chrom,pos,PM,numMeth,numUnmeth,Count,ind
chr1,39061807,0.86,76,12,88,600001
chr1,39061839,0.8,70,17,87,600002
chr1,39061893,0.82,32,7,39,600003
chr1,39061909,0.75,27,9,36,600004
chr1,39061981,0.75,49,16,65,600005
chr1,39062021,0.91,81,8,89,600006
chr1,39062084,0.78,63,18,81,600007
chr1,39062147,0.91,74,7,81,600008
chr1,39062152,0.94,77,5,82,600009
chr1,39062337,0.93,77,6,83,600010
chr1,39062355,0.89,82,10,92,600011
chr1,39062407,0.94,80,5,85,600012
chr1,39062428,0.76,66,21,87,600013
chr1,39062533,1,65,0,65,600014
chr1,39062548,0.97,61,2,63,600015
chr1,39062599,0.73,45,17,62,600016
chr1,39062614,0.85,53,9,62,600017
chr1,39062690,0.8,64,16,80,600018
chr1,39062703,0.91,70,7,77,600019
chr1,39062706,0.97,72,2,74,600020
chr1,39062746,0.95,56,3,59,600021
chr1,39062929,0.94,87,6,93,600022
chr1,39062936,0.95,81,4,85,600023
chr1,39062950,0.68,58,27,85,600024
chr1,39062989,0.84,47,9,56,600025
chr1,39063099,0.94,49,3,52,600026
chr1,39063101,0.96,48,2,50,600027
chr1,39063242,0.69,42,19,61,600028
chr1,39063296,0.97,87,3,90,600029
chr1,39063308,0.97,89,3,92,600030
chr1,39063311,0.88,81,11,92,600031
chr1,39063393,0.69,47,21,68,600032
chr1,39063436,0.94,77,5,82,600033
chr1,39063446,0.93,83,6,89,600034
chr1,39063522,0.93,87,7,94,600035
chr1,39063777,0.75,52,17,69,600036
chr1,39064024,0.95,87,5,92,600037
chr1,39064317,0.86,88,14,102,600038
chr1,39064549,0.83,38,8,46,600039
chr1,39064590,0.79,34,9,43,600040
chr1,39064599,0.78,39,11,50,600041
chr1,39064769,0.57,56,43,99,600042
chr1,39064847,0.82,83,18,101,600043
chr1,39065002,0.49,49,52,101,600044
chr1,39065308,0.38,41,68,109,600045
chr1,39065328,0.29,33,82,115,600046
chr1,39065555,0.28,30,76,106,600047
chr1,39066158,0.77,67,20,87,600048
chr1,39066500,0.8,70,18,88,600049
chr1,39066586,0.38,28,45,73,600050
chr1,39066788,0.67,72,35,107,600051
chr1,39066943,0.8,89,22,111,600052
chr1,39066972,0.73,72,26,98,600053
chr1,39067248,0.67,68,34,102,600054
chr1,39067286,0.95,92,5,97,600055
chr1,39067312,0.92,90,8,98,600056
chr1,39067549,0.8,66,17,83,600057
chr1,39067583,0.31,21,47,68,600058
chr1,39067888,0.89,55,7,62,600059
chr1,39067938,0.65,20,11,31,600060
chr1,39068105,0.88,84,12,96,600061
chr1,39068125,0.66,40,21,61,600062
chr1,39068159,0.95,75,4,79,600063
chr1,39068168,0.7,60,26,86,600064
chr1,39068386,0.66,76,40,116,600065
chr1,39068434,0.88,90,12,102,600066
chr1,39068704,0.53,24,21,45,600067
chr1,39069022,0.84,70,13,83,600068
chr1,39069314,0.85,98,17,115,600069
chr1,39069347,0.86,84,14,98,600070
chr1,39069399,0.86,84,14,98,600071
chr1,39069436,0.6,57,38,95,600072
chr1,39069682,0.96,69,3,72,600073
chr1,39069693,0.87,72,11,83,600074
chr1,39069739,0.88,85,12,97,600075
chr1,39069823,0.72,60,23,83,600076
chr1,39069948,0.52,43,40,83,600077
chr1,39069956,0.88,81,11,92,600078
chr1,39069964,0.97,87,3,90,600079
chr1,39069968,0.95,89,5,94,600080
chr1,39069986,0.9,76,8,84,600081
chr1,39070050,0.75,57,19,76,600082
chr1,39070171,0.96,47,2,49,600083
chr1,39070176,0.89,48,6,54,600084
chr1,39070214,0.97,76,2,78,600085
chr1,39070216,0.99,82,1,83,600086
chr1,39070220,0.58,50,36,86,600087
chr1,39070250,0.92,92,8,100,600088
chr1,39070364,0.93,90,7,97,600089
chr1,39070486,0.46,38,44,82,600090
chr1,39070500,0.51,43,42,85,600091
chr1,39070598,0.68,64,30,94,600092
chr1,39070620,0.92,84,7,91,600093
chr1,39070808,0.79,45,12,57,600094
chr1,39071085,0.62,36,22,58,600095
chr1,39071100,0.97,59,2,61,600096
chr1,39071155,0.56,33,26,59,600097
chr1,39071199,0.65,42,23,65,600098
chr1,39071487,0.14,11,66,77,600099
chr1,39071931,0.93,79,6,85,600100
chr1,39072043,0.83,44,9,53,600101
chr1,39072082,0.89,55,7,62,600102
chr1,39072257,0.42,37,52,89,600103
chr1,39072316,0.7,61,26,87,600104
chr1,39072479,0.56,24,19,43,600105
chr1,39072481,0.96,47,2,49,600106
chr1,39072483,0.77,36,11,47,600107
chr1,39072487,0.68,36,17,53,600108
chr1,39072503,0.87,59,9,68,600109
chr1,39072668,0.96,75,3,78,600110
chr1,39073027,0.96,89,4,93,600111
chr1,39073063,0.9,89,10,99,600112
chr1,39073083,0.98,84,2,86,600113
chr1,39073245,0.69,58,26,84,600114
chr1,39073374,0.89,55,7,62,600115
chr1,39073384,0.71,45,18,63,600116
chr1,39073430,0.33,15,30,45,600117
chr1,39073438,0.42,19,26,45,600118
chr1,39073477,0.59,29,20,49,600119
chr1,39073485,0.87,40,6,46,600120
chr1,39073583,0.42,27,38,65,600121
chr1,39073718,0.97,86,3,89,600122
chr1,39073726,0.85,72,13,85,600123
chr1,39073872,0.63,29,17,46,600124
chr1,39073876,0.49,28,29,57,600125
chr1,39073932,0.25,8,24,32,600126
chr1,39073991,0,0,37,37,600127
chr1,39074028,0.11,6,48,54,600128
chr1,39074059,0.29,18,44,62,600129
chr1,39074065,0.05,4,70,74,600130
chr1,39074082,0.01,1,82,83,600131
chr1,39074095,0.06,5,78,83,600132
chr1,39074102,0.05,2,42,44,600133
chr1,39074162,0.02,2,97,99,600134
chr1,39074176,0.01,1,92,93,600135
chr1,39074200,0.03,2,62,64,600136
chr1,39074275,0.52,44,41,85,600137
chr1,39074292,0.54,43,37,80,600138
chr1,39074352,0.4,35,53,88,600139
chr1,39074428,0.57,54,41,95,600140
chr1,39074532,0.91,92,9,101,600141
chr1,39074620,0.81,48,11,59,600142
chr1,39074725,0.97,73,2,75,600143
chr1,39074776,1,91,0,91,600144
chr1,39074821,0.62,55,34,89,600145
chr1,39074858,0.74,55,19,74,600146
chr1,39074895,0.94,62,4,66,600147
chr1,39074898,0.92,65,6,71,600148
chr1,39074969,0.85,76,13,89,600149
chr1,39075001,0.83,66,14,80,600150
chr1,39075009,0.93,76,6,82,600151
chr1,39075040,0.83,85,17,102,600152
chr1,39075111,0.8,78,20,98,600153
chr1,39075126,0.72,62,24,86,600154
chr1,39075178,0.7,44,19,63,600155
chr1,39075208,0.88,38,5,43,600156
chr1,39075295,0.93,63,5,68,600157
chr1,39075321,0.98,80,2,82,600158
chr1,39075329,0.99,85,1,86,600159
chr1,39075344,0.91,79,8,87,600160
chr1,39075416,0.5,48,48,96,600161
chr1,39075432,0.79,71,19,90,600162
chr1,39075434,0.8,72,18,90,600163
chr1,39075458,0.69,54,24,78,600164
chr1,39075551,0.97,74,2,76,600165
chr1,39075717,0.97,73,2,75,600166
chr1,39075961,0.85,74,13,87,600167
chr1,39075973,0.91,78,8,86,600168
chr1,39076011,0.88,44,6,50,600169
chr1,39076061,0.91,40,4,44,600170
chr1,39076097,0.92,57,5,62,600171
chr1,39076298,0.9,86,10,96,600172
chr1,39076314,0.65,55,29,84,600173
chr1,39076512,0.61,68,43,111,600174
chr1,39076638,0.76,69,22,91,600175
chr1,39076993,0.66,46,24,70,600176
chr1,39077045,0.89,66,8,74,600177
chr1,39077099,0.75,80,26,106,600178
chr1,39077133,0.85,102,18,120,600179
chr1,39077294,0.31,33,75,108,600180
chr1,39077426,0.07,7,91,98,600181
chr1,39077486,0.36,31,56,87,600182
chr1,39077492,0.3,24,56,80,600183
chr1,39077517,0.49,25,26,51,600184
chr1,39077595,0.07,7,92,99,600185
chr1,39077693,0.42,45,63,108,600186
chr1,39077789,0.85,81,14,95,600187
chr1,39078193,0.97,77,2,79,600188
chr1,39078198,0.97,75,2,77,600189
chr1,39078200,0.96,74,3,77,600190
chr1,39078206,0.96,75,3,78,600191
chr1,39078390,0.97,86,3,89,600192
chr1,39078406,0.92,84,7,91,600193
chr1,39078427,0.94,91,6,97,600194
chr1,39078466,0.96,89,4,93,600195
chr1,39078620,0.93,65,5,70,600196
chr1,39078740,0.77,70,21,91,600197
chr1,39078752,0.89,84,10,94,600198
chr1,39078776,0.88,90,12,102,600199
chr1,39078894,0.88,91,13,104,600200
chr1,39078955,0.95,100,5,105,600201
chr1,39078973,0.92,95,8,103,600202
chr1,39079055,0.74,55,19,74,600203
chr1,39079258,0.92,99,9,108,600204
chr1,39079283,0.76,81,25,106,600205
chr1,39079314,0.91,99,10,109,600206
chr1,39079363,0.77,71,21,92,600207
chr1,39079381,0.72,58,23,81,600208
chr1,39079479,0.91,48,5,53,600209
chr1,39079489,0.96,48,2,50,600210
chr1,39079653,0.91,83,8,91,600211
chr1,39079684,0.91,97,10,107,600212
chr1,39079715,0.9,110,12,122,600213
chr1,39079748,0.5,56,55,111,600214
chr1,39079750,0.51,58,55,113,600215
chr1,39079774,0.78,66,19,85,600216
chr1,39079786,0.83,65,13,78,600217
chr1,39079839,0.65,33,18,51,600218
chr1,39080132,0.13,12,77,89,600219
chr1,39080383,0.07,6,77,83,600220
chr1,39080448,0.42,41,57,98,600221
chr1,39080522,0.41,32,46,78,600222
chr1,39080676,0.2,15,61,76,600223
chr1,39080851,0.28,16,42,58,600224
chr1,39080888,0.76,50,16,66,600225
chr1,39081084,0.78,18,5,23,600226
chr1,39081158,0.96,44,2,46,600227
chr1,39081545,0.74,70,25,95,600228
chr1,39081977,0.78,56,16,72,600229
chr1,39082151,0.91,60,6,66,600230
chr1,39082244,0.96,79,3,82,600231
chr1,39082650,0.27,27,73,100,600232
chr1,39082746,0.42,45,61,106,600233
chr1,39082768,0.19,19,83,102,600234
chr1,39083383,0.84,109,21,130,600235
chr1,39083674,0.64,61,35,96,600236
chr1,39083718,0.92,97,9,106,600237
chr1,39083933,0.7,37,16,53,600238
chr1,39083991,0.74,48,17,65,600239
chr1,39084053,0.84,51,10,61,600240
chr1,39084063,0.83,49,10,59,600241
chr1,39084123,0.97,56,2,58,600242
chr1,39084153,0.83,49,10,59,600243
chr1,39084180,0.91,50,5,55,600244
chr1,39084184,0.81,39,9,48,600245
chr1,39084216,0.79,54,14,68,600246
chr1,39084249,0.76,35,11,46,600247
chr1,39084265,0.9,35,4,39,600248
chr1,39084492,0.61,67,43,110,600249
chr1,39084756,0.72,88,34,122,600250
chr1,39084799,0.8,96,24,120,600251
chr1,39085010,0.52,54,50,104,600252
chr1,39085054,0.57,51,38,89,600253
chr1,39085511,0.54,59,51,110,600254
chr1,39085584,0.89,88,11,99,600255
chr1,39085695,0.92,59,5,64,600256
chr1,39085700,0.95,53,3,56,600257
chr1,39085719,0.76,25,8,33,600258
chr1,39085758,0.9,37,4,41,600259
chr1,39085785,0.92,47,4,51,600260
chr1,39085789,0.84,41,8,49,600261
chr1,39085799,0.84,38,7,45,600262
chr1,39085860,1,28,0,28,600263
chr1,39085869,0.92,24,2,26,600264
chr1,39085883,0.95,21,1,22,600265
chr1,39085976,0.83,44,9,53,600266
chr1,39085992,0.75,46,15,61,600267
chr1,39086062,0.92,94,8,102,600268
chr1,39086075,0.91,90,9,99,600269
chr1,39086112,0.91,96,10,106,600270
chr1,39086116,0.93,100,7,107,600271
chr1,39086170,0.94,75,5,80,600272
chr1,39086210,0.77,36,11,47,600273
chr1,39086749,0.86,57,9,66,600274
chr1,39086806,0.85,57,10,67,600275
chr1,39086852,0.93,80,6,86,600276
chr1,39086938,0.91,88,9,97,600277
chr1,39087188,0.56,61,48,109,600278
chr1,39087258,0.77,75,22,97,600279
chr1,39087603,0.77,51,15,66,600280
chr1,39087824,0.87,91,14,105,600281
chr1,39087833,0.84,88,17,105,600282
chr1,39087843,0.92,90,8,98,600283
chr1,39087890,0.81,91,22,113,600284
chr1,39087901,0.96,106,4,110,600285
chr1,39087958,0.61,62,39,101,600286
chr1,39088008,0.77,70,21,91,600287
chr1,39088044,0.86,86,14,100,600288
chr1,39088251,0.94,99,6,105,600289
chr1,39088305,0.9,105,12,117,600290
chr1,39088319,0.98,117,3,120,600291
chr1,39088324,0.94,113,7,120,600292
chr1,39088446,0.94,78,5,83,600293
chr1,39088564,0.78,87,24,111,600294
chr1,39088599,0.92,107,9,116,600295
chr1,39088699,0.9,108,12,120,600296
chr1,39088754,0.92,98,9,107,600297
chr1,39088787,0.78,83,23,106,600298
chr1,39088806,0.61,59,37,96,600299
chr1,39089091,0.74,43,15,58,600300
chr1,39089106,0.83,39,8,47,600301
chr1,39089202,0.91,32,3,35,600302
chr1,39089352,0.8,60,15,75,600303
chr1,39089362,0.93,69,5,74,600304
chr1,39089384,0.88,67,9,76,600305
chr1,39089436,0.94,72,5,77,600306
chr1,39089444,0.97,71,2,73,600307
chr1,39089531,0.82,75,16,91,600308
chr1,39089913,0.52,30,28,58,600309
chr1,39090010,0.84,46,9,55,600310
chr1,39090038,0.67,40,20,60,600311
chr1,39090095,0.46,32,37,69,600312
chr1,39090107,0.42,33,46,79,600313
chr1,39090142,0.03,3,88,91,600314
chr1,39090213,0.03,3,91,94,600315
chr1,39090242,0.17,16,78,94,600316
chr1,39090424,0.77,53,16,69,600317
chr1,39090427,0.93,62,5,67,600318
chr1,39090457,0.78,58,16,74,600319
chr1,39090491,0.39,39,61,100,600320
chr1,39090619,0.93,76,6,82,600321
chr1,39090645,0.98,84,2,86,600322
chr1,39090674,0.86,86,14,100,600323
chr1,39090915,0.38,30,48,78,600324
chr1,39091171,0.78,47,13,60,600325
chr1,39091432,0.28,40,102,142,600326
chr1,39091654,0.73,65,24,89,600327
chr1,39091680,0.86,71,12,83,600328
chr1,39091796,0.78,49,14,63,600329
chr1,39091825,0.92,58,5,63,600330
chr1,39091869,0.41,30,43,73,600331
chr1,39091928,0.66,56,29,85,600332
chr1,39092087,0.45,50,62,112,600333
chr1,39092133,0.68,63,29,92,600334
chr1,39092361,0.81,61,14,75,600335
chr1,39092518,0.74,96,33,129,600336
chr1,39092745,0.79,63,17,80,600337
chr1,39092970,0.31,22,50,72,600338
chr1,39092975,0.54,37,31,68,600339
chr1,39092983,0.38,26,42,68,600340
chr1,39093017,0.93,64,5,69,600341
chr1,39093026,0.88,60,8,68,600342
chr1,39093041,0.63,45,27,72,600343
chr1,39093058,0.81,55,13,68,600344
chr1,39093061,0.88,59,8,67,600345
chr1,39093073,0.86,55,9,64,600346
chr1,39093077,0.86,55,9,64,600347
chr1,39093167,0.74,48,17,65,600348
chr1,39093205,0.32,26,56,82,600349
chr1,39093270,0.7,64,28,92,600350
chr1,39093452,0.97,64,2,66,600351
chr1,39093460,0.96,76,3,79,600352
chr1,39093484,0.88,89,12,101,600353
chr1,39093547,0.85,88,16,104,600354
chr1,39093628,0.82,46,10,56,600355
chr1,39094285,0.82,74,16,90,600356
chr1,39094337,0.84,75,14,89,600357
chr1,39094528,0.96,77,3,80,600358
chr1,39095015,0.92,55,5,60,600359
chr1,39095149,0.09,3,32,35,600360
chr1,39095411,0.59,40,28,68,600361
chr1,39095575,0.73,92,34,126,600362
chr1,39095662,0.87,72,11,83,600363
chr1,39096018,0.81,70,16,86,600364
chr1,39096089,0.82,71,16,87,600365
chr1,39096134,0.9,83,9,92,600366
chr1,39096299,0.89,87,11,98,600367
chr1,39096414,0.83,53,11,64,600368
chr1,39097440,0.77,85,26,111,600369
chr1,39097445,0.59,65,45,110,600370
chr1,39098071,0.77,27,8,35,600371
chr1,39098127,0.87,80,12,92,600372
chr1,39098393,0.73,73,27,100,600373
chr1,39098737,0.64,46,26,72,600374
chr1,39099153,0.85,66,12,78,600375
chr1,39099201,0.78,62,18,80,600376
chr1,39099238,0.92,60,5,65,600377
chr1,39099247,0.78,47,13,60,600378
chr1,39099670,0.9,111,12,123,600379
chr1,39099830,0.87,111,17,128,600380
chr1,39099899,0.69,83,37,120,600381
chr1,39100176,0.92,92,8,100,600382
chr1,39100254,0.77,60,18,78,600383
chr1,39100384,0.68,71,34,105,600384
chr1,39100550,0.8,40,10,50,600385
chr1,39100642,0.96,66,3,69,600386
chr1,39100764,0.81,30,7,37,600387
chr1,39100863,0.46,21,25,46,600388
chr1,39100964,0.94,104,7,111,600389
chr1,39101006,0.77,78,23,101,600390
chr1,39101530,0.91,68,7,75,600391
chr1,39101654,0.33,28,56,84,600392
chr1,39101774,0.51,39,38,77,600393
chr1,39101896,0.91,64,6,70,600394
chr1,39101948,0.72,46,18,64,600395
chr1,39102635,0.83,93,19,112,600396
chr1,39102766,0.81,68,16,84,600397
chr1,39102924,0.9,66,7,73,600398
chr1,39102954,0.92,72,6,78,600399
chr1,39102974,0.92,72,6,78,600400
chr1,39103027,0.98,60,1,61,600401
chr1,39103037,0.98,57,1,58,600402
chr1,39103137,0.83,48,10,58,600403
chr1,39103178,0.71,42,17,59,600404
chr1,39103331,0.77,75,22,97,600405
chr1,39103564,0.91,59,6,65,600406
chr1,39103592,0.79,49,13,62,600407
chr1,39103610,0.79,52,14,66,600408
chr1,39103618,0.83,50,10,60,600409
chr1,39103707,0.53,42,37,79,600410
chr1,39103777,0.78,73,20,93,600411
chr1,39103866,0.79,73,19,92,600412
chr1,39104274,0.34,36,71,107,600413
chr1,39104601,0.88,53,7,60,600414
chr1,39104670,0.91,49,5,54,600415
chr1,39104966,0.71,37,15,52,600416
chr1,39105077,0.56,52,41,93,600417
chr1,39105196,0.9,75,8,83,600418
chr1,39105505,0.64,30,17,47,600419
chr1,39105572,0.89,59,7,66,600420
chr1,39106076,0.5,35,35,70,600421
chr1,39106112,0.87,67,10,77,600422
chr1,39106380,0.75,91,30,121,600423
chr1,39106404,0.78,95,27,122,600424
chr1,39106442,0.51,58,55,113,600425
chr1,39107008,0.76,84,27,111,600426
chr1,39107324,0.92,95,8,103,600427
chr1,39107363,0.77,71,21,92,600428
chr1,39107456,0.87,41,6,47,600429
chr1,39107473,0.89,32,4,36,600430
chr1,39107525,0.76,16,5,21,600431
chr1,39107628,0.97,63,2,65,600432
chr1,39107645,0.94,75,5,80,600433
chr1,39107707,0.85,73,13,86,600434
chr1,39107839,0.76,41,13,54,600435
chr1,39108008,0.49,52,55,107,600436
chr1,39108996,0.98,63,1,64,600437
chr1,39109131,0.83,43,9,52,600438
chr1,39109197,0.94,50,3,53,600439
chr1,39109234,0.93,62,5,67,600440
chr1,39109381,0.93,78,6,84,600441
chr1,39109591,0.88,15,2,17,600442
chr1,39109615,0.71,12,5,17,600443
chr1,39109645,0.78,7,2,9,600444
chr1,39109653,0.67,6,3,9,600445
chr1,39109697,0.89,25,3,28,600446
chr1,39109713,0.85,35,6,41,600447
chr1,39109744,0.82,56,12,68,600448
chr1,39109755,0.89,67,8,75,600449
chr1,39109777,0.85,64,11,75,600450
chr1,39109788,0.96,79,3,82,600451
chr1,39109821,0.89,82,10,92,600452
chr1,39109831,0.98,90,2,92,600453
chr1,39109833,0.96,89,4,93,600454
chr1,39109837,0.93,85,6,91,600455
chr1,39110014,0.97,59,2,61,600456
chr1,39110030,0.98,62,1,63,600457
chr1,39110227,0.88,81,11,92,600458
chr1,39110269,0.74,65,23,88,600459
chr1,39110341,0.98,80,2,82,600460
chr1,39110355,0.96,74,3,77,600461
chr1,39110360,0.86,71,12,83,600462
chr1,39110402,0.79,75,20,95,600463
chr1,39110601,0.98,50,1,51,600464
chr1,39110618,0.72,38,15,53,600465
chr1,39110660,0.95,35,2,37,600466
chr1,39110672,0.98,40,1,41,600467
chr1,39110734,0.82,36,8,44,600468
chr1,39110766,0.94,46,3,49,600469
chr1,39111197,0.78,64,18,82,600470
chr1,39111207,0.71,57,23,80,600471
chr1,39111210,0.58,45,33,78,600472
chr1,39111284,0.69,49,22,71,600473
chr1,39111393,0.84,88,17,105,600474
chr1,39111531,0.94,100,6,106,600475
chr1,39111668,0.93,55,4,59,600476
chr1,39111866,0.89,84,10,94,600477
chr1,39111882,0.88,84,11,95,600478
chr1,39112043,0.45,50,61,111,600479
chr1,39112372,0.96,49,2,51,600480
chr1,39112434,0.91,50,5,55,600481
chr1,39112461,0.76,53,17,70,600482
chr1,39112486,0.89,56,7,63,600483
chr1,39112511,0.9,37,4,41,600484
chr1,39112528,1,30,0,30,600485
chr1,39112533,0.96,23,1,24,600486
chr1,39112560,1,10,0,10,600487
chr1,39112605,0.91,40,4,44,600488
chr1,39112615,1,46,0,46,600489
chr1,39112625,0.96,52,2,54,600490
chr1,39112627,0.98,56,1,57,600491
chr1,39112629,1,58,0,58,600492
chr1,39112652,0.96,71,3,74,600493
chr1,39112662,0.92,66,6,72,600494
chr1,39112671,0.92,60,5,65,600495
chr1,39112679,0.95,59,3,62,600496
chr1,39112691,0.98,60,1,61,600497
chr1,39112725,0.95,62,3,65,600498
chr1,39112734,0.94,62,4,66,600499
chr1,39112742,0.98,61,1,62,600500
chr1,39112750,0.98,60,1,61,600501
chr1,39112770,0.94,63,4,67,600502
chr1,39112774,0.9,62,7,69,600503
chr1,39112813,0.95,40,2,42,600504
chr1,39112821,0.94,30,2,32,600505
chr1,39112826,0.94,29,2,31,600506
chr1,39112849,0.86,18,3,21,600507
chr1,39112874,1,17,0,17,600508
chr1,39112893,0.92,12,1,13,600509
chr1,39112897,1,16,0,16,600510
chr1,39112905,0.75,12,4,16,600511
chr1,39112937,1,13,0,13,600512
chr1,39112944,0.82,9,2,11,600513
chr1,39112999,0.93,13,1,14,600514
chr1,39113009,0.94,16,1,17,600515
chr1,39113013,1,18,0,18,600516
chr1,39113039,1,28,0,28,600517
chr1,39113050,1,31,0,31,600518
chr1,39113053,0.97,31,1,32,600519
chr1,39113079,1,26,0,26,600520
chr1,39113089,0.96,23,1,24,600521
chr1,39113093,1,27,0,27,600522
chr1,39113100,0.94,30,2,32,600523
chr1,39113118,1,27,0,27,600524
chr1,39113129,0.93,25,2,27,600525
chr1,39113132,1,28,0,28,600526
chr1,39113137,0.94,30,2,32,600527
chr1,39113155,0.97,32,1,33,600528
chr1,39113169,1,41,0,41,600529
chr1,39113171,0.98,39,1,40,600530
chr1,39113177,0.98,47,1,48,600531
chr1,39113195,1,34,0,34,600532
chr1,39113205,0.91,29,3,32,600533
chr1,39113209,1,30,0,30,600534
chr1,39113214,0.94,33,2,35,600535
chr1,39113238,1,23,0,23,600536
chr1,39113242,1,24,0,24,600537
chr1,39113249,0.95,18,1,19,600538
chr1,39113254,0.85,17,3,20,600539
chr1,39113283,0.95,18,1,19,600540
chr1,39113295,0.94,17,1,18,600541
chr1,39113304,0.91,20,2,22,600542
chr1,39113330,1,25,0,25,600543
chr1,39113342,1,27,0,27,600544
chr1,39113351,0.97,31,1,32,600545
chr1,39113377,0.95,39,2,41,600546
chr1,39113389,0.98,44,1,45,600547
chr1,39113394,0.95,40,2,42,600548
chr1,39113398,0.95,38,2,40,600549
chr1,39113412,1,31,0,31,600550
chr1,39113422,0.93,27,2,29,600551
chr1,39113426,0.96,25,1,26,600552
chr1,39113459,0.86,12,2,14,600553
chr1,39113471,1,9,0,9,600554
chr1,39113746,0.93,13,1,14,600555
chr1,39113778,0.51,21,20,41,600556
chr1,39113793,0.68,34,16,50,600557
chr1,39113845,0.81,61,14,75,600558
chr1,39113855,0.8,49,12,61,600559
chr1,39113957,1,8,0,8,600560
chr1,39114109,0.78,57,16,73,600561
chr1,39114212,0.92,71,6,77,600562
chr1,39114264,0.84,52,10,62,600563
chr1,39114272,0.93,71,5,76,600564
chr1,39114366,0.81,71,17,88,600565
chr1,39114464,0.81,46,11,57,600566
chr1,39114490,0.93,43,3,46,600567
chr1,39114511,0.77,49,15,64,600568
chr1,39114893,0.79,81,21,102,600569
chr1,39114915,0.87,88,13,101,600570
chr1,39115215,0.9,43,5,48,600571
chr1,39115405,0.72,63,24,87,600572
chr1,39115908,0.55,48,40,88,600573
chr1,39115944,0.63,64,37,101,600574
chr1,39116208,0.24,19,59,78,600575
chr1,39116508,0.92,79,7,86,600576
chr1,39116511,0.88,69,9,78,600577
chr1,39116546,0.91,61,6,67,600578
chr1,39116674,0.77,37,11,48,600579
chr1,39116764,0.97,62,2,64,600580
chr1,39116766,0.96,66,3,69,600581
chr1,39116776,0.97,62,2,64,600582
chr1,39116780,0.89,62,8,70,600583
chr1,39116810,0.88,76,10,86,600584
chr1,39117003,0.92,82,7,89,600585
chr1,39117048,0.94,82,5,87,600586
chr1,39117241,0.71,44,18,62,600587
chr1,39117281,0.82,55,12,67,600588
chr1,39117288,0.92,61,5,66,600589
chr1,39117367,0.87,65,10,75,600590
chr1,39117501,0.7,62,26,88,600591
chr1,39117514,0.85,83,15,98,600592
chr1,39117541,0.93,100,7,107,600593
chr1,39117547,0.92,100,9,109,600594
chr1,39117579,0.75,89,29,118,600595
chr1,39117646,0.48,54,59,113,600596
chr1,39117697,0.37,41,69,110,600597
chr1,39117761,0.82,73,16,89,600598
chr1,39117779,0.83,60,12,72,600599
chr1,39117935,0.98,55,1,56,600600
chr1,39118331,0.72,53,21,74,600601
chr1,39118582,0.68,62,29,91,600602
chr1,39118723,0.75,44,15,59,600603
chr1,39118759,0.94,72,5,77,600604
chr1,39118778,0.85,78,14,92,600605
chr1,39118800,0.91,92,9,101,600606
chr1,39118815,0.73,85,32,117,600607
chr1,39118976,0.9,81,9,90,600608
chr1,39119343,0.88,64,9,73,600609
chr1,39119379,0.71,55,22,77,600610
chr1,39119506,0.89,79,10,89,600611
chr1,39119537,0.91,77,8,85,600612
chr1,39119767,0.84,88,17,105,600613
chr1,39119799,0.55,56,45,101,600614
chr1,39120011,0.87,78,12,90,600615
chr1,39120140,0.91,82,8,90,600616
chr1,39120438,0.92,86,7,93,600617
chr1,39120606,0.86,75,12,87,600618
chr1,39120757,0.9,55,6,61,600619
chr1,39120956,0.27,18,49,67,600620
chr1,39120974,0.85,41,7,48,600621
chr1,39120980,0.93,50,4,54,600622
chr1,39120982,0.75,40,13,53,600623
chr1,39120997,0.55,28,23,51,600624
chr1,39121110,0.59,35,24,59,600625
chr1,39121147,0.56,34,27,61,600626
chr1,39121167,0.81,50,12,62,600627
chr1,39121218,0.45,30,37,67,600628
chr1,39121488,0.82,54,12,66,600629
chr1,39121497,0.82,56,12,68,600630
chr1,39121573,0.52,46,42,88,600631
chr1,39121596,0.68,60,28,88,600632
chr1,39121672,0.55,47,39,86,600633
chr1,39121681,0.4,33,50,83,600634
chr1,39121701,0.26,19,53,72,600635
chr1,39121722,0.46,21,25,46,600636
chr1,39121991,0.89,114,14,128,600637
chr1,39122147,0.87,75,11,86,600638
chr1,39122195,0.9,62,7,69,600639
chr1,39122241,1,56,0,56,600640
chr1,39122267,0.97,58,2,60,600641
chr1,39122280,0.83,52,11,63,600642
chr1,39122406,0.7,91,39,130,600643
chr1,39122548,0.28,21,53,74,600644
chr1,39122595,0.78,43,12,55,600645
chr1,39122772,0.33,15,30,45,600646
chr1,39122884,0.65,51,27,78,600647
chr1,39123075,0.31,34,75,109,600648
chr1,39123440,0.64,74,41,115,600649
chr1,39123474,0.91,100,10,110,600650
chr1,39123667,0.93,84,6,90,600651
chr1,39123692,0.86,85,14,99,600652
chr1,39124127,0.73,53,20,73,600653
chr1,39124843,0.6,50,34,84,600654
chr1,39124993,0.83,50,10,60,600655
chr1,39125082,0.91,64,6,70,600656
chr1,39125236,0.89,70,9,79,600657
chr1,39125413,0.93,68,5,73,600658
chr1,39125471,0.94,60,4,64,600659
chr1,39125491,0.93,53,4,57,600660
chr1,39125531,0.79,44,12,56,600661
chr1,39125567,0.6,28,19,47,600662
chr1,39125653,0.97,30,1,31,600663
chr1,39125661,0.97,35,1,36,600664
chr1,39125669,0.92,36,3,39,600665
chr1,39125953,0.83,34,7,41,600666
chr1,39125973,0.71,36,15,51,600667
chr1,39125976,0.94,48,3,51,600668
chr1,39126262,0.72,73,28,101,600669
chr1,39126362,0.82,51,11,62,600670
chr1,39126554,0.64,18,10,28,600671
chr1,39126654,0.89,110,13,123,600672
chr1,39126699,0.93,132,10,142,600673
chr1,39126742,0.94,120,7,127,600674
chr1,39126879,0.73,68,25,93,600675
chr1,39126929,0.74,66,23,89,600676
chr1,39127024,0.37,36,61,97,600677
chr1,39127087,0.74,40,14,54,600678
chr1,39127091,0.96,45,2,47,600679
chr1,39127382,0.97,88,3,91,600680
chr1,39127558,0.53,50,44,94,600681
chr1,39127787,0.74,53,19,72,600682
chr1,39127900,0.23,11,36,47,600683
chr1,39127902,0.41,21,30,51,600684
chr1,39128004,0.6,33,22,55,600685
chr1,39128045,0.35,24,44,68,600686
chr1,39128099,0.89,58,7,65,600687
chr1,39128119,0.79,56,15,71,600688
chr1,39128126,0.69,51,23,74,600689
chr1,39128255,0.8,63,16,79,600690
chr1,39128468,0.7,56,24,80,600691
chr1,39128522,0.81,63,15,78,600692
chr1,39129070,0.94,105,7,112,600693
chr1,39129571,0.5,26,26,52,600694
chr1,39129741,0.58,57,41,98,600695
chr1,39129986,0.61,34,22,56,600696
chr1,39130159,0.82,79,17,96,600697
chr1,39130212,0.68,47,22,69,600698
chr1,39130373,0.56,33,26,59,600699
chr1,39130461,0.73,33,12,45,600700
chr1,39130505,0.91,64,6,70,600701
chr1,39130581,0.65,53,29,82,600702
chr1,39131042,0.61,69,44,113,600703
chr1,39131357,0.18,12,54,66,600704
chr1,39131695,0.93,113,8,121,600705
chr1,39132038,0.94,16,1,17,600706
chr1,39132055,0.75,9,3,12,600707
chr1,39132314,0.78,39,11,50,600708
chr1,39132412,0.9,72,8,80,600709
chr1,39132461,0.95,86,5,91,600710
chr1,39132571,1,2,0,2,600711
chr1,39132998,0.99,73,1,74,600712
chr1,39133019,0.9,66,7,73,600713
chr1,39133075,0.72,73,28,101,600714
chr1,39133298,0.56,57,44,101,600715
chr1,39133528,0.48,36,39,75,600716
chr1,39133626,0.6,30,20,50,600717
chr1,39133689,0.52,37,34,71,600718
chr1,39134707,0.86,31,5,36,600719
chr1,39134967,0.76,59,19,78,600720
chr1,39134996,0.8,66,16,82,600721
chr1,39135160,0.81,57,13,70,600722
chr1,39135474,0.74,67,23,90,600723
chr1,39135748,0.64,60,34,94,600724
chr1,39136051,0.84,81,16,97,600725
chr1,39136122,0.58,62,44,106,600726
chr1,39136315,0.59,54,38,92,600727
chr1,39136585,0.92,95,8,103,600728
chr1,39136615,0.89,103,13,116,600729
chr1,39136659,0.67,82,40,122,600730
chr1,39136833,0.84,82,16,98,600731
chr1,39136882,0.66,72,37,109,600732
chr1,39136985,0.75,66,22,88,600733
chr1,39137006,0.4,32,49,81,600734
chr1,39137078,0.61,78,50,128,600735
chr1,39137083,0.59,78,55,133,600736
chr1,39137092,0.63,84,50,134,600737
chr1,39137164,0.68,100,47,147,600738
chr1,39137194,0.39,52,82,134,600739
chr1,39137271,0.84,104,20,124,600740
chr1,39137337,0.44,58,73,131,600741
chr1,39137388,0.95,111,6,117,600742
chr1,39137563,0.88,51,7,58,600743
chr1,39137629,0.98,58,1,59,600744
chr1,39137846,0.83,43,9,52,600745
chr1,39138155,0.8,82,20,102,600746
chr1,39138232,0.94,84,5,89,600747
chr1,39138462,0.76,84,26,110,600748
chr1,39138637,0.81,51,12,63,600749
chr1,39138667,0.85,58,10,68,600750
chr1,39138697,0.83,60,12,72,600751
chr1,39138795,0.85,74,13,87,600752
chr1,39138817,0.92,70,6,76,600753
chr1,39138856,0.88,51,7,58,600754
chr1,39139039,0.77,82,25,107,600755
chr1,39139108,0.66,56,29,85,600756
chr1,39139220,0.65,46,25,71,600757
chr1,39139248,0.88,75,10,85,600758
chr1,39139554,0.69,61,28,89,600759
chr1,39139885,0.91,84,8,92,600760
chr1,39140002,0.43,40,53,93,600761
chr1,39140163,0.86,48,8,56,600762
chr1,39140477,0.84,65,12,77,600763
chr1,39140505,0.57,52,40,92,600764
chr1,39140536,0.59,57,40,97,600765
chr1,39140757,0.25,19,56,75,600766
chr1,39140822,0.15,15,85,100,600767
chr1,39140859,0.08,8,94,102,600768
chr1,39141374,0.67,61,30,91,600769
chr1,39141395,0.63,47,28,75,600770
chr1,39141508,0.99,66,1,67,600771
chr1,39141510,0.97,62,2,64,600772
chr1,39141565,0.86,68,11,79,600773
chr1,39141670,0.9,60,7,67,600774
chr1,39141983,0.99,73,1,74,600775
chr1,39141988,0.97,69,2,71,600776
chr1,39142007,0.88,64,9,73,600777
chr1,39142033,0.84,68,13,81,600778
chr1,39142150,0.92,71,6,77,600779
chr1,39142167,0.97,72,2,74,600780
chr1,39142190,0.94,61,4,65,600781
chr1,39142222,0.95,74,4,78,600782
chr1,39142322,0.85,50,9,59,600783
chr1,39142399,0.94,87,6,93,600784
chr1,39142451,0.85,92,16,108,600785
chr1,39142485,0.8,86,22,108,600786
chr1,39142536,0.68,71,33,104,600787
chr1,39142779,0.86,79,13,92,600788
chr1,39143056,0.41,31,44,75,600789
chr1,39143081,0.62,43,26,69,600790
chr1,39143186,0.65,42,23,65,600791
chr1,39143194,0.9,66,7,73,600792
chr1,39143294,0.93,100,7,107,600793
chr1,39143308,0.92,89,8,97,600794
chr1,39143370,0.92,91,8,99,600795
chr1,39143585,0.72,53,21,74,600796
chr1,39143691,0.8,64,16,80,600797
chr1,39143947,0.77,67,20,87,600798
chr1,39144115,0.55,57,47,104,600799
chr1,39144210,0.7,61,26,87,600800
chr1,39144450,0.64,49,28,77,600801
chr1,39144720,0.93,74,6,80,600802
chr1,39145027,0.75,82,27,109,600803
chr1,39145339,0.44,32,41,73,600804
chr1,39145503,0.68,67,32,99,600805
chr1,39145645,0.89,107,13,120,600806
chr1,39145752,0.55,57,46,103,600807
chr1,39145817,0.72,50,19,69,600808
chr1,39145881,0.46,36,42,78,600809
chr1,39146095,0.89,89,11,100,600810
chr1,39146140,0.93,92,7,99,600811
chr1,39146195,0.96,86,4,90,600812
chr1,39146241,0.93,92,7,99,600813
chr1,39146303,0.72,57,22,79,600814
chr1,39146677,0.24,10,32,42,600815
chr1,39146751,0.02,2,83,85,600816
chr1,39146964,0.72,82,32,114,600817
chr1,39146993,0.56,67,53,120,600818
chr1,39147061,0.24,27,84,111,600819
chr1,39147270,0.92,60,5,65,600820
chr1,39147541,0.83,48,10,58,600821
chr1,39148082,0.9,78,9,87,600822
chr1,39148137,0.7,67,29,96,600823
chr1,39148325,0.73,58,22,80,600824
chr1,39148359,0.88,71,10,81,600825
chr1,39148489,0.95,59,3,62,600826
chr1,39148642,0.99,102,1,103,600827
chr1,39148876,0.93,83,6,89,600828
chr1,39148918,0.99,74,1,75,600829
chr1,39148979,0.9,71,8,79,600830
chr1,39149007,0.92,80,7,87,600831
chr1,39149019,0.94,78,5,83,600832
chr1,39149043,0.75,65,22,87,600833
chr1,39149279,0.51,46,45,91,600834
chr1,39149905,0.76,81,25,106,600835
chr1,39149916,0.75,77,26,103,600836
chr1,39150225,0.85,64,11,75,600837
chr1,39150281,0.66,49,25,74,600838
chr1,39150401,0.81,84,20,104,600839
chr1,39150464,0.95,93,5,98,600840
chr1,39150505,0.9,55,6,61,600841
chr1,39150559,0.8,43,11,54,600842
chr1,39150645,0.95,37,2,39,600843
chr1,39150681,0.76,69,22,91,600844
chr1,39150729,0.88,90,12,102,600845
chr1,39150823,0.84,88,17,105,600846
chr1,39150835,0.95,102,5,107,600847
chr1,39151083,0.94,66,4,70,600848
chr1,39151260,0.58,42,30,72,600849
chr1,39151304,0.59,37,26,63,600850
chr1,39151325,0.58,34,25,59,600851
chr1,39151399,0.57,55,41,96,600852
chr1,39151434,0.15,13,73,86,600853
chr1,39151657,0.51,32,31,63,600854
chr1,39151733,0.86,70,11,81,600855
chr1,39151735,0.87,75,11,86,600856
chr1,39151749,0.88,71,10,81,600857
chr1,39151752,0.69,54,24,78,600858
chr1,39151794,0.77,71,21,92,600859
chr1,39151832,0.91,79,8,87,600860
chr1,39151854,0.96,103,4,107,600861
chr1,39151889,0.96,99,4,103,600862
chr1,39152184,0.43,50,67,117,600863
chr1,39152188,0.65,76,41,117,600864
chr1,39152199,0.85,94,16,110,600865
chr1,39152243,0.59,63,44,107,600866
chr1,39152325,0.86,103,17,120,600867
chr1,39152367,0.95,116,6,122,600868
chr1,39152392,0.65,78,42,120,600869
chr1,39152410,0.77,86,26,112,600870
chr1,39152454,0.69,72,32,104,600871
chr1,39152478,0.79,81,22,103,600872
chr1,39152481,0.86,85,14,99,600873
chr1,39152484,0.78,75,21,96,600874
chr1,39152725,0.19,11,48,59,600875
chr1,39152827,0.16,13,67,80,600876
chr1,39152976,0.77,84,25,109,600877
chr1,39153084,0.54,60,52,112,600878
chr1,39153550,0.79,48,13,61,600879
chr1,39153610,0.96,52,2,54,600880
chr1,39153624,0.89,58,7,65,600881
chr1,39154537,0.94,82,5,87,600882
chr1,39154561,0.86,79,13,92,600883
chr1,39154612,0.87,72,11,83,600884
chr1,39154640,0.96,70,3,73,600885
chr1,39154694,0.95,59,3,62,600886
chr1,39154731,0.66,51,26,77,600887
chr1,39154741,0.37,31,52,83,600888
chr1,39154794,0.68,65,30,95,600889
chr1,39155126,0.62,56,34,90,600890
chr1,39156369,0.55,51,42,93,600891
chr1,39156535,0.9,101,11,112,600892
chr1,39156606,0.14,15,96,111,600893
chr1,39156658,0.37,35,60,95,600894
chr1,39157109,0.83,68,14,82,600895
chr1,39158354,0.93,81,6,87,600896
chr1,39158367,0.95,73,4,77,600897
chr1,39158375,0.94,75,5,80,600898
chr1,39158462,0.94,60,4,64,600899
chr1,39158479,0.95,69,4,73,600900
chr1,39158534,0.8,64,16,80,600901
chr1,39158542,0.85,64,11,75,600902
chr1,39158704,0.63,59,34,93,600903
chr1,39158793,0.29,42,103,145,600904
chr1,39158975,0.77,49,15,64,600905
chr1,39159616,0.63,33,19,52,600906
chr1,39159849,0.78,102,28,130,600907
chr1,39160263,0.71,58,24,82,600908
chr1,39160431,0.86,72,12,84,600909
chr1,39160479,0.59,49,34,83,600910
chr1,39160575,0.89,64,8,72,600911
chr1,39160585,0.84,57,11,68,600912
chr1,39160598,0.88,59,8,67,600913
chr1,39160674,0.3,14,32,46,600914
chr1,39161148,0.76,67,21,88,600915
chr1,39161492,0.83,44,9,53,600916
chr1,39161792,0.41,34,48,82,600917
chr1,39161843,0.49,42,44,86,600918
chr1,39161872,0.92,78,7,85,600919
chr1,39162171,0.89,86,11,97,600920
chr1,39162224,0.92,79,7,86,600921
chr1,39162452,0.37,22,37,59,600922
chr1,39162459,0.76,51,16,67,600923
chr1,39162966,0.78,62,18,80,600924
chr1,39163437,0.64,49,27,76,600925
chr1,39163535,0.55,58,47,105,600926
chr1,39163565,0.4,40,60,100,600927
chr1,39163758,0.9,72,8,80,600928
chr1,39163967,0.97,86,3,89,600929
chr1,39164090,0.29,27,67,94,600930
chr1,39164195,0.36,20,36,56,600931
chr1,39164349,0.87,59,9,68,600932
chr1,39164632,0.82,68,15,83,600933
chr1,39164798,0.96,81,3,84,600934
chr1,39164826,0.88,78,11,89,600935
chr1,39164852,0.83,71,15,86,600936
chr1,39164880,0.82,55,12,67,600937
chr1,39165128,0.7,58,25,83,600938
chr1,39165215,0.57,46,35,81,600939
chr1,39165233,0.53,42,37,79,600940
chr1,39165460,0.71,75,30,105,600941
chr1,39165495,0.8,98,24,122,600942
chr1,39165569,0.78,96,27,123,600943
chr1,39165668,0.64,52,29,81,600944
chr1,39165786,0.76,45,14,59,600945
chr1,39165815,0.96,53,2,55,600946
chr1,39165850,0.76,51,16,67,600947
chr1,39166288,0.92,65,6,71,600948
chr1,39166297,0.99,70,1,71,600949
chr1,39166315,0.94,74,5,79,600950
chr1,39166390,0.8,73,18,91,600951
chr1,39166707,0.9,70,8,78,600952
chr1,39166711,0.78,56,16,72,600953
chr1,39166802,0.63,36,21,57,600954
chr1,39166900,0.86,73,12,85,600955
chr1,39166906,0.98,89,2,91,600956
chr1,39166921,0.95,91,5,96,600957
chr1,39166928,0.89,90,11,101,600958
chr1,39166951,0.86,93,15,108,600959
chr1,39167014,0.94,105,7,112,600960
chr1,39167067,0.73,82,30,112,600961
chr1,39167076,0.93,100,7,107,600962
chr1,39167196,0.88,102,14,116,600963
chr1,39167409,0.91,83,8,91,600964
chr1,39167422,0.84,76,15,91,600965
chr1,39168197,0.85,57,10,67,600966
chr1,39168601,1,72,0,72,600967
chr1,39168614,1,69,0,69,600968
chr1,39168700,0.68,32,15,47,600969
chr1,39168765,0.83,43,9,52,600970
chr1,39168850,0.77,62,19,81,600971
chr1,39169095,0.89,80,10,90,600972
chr1,39169104,0.96,87,4,91,600973
chr1,39169349,0.6,51,34,85,600974
chr1,39169692,0.61,49,31,80,600975
chr1,39169940,0.91,112,11,123,600976
chr1,39170125,0.98,128,2,130,600977
chr1,39170142,0.81,101,23,124,600978
chr1,39170171,0.77,103,30,133,600979
chr1,39170353,0.83,65,13,78,600980
chr1,39170469,0.83,60,12,72,600981
chr1,39170699,0.81,75,18,93,600982
chr1,39170899,0.92,86,7,93,600983
chr1,39171185,0.85,64,11,75,600984
chr1,39171232,0.94,89,6,95,600985
chr1,39171713,0.54,35,30,65,600986
chr1,39172020,0.61,57,36,93,600987
chr1,39172300,0.94,65,4,69,600988
chr1,39172390,0.74,73,26,99,600989
chr1,39172557,0.86,106,17,123,600990
chr1,39172714,0.88,46,6,52,600991
chr1,39172731,0.97,57,2,59,600992
chr1,39172748,0.92,56,5,61,600993
chr1,39172770,0.7,43,18,61,600994
chr1,39172872,0.42,27,37,64,600995
chr1,39172891,0.81,56,13,69,600996
chr1,39172962,0.86,102,17,119,600997
chr1,39173034,0.86,137,23,160,600998
chr1,39173197,0.83,59,12,71,600999
chr1,39173465,0.89,67,8,75,601000
chr1,39173687,0.96,45,2,47,601001
chr1,39173697,0.95,40,2,42,601002
chr1,39173770,0.33,22,44,66,601003
chr1,39173847,0.9,61,7,68,601004
chr1,39173909,0.83,25,5,30,601005
chr1,39174380,0.96,104,4,108,601006
chr1,39174383,0.86,89,14,103,601007
chr1,39174387,0.96,102,4,106,601008
chr1,39174395,0.97,102,3,105,601009
chr1,39174406,0.97,92,3,95,601010
chr1,39174410,0.94,93,6,99,601011
chr1,39174424,0.95,92,5,97,601012
chr1,39174443,0.94,83,5,88,601013
chr1,39174446,0.94,83,5,88,601014
chr1,39174448,0.97,85,3,88,601015
chr1,39174474,0.95,79,4,83,601016
chr1,39174483,0.79,65,17,82,601017
chr1,39174488,0.86,63,10,73,601018
chr1,39174516,0.93,82,6,88,601019
chr1,39174523,0.95,88,5,93,601020
chr1,39174525,0.97,87,3,90,601021
chr1,39174543,0.98,92,2,94,601022
chr1,39174587,0.88,81,11,92,601023
chr1,39174622,0.94,66,4,70,601024
chr1,39174624,0.92,67,6,73,601025
chr1,39174646,0.93,51,4,55,601026
chr1,39174648,0.94,51,3,54,601027
chr1,39174651,0.98,49,1,50,601028
chr1,39174653,0.97,58,2,60,601029
chr1,39174678,0.82,61,13,74,601030
chr1,39174685,0.89,58,7,65,601031
chr1,39174718,0.98,85,2,87,601032
chr1,39174721,0.97,75,2,77,601033
chr1,39174733,0.95,72,4,76,601034
chr1,39174737,0.93,70,5,75,601035
chr1,39174751,0.99,77,1,78,601036
chr1,39174757,0.95,72,4,76,601037
chr1,39174770,0.99,70,1,71,601038
chr1,39174780,0.93,68,5,73,601039
chr1,39174820,0.97,77,2,79,601040
chr1,39174823,0.91,72,7,79,601041
chr1,39174864,0.94,78,5,83,601042
chr1,39174874,0.99,86,1,87,601043
chr1,39174881,0.95,82,4,86,601044
chr1,39174889,0.96,80,3,83,601045
chr1,39174893,0.96,80,3,83,601046
chr1,39174904,0.88,77,11,88,601047
chr1,39174909,0.9,85,9,94,601048
chr1,39174928,0.93,87,7,94,601049
chr1,39174939,0.95,89,5,94,601050
chr1,39175060,0.66,97,50,147,601051
chr1,39175147,0.86,114,19,133,601052
chr1,39175370,0.8,65,16,81,601053
chr1,39175457,0.92,91,8,99,601054
chr1,39175478,0.67,70,34,104,601055
chr1,39175759,0.99,96,1,97,601056
chr1,39175761,0.99,94,1,95,601057
chr1,39175979,0.86,84,14,98,601058
chr1,39176183,0.72,74,29,103,601059
chr1,39176510,0.93,67,5,72,601060
chr1,39176616,0.83,94,19,113,601061
chr1,39176702,0.92,98,9,107,601062
chr1,39176748,0.75,70,23,93,601063
chr1,39177285,0.94,89,6,95,601064
chr1,39177304,0.94,93,6,99,601065
chr1,39177460,0.92,72,6,78,601066
chr1,39177836,0.69,52,23,75,601067
chr1,39178127,0.67,71,35,106,601068
chr1,39178129,0.53,48,42,90,601069
chr1,39178503,0.85,67,12,79,601070
chr1,39178631,1,113,0,113,601071
chr1,39178648,0.99,105,1,106,601072
chr1,39178787,0.9,54,6,60,601073
chr1,39179003,0.98,95,2,97,601074
chr1,39179013,0.94,88,6,94,601075
chr1,39179015,0.9,84,9,93,601076
chr1,39179214,0.6,38,25,63,601077
chr1,39179329,0.75,67,22,89,601078
chr1,39179411,0.88,83,11,94,601079
chr1,39179770,0.78,85,24,109,601080
chr1,39180410,0.95,41,2,43,601081
chr1,39180591,0.96,76,3,79,601082
chr1,39180594,0.98,78,2,80,601083
chr1,39180880,0.85,94,16,110,601084
chr1,39180998,0.77,80,24,104,601085
chr1,39181260,0.91,60,6,66,601086
chr1,39181303,0.99,81,1,82,601087
chr1,39181311,0.93,76,6,82,601088
chr1,39181331,0.96,80,3,83,601089
chr1,39181336,0.95,79,4,83,601090
chr1,39181408,0.81,91,21,112,601091
chr1,39181431,0.92,102,9,111,601092
chr1,39181448,0.91,96,9,105,601093
chr1,39181466,0.91,98,10,108,601094
chr1,39181490,0.8,78,19,97,601095
chr1,39181718,0.92,83,7,90,601096
chr1,39182016,0.79,95,25,120,601097
chr1,39182103,0.87,111,16,127,601098
chr1,39182983,0.94,31,2,33,601099
chr1,39183029,0.83,15,3,18,601100
chr1,39183160,0.7,52,22,74,601101
chr1,39183591,0.68,79,37,116,601102
chr1,39183621,0.74,78,28,106,601103
chr1,39183860,0.75,77,25,102,601104
chr1,39183865,0.8,82,20,102,601105
chr1,39183884,0.74,81,28,109,601106
chr1,39183906,0.86,91,15,106,601107
chr1,39183937,0.77,92,27,119,601108
chr1,39184012,0.77,85,25,110,601109
chr1,39184041,0.73,75,28,103,601110
chr1,39184081,0.8,74,19,93,601111
chr1,39184131,0.72,70,27,97,601112
chr1,39184330,0.48,46,49,95,601113
chr1,39184513,0.92,116,10,126,601114
chr1,39184671,0.92,82,7,89,601115
chr1,39184691,0.89,89,11,100,601116
chr1,39185235,0.95,57,3,60,601117
chr1,39185239,0.98,57,1,58,601118
chr1,39185241,0.96,52,2,54,601119
chr1,39185251,0.98,46,1,47,601120
chr1,39185284,0.92,24,2,26,601121
chr1,39185295,0.92,11,1,12,601122
chr1,39185298,0.7,7,3,10,601123
chr1,39185309,0.92,12,1,13,601124
chr1,39185329,0.88,21,3,24,601125
chr1,39185340,0.93,43,3,46,601126
chr1,39185369,0.9,53,6,59,601127
chr1,39185381,0.98,58,1,59,601128
chr1,39185405,0.96,48,2,50,601129
chr1,39185418,0.98,39,1,40,601130
chr1,39185429,1,23,0,23,601131
chr1,39185436,0.95,21,1,22,601132
chr1,39185444,1,18,0,18,601133
chr1,39185461,0.92,12,1,13,601134
chr1,39185469,0.93,14,1,15,601135
chr1,39185491,0.73,8,3,11,601136
chr1,39185710,0.72,67,26,93,601137
chr1,39185757,0.9,65,7,72,601138
chr1,39185776,0.45,29,36,65,601139
chr1,39185780,0.83,53,11,64,601140
chr1,39185811,0.65,37,20,57,601141
chr1,39185864,0.88,52,7,59,601142
chr1,39185901,0.78,51,14,65,601143
chr1,39186151,0.71,66,27,93,601144
chr1,39186306,0.56,24,19,43,601145
chr1,39186322,0.68,41,19,60,601146
chr1,39186903,0.55,57,47,104,601147
chr1,39187004,0.68,78,36,114,601148
chr1,39187097,0.43,53,69,122,601149
chr1,39187240,0.7,54,23,77,601150
chr1,39187256,0.83,60,12,72,601151
chr1,39187277,0.75,50,17,67,601152
chr1,39187314,0.91,69,7,76,601153
chr1,39187368,0.95,83,4,87,601154
chr1,39187410,0.93,81,6,87,601155
chr1,39187441,0.96,87,4,91,601156
chr1,39187455,0.86,74,12,86,601157
chr1,39187466,0.96,74,3,77,601158
chr1,39187499,1,76,0,76,601159
chr1,39187511,0.98,79,2,81,601160
chr1,39187515,0.87,76,11,87,601161
chr1,39187607,0.62,50,31,81,601162
chr1,39187964,0.91,64,6,70,601163
chr1,39188141,0.95,60,3,63,601164
chr1,39188179,0.91,73,7,80,601165
chr1,39188218,0.87,97,14,111,601166
chr1,39188225,0.96,106,4,110,601167
chr1,39188246,0.97,103,3,106,601168
chr1,39188372,0.95,78,4,82,601169
chr1,39188417,0.99,83,1,84,601170
chr1,39188431,0.96,78,3,81,601171
chr1,39188481,0.96,90,4,94,601172
chr1,39188528,0.86,88,14,102,601173
chr1,39188678,0.85,86,15,101,601174
chr1,39188858,0.98,53,1,54,601175
chr1,39188939,0.98,55,1,56,601176
chr1,39188956,0.91,58,6,64,601177
chr1,39189004,0.95,75,4,79,601178
chr1,39189024,0.97,85,3,88,601179
chr1,39189051,0.94,88,6,94,601180
chr1,39189349,0.75,76,26,102,601181
chr1,39189814,0.71,72,30,102,601182
chr1,39189928,0.28,31,79,110,601183
chr1,39190061,0.38,37,60,97,601184
chr1,39190358,0.67,73,36,109,601185
chr1,39190385,0.49,52,54,106,601186
chr1,39190439,0.54,54,46,100,601187
chr1,39190482,0.45,49,60,109,601188
chr1,39190488,0.75,82,27,109,601189
chr1,39190902,0.95,80,4,84,601190
chr1,39191073,0.63,43,25,68,601191
chr1,39191099,0.79,64,17,81,601192
chr1,39191172,0.59,41,28,69,601193
chr1,39191303,0.91,81,8,89,601194
chr1,39191369,0.89,120,15,135,601195
chr1,39191371,0.91,127,12,139,601196
chr1,39191432,0.95,135,7,142,601197
chr1,39191516,0.86,97,16,113,601198
chr1,39192002,0.93,93,7,100,601199
chr1,39192043,1,123,0,123,601200
chr1,39192290,0.86,74,12,86,601201
chr1,39192359,0.97,66,2,68,601202
chr1,39192437,0.96,50,2,52,601203
chr1,39192558,0.88,74,10,84,601204
chr1,39192657,0.99,99,1,100,601205
chr1,39192680,0.92,83,7,90,601206
chr1,39192693,0.96,101,4,105,601207
chr1,39192934,0.82,80,18,98,601208
chr1,39192989,0.5,71,72,143,601209
chr1,39193004,0.92,130,12,142,601210
chr1,39193023,0.52,82,76,158,601211
chr1,39193038,0.78,125,36,161,601212
chr1,39193051,0.93,140,10,150,601213
chr1,39193154,0.73,72,26,98,601214
chr1,39193252,0.77,81,24,105,601215
chr1,39193278,0.86,89,15,104,601216
chr1,39193457,0.16,14,75,89,601217
chr1,39193486,0,0,98,98,601218
chr1,39193537,0.02,2,113,115,601219
chr1,39193565,0.02,2,91,93,601220
chr1,39193606,0.04,3,67,70,601221
chr1,39193685,0.02,1,49,50,601222
chr1,39193863,0.11,5,41,46,601223
chr1,39193875,0.06,3,48,51,601224
chr1,39193930,0.03,1,30,31,601225
chr1,39193952,0,0,34,34,601226
chr1,39194042,0,0,50,50,601227
chr1,39194064,0,0,46,46,601228
chr1,39194066,0.02,1,48,49,601229
chr1,39194129,0,0,64,64,601230
chr1,39194154,0,0,83,83,601231
chr1,39194173,0.01,1,99,100,601232
chr1,39194202,0.01,1,90,91,601233
chr1,39194234,0,0,89,89,601234
chr1,39194245,0,0,83,83,601235
chr1,39194477,0.05,3,61,64,601236
chr1,39194716,0.42,39,53,92,601237
chr1,39194803,0.77,41,12,53,601238
chr1,39194812,0.85,46,8,54,601239
chr1,39194818,0.77,43,13,56,601240
chr1,39194949,0.81,42,10,52,601241
chr1,39194989,0.58,30,22,52,601242
chr1,39194994,0.96,52,2,54,601243
chr1,39195045,0.82,63,14,77,601244
chr1,39195073,0.94,94,6,100,601245
chr1,39195089,0.87,102,15,117,601246
chr1,39195101,0.89,109,13,122,601247
chr1,39195131,0.83,108,22,130,601248
chr1,39195173,0.85,87,15,102,601249
chr1,39195211,0.67,36,18,54,601250
chr1,39195401,0.44,16,20,36,601251
chr1,39195469,0.76,31,10,41,601252
chr1,39195614,0.58,66,47,113,601253
chr1,39195672,0.84,83,16,99,601254
chr1,39195730,0.89,64,8,72,601255
chr1,39195831,0.75,85,29,114,601256
chr1,39196413,0.57,64,49,113,601257
chr1,39196465,0.8,99,24,123,601258
chr1,39196952,0.92,73,6,79,601259
chr1,39196971,0.93,75,6,81,601260
chr1,39197017,0.95,93,5,98,601261
chr1,39197049,0.85,88,15,103,601262
chr1,39197690,0.94,60,4,64,601263
chr1,39198025,0.65,74,39,113,601264
chr1,39198033,0.91,105,10,115,601265
chr1,39198232,0.76,42,13,55,601266
chr1,39198344,0.65,57,31,88,601267
chr1,39198545,0.76,85,27,112,601268
chr1,39198570,0.85,83,15,98,601269
chr1,39198835,0.69,53,24,77,601270
chr1,39199072,0.84,110,21,131,601271
chr1,39199098,0.6,84,55,139,601272
chr1,39199113,0.3,45,105,150,601273
chr1,39199163,0.66,83,42,125,601274
chr1,39199504,0.3,26,61,87,601275
chr1,39199606,0.37,42,71,113,601276
chr1,39199608,0.57,65,50,115,601277
chr1,39199832,0.18,23,108,131,601278
chr1,39199930,0.38,35,56,91,601279
chr1,39200413,0.97,77,2,79,601280
chr1,39200492,0.84,72,14,86,601281
chr1,39200818,0.84,87,16,103,601282
chr1,39200880,0.87,48,7,55,601283
chr1,39201367,0.96,108,5,113,601284
chr1,39201448,0.72,79,31,110,601285
chr1,39201518,0.86,75,12,87,601286
chr1,39201662,0.7,51,22,73,601287
chr1,39201670,0.87,66,10,76,601288
chr1,39201725,0.64,57,32,89,601289
chr1,39202388,0.97,86,3,89,601290
chr1,39202489,0.88,81,11,92,601291
chr1,39202590,0.93,74,6,80,601292
chr1,39202700,0.85,95,17,112,601293
chr1,39202724,0.96,110,4,114,601294
chr1,39202737,0.87,97,15,112,601295
chr1,39202774,0.94,104,7,111,601296
chr1,39202811,0.85,84,15,99,601297
chr1,39202854,0.95,71,4,75,601298
chr1,39202861,0.92,71,6,77,601299
chr1,39202922,0.91,78,8,86,601300
chr1,39202926,0.96,76,3,79,601301
chr1,39202966,0.96,43,2,45,601302
chr1,39202975,0.93,37,3,40,601303
chr1,39202982,0.76,29,9,38,601304
chr1,39202996,0.91,40,4,44,601305
chr1,39203016,0.96,46,2,48,601306
chr1,39203027,0.95,55,3,58,601307
chr1,39203062,0.96,78,3,81,601308
chr1,39203066,0.97,74,2,76,601309
chr1,39203098,0.92,80,7,87,601310
chr1,39203103,0.95,80,4,84,601311
chr1,39203122,0.9,71,8,79,601312
chr1,39203154,0.88,53,7,60,601313
chr1,39203192,1,34,0,34,601314
chr1,39203202,0.9,26,3,29,601315
chr1,39203519,0.94,78,5,83,601316
chr1,39203537,0.98,89,2,91,601317
chr1,39203712,0.71,50,20,70,601318
chr1,39203835,0.89,77,10,87,601319
chr1,39203913,0.82,84,18,102,601320
chr1,39203949,0.78,74,21,95,601321
chr1,39204025,0.78,49,14,63,601322
chr1,39204039,0.76,56,18,74,601323
chr1,39204115,0.49,39,40,79,601324
chr1,39204211,0.93,94,7,101,601325
chr1,39204308,0.86,101,16,117,601326
chr1,39204367,0.89,96,12,108,601327
chr1,39204500,0.76,78,24,102,601328
chr1,39204535,0.95,91,5,96,601329
chr1,39204574,0.95,82,4,86,601330
chr1,39204598,0.96,106,4,110,601331
chr1,39204649,0.9,112,12,124,601332
chr1,39204697,0.89,108,13,121,601333
chr1,39204785,0.73,92,34,126,601334
chr1,39204902,0.93,99,8,107,601335
chr1,39204940,0.92,82,7,89,601336
chr1,39205056,0.86,48,8,56,601337
chr1,39205070,0.93,50,4,54,601338
chr1,39205357,0.81,42,10,52,601339
chr1,39205567,0.5,50,50,100,601340
chr1,39205774,0.73,69,25,94,601341
chr1,39205979,0.43,35,47,82,601342
chr1,39206216,0.57,63,48,111,601343
chr1,39206321,0.44,41,53,94,601344
chr1,39206367,0.69,42,19,61,601345
chr1,39206408,0.32,24,51,75,601346
chr1,39206479,0.12,8,61,69,601347
chr1,39206492,0.1,7,60,67,601348
chr1,39206588,0.96,74,3,77,601349
chr1,39206637,0.53,30,27,57,601350
chr1,39206733,0.94,62,4,66,601351
chr1,39206741,0.89,62,8,70,601352
chr1,39206976,0.68,60,28,88,601353
chr1,39206989,0.98,88,2,90,601354
chr1,39207017,0.6,64,42,106,601355
chr1,39207116,0.72,75,29,104,601356
chr1,39207132,0.62,62,38,100,601357
chr1,39207161,0.85,81,14,95,601358
chr1,39207255,0.74,42,15,57,601359
chr1,39207261,0.98,54,1,55,601360
chr1,39207291,0.95,42,2,44,601361
chr1,39207314,1,46,0,46,601362
chr1,39207364,0.87,45,7,52,601363
chr1,39207427,0.97,56,2,58,601364
chr1,39207431,0.98,60,1,61,601365
chr1,39207470,0.97,75,2,77,601366
chr1,39207476,0.96,70,3,73,601367
chr1,39207562,0.93,65,5,70,601368
chr1,39207606,0.94,65,4,69,601369
chr1,39207917,1,49,0,49,601370
chr1,39208028,0.82,58,13,71,601371
chr1,39208250,0.83,58,12,70,601372
chr1,39208280,0.96,75,3,78,601373
chr1,39208317,0.83,66,14,80,601374
chr1,39208381,0.97,59,2,61,601375
chr1,39208576,0.59,57,40,97,601376
chr1,39208665,0.96,90,4,94,601377
chr1,39208759,0.96,111,5,116,601378
chr1,39208921,0.92,81,7,88,601379
chr1,39209323,0.95,77,4,81,601380
chr1,39209349,0.79,79,21,100,601381
chr1,39209356,0.84,89,17,106,601382
chr1,39209362,0.91,87,9,96,601383
chr1,39209420,0.76,92,29,121,601384
chr1,39209460,0.89,102,12,114,601385
chr1,39209476,0.88,96,13,109,601386
chr1,39209506,0.9,92,10,102,601387
chr1,39209767,0.97,75,2,77,601388
chr1,39209909,0.96,94,4,98,601389
chr1,39209931,0.99,95,1,96,601390
chr1,39209941,0.91,88,9,97,601391
chr1,39209971,0.93,82,6,88,601392
chr1,39209982,0.99,92,1,93,601393
chr1,39209984,0.98,92,2,94,601394
chr1,39209994,0.91,80,8,88,601395
chr1,39210003,0.94,83,5,88,601396
chr1,39210045,0.98,99,2,101,601397
chr1,39210122,0.89,73,9,82,601398
chr1,39210154,0.9,57,6,63,601399
chr1,39210298,0.98,57,1,58,601400
chr1,39210333,0.44,34,44,78,601401
chr1,39210763,0.62,37,23,60,601402
chr1,39210802,0.99,72,1,73,601403
chr1,39210810,0.96,78,3,81,601404
chr1,39210823,0.95,86,5,91,601405
chr1,39210886,0.97,68,2,70,601406
chr1,39210890,0.94,61,4,65,601407
chr1,39210898,1,70,0,70,601408
chr1,39211133,0.89,54,7,61,601409
chr1,39211157,0.96,47,2,49,601410
chr1,39211185,0.95,52,3,55,601411
chr1,39211200,0.89,51,6,57,601412
chr1,39211211,0.9,46,5,51,601413
chr1,39211260,0.88,57,8,65,601414
chr1,39211281,0.83,66,14,80,601415
chr1,39211433,0.93,92,7,99,601416
chr1,39211562,0.83,86,17,103,601417
chr1,39211699,0.38,51,83,134,601418
chr1,39212108,0.08,6,66,72,601419
chr1,39212250,0.36,21,37,58,601420
chr1,39212351,0.04,3,82,85,601421
chr1,39212461,0.49,43,44,87,601422
chr1,39212500,0.29,24,58,82,601423
chr1,39212581,0.16,12,64,76,601424
chr1,39212675,0.4,26,39,65,601425
chr1,39212701,0.48,28,30,58,601426
chr1,39212727,0.82,41,9,50,601427
chr1,39212752,0.26,16,46,62,601428
chr1,39212873,0.62,45,28,73,601429
chr1,39212920,0.84,76,15,91,601430
chr1,39212922,0.9,87,10,97,601431
chr1,39212968,0.88,90,12,102,601432
chr1,39212988,0.58,67,49,116,601433
chr1,39213040,0.82,99,22,121,601434
chr1,39213050,0.55,63,52,115,601435
chr1,39213089,0.74,66,23,89,601436
chr1,39213108,0.83,57,12,69,601437
chr1,39213130,0.89,39,5,44,601438
chr1,39213182,0.85,44,8,52,601439
chr1,39213186,0.77,46,14,60,601440
chr1,39213298,1,55,0,55,601441
chr1,39213383,0.64,23,13,36,601442
chr1,39213488,0.92,46,4,50,601443
chr1,39213538,0.78,45,13,58,601444
chr1,39213555,0.55,32,26,58,601445
chr1,39213603,0.42,20,28,48,601446
chr1,39213662,0.96,48,2,50,601447
chr1,39213928,0.97,95,3,98,601448
chr1,39214207,0.88,63,9,72,601449
chr1,39214413,0.97,69,2,71,601450
chr1,39214500,0.72,51,20,71,601451
chr1,39214548,0.61,23,15,38,601452
chr1,39214570,0.94,59,4,63,601453
chr1,39214686,0.77,82,25,107,601454
chr1,39214827,0.92,88,8,96,601455
chr1,39214836,0.93,82,6,88,601456
chr1,39214918,0.87,74,11,85,601457
chr1,39215096,0.92,60,5,65,601458
chr1,39215282,0.9,79,9,88,601459
chr1,39215383,0.7,78,33,111,601460
chr1,39215397,0.89,103,13,116,601461
chr1,39215477,0.86,96,16,112,601462
chr1,39215842,0.9,37,4,41,601463
chr1,39215846,0.83,40,8,48,601464
chr1,39215862,0.86,42,7,49,601465
chr1,39216061,0.64,52,29,81,601466
chr1,39216377,0.77,73,22,95,601467
chr1,39216857,0.9,85,9,94,601468
chr1,39216876,0.46,43,50,93,601469
chr1,39216918,0.9,82,9,91,601470
chr1,39217357,0.76,94,29,123,601471
chr1,39217611,0.92,95,8,103,601472
chr1,39217731,0.89,119,15,134,601473
chr1,39217792,0.83,111,22,133,601474
chr1,39217923,0.81,103,24,127,601475
chr1,39217958,0.68,99,47,146,601476
chr1,39217992,0.6,84,57,141,601477
chr1,39218513,0.36,27,49,76,601478
chr1,39218621,0.86,66,11,77,601479
chr1,39218671,0.63,49,29,78,601480
chr1,39218904,0.7,31,13,44,601481
chr1,39218912,0.72,36,14,50,601482
chr1,39219043,0.82,73,16,89,601483
chr1,39219384,0.86,81,13,94,601484
chr1,39219427,0.36,34,61,95,601485
chr1,39219521,0.78,38,11,49,601486
chr1,39219924,0.93,99,7,106,601487
chr1,39219957,0.87,77,12,89,601488
chr1,39220103,0.6,52,34,86,601489
chr1,39220147,0.77,67,20,87,601490
chr1,39220432,0.92,82,7,89,601491
chr1,39220449,0.91,85,8,93,601492
chr1,39220548,0.62,39,24,63,601493
chr1,39220637,0.88,36,5,41,601494
chr1,39220643,0.82,36,8,44,601495
chr1,39220783,0.77,55,16,71,601496
chr1,39220928,0.83,62,13,75,601497
chr1,39220935,0.78,51,14,65,601498
chr1,39220987,0.97,57,2,59,601499
chr1,39220999,0.76,50,16,66,601500
chr1,39221226,0.68,65,30,95,601501
chr1,39221364,0.82,51,11,62,601502
chr1,39221394,0.82,63,14,77,601503
chr1,39221411,0.98,82,2,84,601504
chr1,39221428,0.98,89,2,91,601505
chr1,39221482,0.96,103,4,107,601506
chr1,39221545,0.81,80,19,99,601507
chr1,39221577,0.96,87,4,91,601508
chr1,39221673,0.97,67,2,69,601509
chr1,39221713,0.93,78,6,84,601510
chr1,39221757,0.99,92,1,93,601511
chr1,39221759,0.98,86,2,88,601512
chr1,39221963,0.65,76,41,117,601513
chr1,39222012,0.82,108,23,131,601514
chr1,39222155,0.94,46,3,49,601515
chr1,39222185,0.72,36,14,50,601516
chr1,39222255,0.8,53,13,66,601517
chr1,39222411,0.93,93,7,100,601518
chr1,39222861,0.13,12,78,90,601519
chr1,39223040,0.23,21,70,91,601520
chr1,39223265,0.77,58,17,75,601521
chr1,39223476,0.66,46,24,70,601522
chr1,39223738,0.89,55,7,62,601523
chr1,39223762,0.83,53,11,64,601524
chr1,39223901,0.74,55,19,74,601525
chr1,39223917,0.88,64,9,73,601526
chr1,39223963,0.85,63,11,74,601527
chr1,39223999,0.89,56,7,63,601528
chr1,39224248,0.85,67,12,79,601529
chr1,39224582,0.66,85,43,128,601530
chr1,39224620,0.86,105,17,122,601531
chr1,39224639,0.28,33,83,116,601532
chr1,39224786,0.58,51,37,88,601533
chr1,39224855,0.9,63,7,70,601534
chr1,39224913,0.88,61,8,69,601535
chr1,39225027,0.88,59,8,67,601536
chr1,39225093,0.97,76,2,78,601537
chr1,39225225,0.86,95,15,110,601538
chr1,39225557,0.95,40,2,42,601539
chr1,39225577,0.96,50,2,52,601540
chr1,39225648,0.75,68,23,91,601541
chr1,39226014,0.93,66,5,71,601542
chr1,39226031,0.8,68,17,85,601543
chr1,39226053,0.85,82,14,96,601544
chr1,39226085,0.95,125,6,131,601545
chr1,39226181,0.7,74,31,105,601546
chr1,39226209,0.68,79,37,116,601547
chr1,39226511,0.93,94,7,101,601548
chr1,39226556,0.31,36,82,118,601549
chr1,39226711,0.86,86,14,100,601550
chr1,39226806,0.93,70,5,75,601551
chr1,39226982,0.76,82,26,108,601552
chr1,39227006,0.96,103,4,107,601553
chr1,39227011,0.95,106,5,111,601554
chr1,39227056,0.89,90,11,101,601555
chr1,39227099,0.93,101,8,109,601556
chr1,39227131,0.45,46,57,103,601557
chr1,39227411,0.91,74,7,81,601558
chr1,39227487,0.97,93,3,96,601559
chr1,39227627,0.76,62,20,82,601560
chr1,39227702,0.71,49,20,69,601561
chr1,39227923,0.92,109,9,118,601562
chr1,39227949,0.48,58,64,122,601563
chr1,39228049,0.86,79,13,92,601564
chr1,39228134,0.84,56,11,67,601565
chr1,39228323,0.76,32,10,42,601566
chr1,39228471,0.89,54,7,61,601567
chr1,39228627,0.8,59,15,74,601568
chr1,39228640,0.99,73,1,74,601569
chr1,39228668,0.93,87,7,94,601570
chr1,39228832,0.89,70,9,79,601571
chr1,39228879,0.73,74,28,102,601572
chr1,39228989,0.56,52,41,93,601573
chr1,39229040,0.7,78,33,111,601574
chr1,39229089,0.44,51,64,115,601575
chr1,39229113,0.59,57,40,97,601576
chr1,39229246,0,0,47,47,601577
chr1,39229513,0.91,58,6,64,601578
chr1,39229540,0.25,19,58,77,601579
chr1,39229568,0.66,48,25,73,601580
chr1,39229723,0.5,1,1,2,601581
chr1,39229739,0,0,2,2,601582
chr1,39229761,0.5,1,1,2,601583
chr1,39229825,0,0,1,1,601584
chr1,39229845,0.88,7,1,8,601585
chr1,39229849,0.86,18,3,21,601586
chr1,39229857,0.89,24,3,27,601587
chr1,39229901,0.85,56,10,66,601588
chr1,39229921,0.94,68,4,72,601589
chr1,39229935,0.84,65,12,77,601590
chr1,39229942,0.94,73,5,78,601591
chr1,39230181,0.74,43,15,58,601592
chr1,39230410,0.76,111,35,146,601593
chr1,39230545,0.69,44,20,64,601594
chr1,39230821,0.84,54,10,64,601595
chr1,39231068,0.85,98,17,115,601596
chr1,39231275,0.75,77,25,102,601597
chr1,39231424,0.56,39,31,70,601598
chr1,39231459,0.09,10,100,110,601599
chr1,39231518,0.46,56,66,122,601600
chr1,39231804,0.88,84,12,96,601601
chr1,39231843,0.68,67,31,98,601602
chr1,39231881,0.58,54,39,93,601603
chr1,39231973,0.53,49,44,93,601604
chr1,39232009,0.96,92,4,96,601605
chr1,39232050,0.93,87,7,94,601606
chr1,39232099,0.79,59,16,75,601607
chr1,39232325,0.98,82,2,84,601608
chr1,39232381,0.95,93,5,98,601609
chr1,39232419,0.68,65,31,96,601610
chr1,39232512,0.8,55,14,69,601611
chr1,39232567,0.94,58,4,62,601612
chr1,39232725,0.97,71,2,73,601613
chr1,39232770,0.94,93,6,99,601614
chr1,39232844,0.89,91,11,102,601615
chr1,39232980,0.93,62,5,67,601616
chr1,39233114,0.9,72,8,80,601617
chr1,39233266,0.75,45,15,60,601618
chr1,39233402,0.95,86,5,91,601619
chr1,39233419,0.98,95,2,97,601620
chr1,39233440,0.97,89,3,92,601621
chr1,39233465,0.91,88,9,97,601622
chr1,39233473,0.93,87,7,94,601623
chr1,39233505,0.78,58,16,74,601624
chr1,39233536,0.8,44,11,55,601625
chr1,39233550,0.49,33,35,68,601626
chr1,39233559,0.45,34,42,76,601627
chr1,39233563,0.8,43,11,54,601628
chr1,39233606,0.65,54,29,83,601629
chr1,39233875,0.81,56,13,69,601630
chr1,39233877,0.89,64,8,72,601631
chr1,39233973,0.66,64,33,97,601632
chr1,39234037,0.77,77,23,100,601633
chr1,39234107,0.94,51,3,54,601634
chr1,39234186,0.95,19,1,20,601635
chr1,39234628,0.94,16,1,17,601636
chr1,39234678,0.89,64,8,72,601637
chr1,39234764,0.89,85,10,95,601638
chr1,39234854,1,25,0,25,601639
chr1,39235095,0.91,49,5,54,601640
chr1,39235308,0.8,4,1,5,601641
chr1,39235416,1,10,0,10,601642
chr1,39235543,0.93,13,1,14,601643
chr1,39235592,0.6,3,2,5,601644
chr1,39235706,0.96,53,2,55,601645
chr1,39235764,0.86,18,3,21,601646
chr1,39236455,0.85,22,4,26,601647
chr1,39236755,0.94,61,4,65,601648
chr1,39236778,1,42,0,42,601649
chr1,39236850,1,17,0,17,601650
chr1,39236918,0.88,14,2,16,601651
chr1,39236977,0.83,39,8,47,601652
chr1,39237099,0.8,72,18,90,601653
chr1,39237246,0.95,54,3,57,601654
chr1,39237358,0.69,57,26,83,601655
chr1,39237383,0.8,75,19,94,601656
chr1,39237553,0.71,55,23,78,601657
chr1,39237610,0.45,38,47,85,601658
chr1,39237662,0.88,81,11,92,601659
chr1,39237755,0.42,27,38,65,601660
chr1,39237787,0.28,20,51,71,601661
chr1,39237944,0.66,45,23,68,601662
chr1,39238094,0.65,47,25,72,601663
chr1,39238104,0.53,38,34,72,601664
chr1,39238155,0.91,50,5,55,601665
chr1,39238261,0.8,70,17,87,601666
chr1,39238360,0.95,61,3,64,601667
chr1,39238448,0.9,61,7,68,601668
chr1,39238750,0.43,34,46,80,601669
chr1,39238862,0.15,14,77,91,601670
chr1,39238895,0.25,26,76,102,601671
chr1,39239394,0.12,7,50,57,601672
chr1,39239505,0.83,64,13,77,601673
chr1,39239622,0.92,56,5,61,601674
chr1,39239815,0.92,68,6,74,601675
chr1,39239832,0.96,76,3,79,601676
chr1,39239849,0.55,40,33,73,601677
chr1,39239904,0.99,90,1,91,601678
chr1,39239944,0.98,82,2,84,601679
chr1,39239967,0.93,81,6,87,601680
chr1,39239979,0.96,76,3,79,601681
chr1,39239990,0.91,71,7,78,601682
chr1,39240027,0.91,68,7,75,601683
chr1,39240197,0.73,71,26,97,601684
chr1,39240238,0.95,54,3,57,601685
chr1,39240307,0.84,48,9,57,601686
chr1,39240400,0.81,92,22,114,601687
chr1,39240440,0.87,103,15,118,601688
chr1,39240452,0.94,110,7,117,601689
chr1,39240528,0.82,84,19,103,601690
chr1,39240570,0.89,80,10,90,601691
chr1,39240667,0.99,76,1,77,601692
chr1,39240707,0.78,80,22,102,601693
chr1,39240734,0.47,51,57,108,601694
chr1,39240755,0.23,26,85,111,601695
chr1,39240872,0.44,32,40,72,601696
chr1,39240893,0.89,70,9,79,601697
chr1,39240942,0.88,79,11,90,601698
chr1,39241273,0.54,65,55,120,601699
chr1,39241349,0.65,60,32,92,601700
chr1,39241394,0.89,75,9,84,601701
chr1,39241420,0.7,75,32,107,601702
chr1,39241433,0.44,47,59,106,601703
chr1,39241482,0.8,75,19,94,601704
chr1,39241539,0.77,64,19,83,601705
chr1,39241563,0.69,57,26,83,601706
chr1,39241644,0.94,59,4,63,601707
chr1,39241660,0.93,53,4,57,601708
chr1,39241693,0.89,49,6,55,601709
chr1,39241704,0.88,42,6,48,601710
chr1,39241718,0.96,44,2,46,601711
chr1,39241749,0.95,40,2,42,601712
chr1,39241783,0.92,46,4,50,601713
chr1,39241795,0.96,44,2,46,601714
chr1,39241871,0.83,35,7,42,601715
chr1,39241901,0.87,26,4,30,601716
chr1,39241917,0.84,26,5,31,601717
chr1,39242854,0.45,50,61,111,601718
chr1,39242869,0.47,47,52,99,601719
chr1,39242902,0.93,82,6,88,601720
chr1,39242929,0.78,67,19,86,601721
chr1,39243046,0.92,82,7,89,601722
chr1,39243048,0.91,82,8,90,601723
chr1,39243383,0.17,15,72,87,601724
chr1,39243439,0.64,51,29,80,601725
chr1,39243493,0.66,66,34,100,601726
chr1,39243515,0.94,97,6,103,601727
chr1,39243546,0.76,88,28,116,601728
chr1,39243589,0.9,94,10,104,601729
chr1,39243641,0.45,35,43,78,601730
chr1,39243777,0.85,57,10,67,601731
chr1,39243868,0.65,37,20,57,601732
chr1,39244126,0.66,63,32,95,601733
chr1,39244255,0.34,26,50,76,601734
chr1,39244596,0.6,18,12,30,601735
chr1,39244612,0.83,34,7,41,601736
chr1,39244626,0.87,41,6,47,601737
chr1,39244641,0.72,41,16,57,601738
chr1,39244665,0.76,52,16,68,601739
chr1,39244697,0.79,52,14,66,601740
chr1,39244729,0.93,37,3,40,601741
chr1,39244762,0.88,37,5,42,601742
chr1,39244860,0.98,53,1,54,601743
chr1,39244866,0.88,58,8,66,601744
chr1,39244973,0.82,86,19,105,601745
chr1,39245141,0.88,71,10,81,601746
chr1,39245233,0.78,79,22,101,601747
chr1,39245330,0.64,36,20,56,601748
chr1,39245351,0.56,35,27,62,601749
chr1,39245445,0.26,18,52,70,601750
chr1,39245457,0.72,51,20,71,601751
chr1,39245990,0.29,26,64,90,601752
chr1,39246088,0.72,79,30,109,601753
chr1,39246112,0.81,61,14,75,601754
chr1,39246163,0.84,49,9,58,601755
chr1,39246399,0.75,76,26,102,601756
chr1,39246452,0.98,83,2,85,601757
chr1,39246658,0.85,39,7,46,601758
chr1,39246804,0.5,44,44,88,601759
chr1,39246840,0.74,64,22,86,601760
chr1,39246898,0.76,62,20,82,601761
chr1,39247094,0.85,39,7,46,601762
chr1,39247102,0.83,45,9,54,601763
chr1,39247271,0.77,99,29,128,601764
chr1,39247277,0.97,112,3,115,601765
chr1,39247306,0.57,68,52,120,601766
chr1,39247539,0.66,67,34,101,601767
chr1,39247698,0.23,22,74,96,601768
chr1,39247945,0.91,80,8,88,601769
chr1,39248108,0.29,26,65,91,601770
chr1,39248258,0.71,79,33,112,601771
chr1,39248372,0.67,78,38,116,601772
chr1,39248481,0.73,58,22,80,601773
chr1,39248499,0.51,40,39,79,601774
chr1,39248524,0.57,45,34,79,601775
chr1,39248529,0.88,73,10,83,601776
chr1,39248622,0.83,92,19,111,601777
chr1,39248870,0.46,49,57,106,601778
chr1,39248918,0.39,45,70,115,601779
chr1,39249117,0.15,11,62,73,601780
chr1,39249180,0.3,23,53,76,601781
chr1,39249207,0.14,11,67,78,601782
chr1,39249262,0.03,2,78,80,601783
chr1,39249301,0.02,1,61,62,601784
chr1,39249315,0,0,65,65,601785
chr1,39249352,0,0,13,13,601786
chr1,39249367,0,0,26,26,601787
chr1,39249376,0.02,1,41,42,601788
chr1,39249415,0,0,41,41,601789
chr1,39249425,0,0,41,41,601790
chr1,39249427,0.06,2,33,35,601791
chr1,39249433,0,0,54,54,601792
chr1,39249452,0.02,1,56,57,601793
chr1,39249483,0.03,2,60,62,601794
chr1,39249564,0.05,4,82,86,601795
chr1,39249567,0.14,10,63,73,601796
chr1,39249576,0.16,14,74,88,601797
chr1,39249604,0.05,5,94,99,601798
chr1,39249632,0.15,15,82,97,601799
chr1,39249664,0.17,15,74,89,601800
chr1,39249667,0.11,12,95,107,601801
chr1,39249681,0.23,21,72,93,601802
chr1,39249683,0.25,19,57,76,601803
chr1,39249689,0.14,14,86,100,601804
chr1,39249693,0.11,11,90,101,601805
chr1,39249705,0.06,6,97,103,601806
chr1,39249719,0.2,19,75,94,601807
chr1,39249721,0.23,21,71,92,601808
chr1,39249723,0.24,23,71,94,601809
chr1,39249733,0.2,19,75,94,601810
chr1,39249739,0.16,11,59,70,601811
chr1,39249748,0.16,13,66,79,601812
chr1,39249764,0.12,8,61,69,601813
chr1,39249784,0.14,6,38,44,601814
chr1,39249833,0.02,1,44,45,601815
chr1,39249839,0.05,2,39,41,601816
chr1,39249845,0.24,10,31,41,601817
chr1,39250039,0.82,46,10,56,601818
chr1,39250239,0.71,55,22,77,601819
chr1,39250279,0.49,44,46,90,601820
chr1,39250386,0.86,86,14,100,601821
chr1,39250580,0.93,106,8,114,601822
chr1,39250646,0.94,108,7,115,601823
chr1,39250702,0.96,81,3,84,601824
chr1,39250963,0.85,87,15,102,601825
chr1,39251078,0.46,37,43,80,601826
chr1,39251098,0.56,41,32,73,601827
chr1,39251413,0.25,32,98,130,601828
chr1,39251697,0.68,17,8,25,601829
chr1,39251782,0.53,24,21,45,601830
chr1,39251856,0.91,48,5,53,601831
chr1,39251872,0.92,44,4,48,601832
chr1,39251882,0.83,52,11,63,601833
chr1,39252083,0.89,54,7,61,601834
chr1,39252087,0.79,48,13,61,601835
chr1,39252263,0.82,72,16,88,601836
chr1,39252330,0.53,49,43,92,601837
chr1,39252429,0.51,63,60,123,601838
chr1,39252435,0.49,58,60,118,601839
chr1,39252478,0.78,85,24,109,601840
chr1,39252489,0.56,58,46,104,601841
chr1,39252546,0.73,61,22,83,601842
chr1,39252549,0.91,70,7,77,601843
chr1,39252553,0.93,67,5,72,601844
chr1,39252573,0.85,61,11,72,601845
chr1,39252597,0.93,63,5,68,601846
chr1,39252613,0.89,59,7,66,601847
chr1,39252629,0.98,58,1,59,601848
chr1,39252635,0.98,52,1,53,601849
chr1,39252659,0.94,31,2,33,601850
chr1,39252667,1,32,0,32,601851
chr1,39252766,0.58,49,35,84,601852
chr1,39252840,0.78,62,17,79,601853
chr1,39252935,0.79,78,21,99,601854
chr1,39253228,0.83,49,10,59,601855
chr1,39253313,0.99,84,1,85,601856
chr1,39253315,0.95,81,4,85,601857
chr1,39253321,0.98,88,2,90,601858
chr1,39253358,0.95,80,4,84,601859
chr1,39253406,0.99,85,1,86,601860
chr1,39253408,0.99,87,1,88,601861
chr1,39253416,0.99,88,1,89,601862
chr1,39253456,1,82,0,82,601863
chr1,39253480,0.57,47,35,82,601864
chr1,39253495,0.96,85,4,89,601865
chr1,39253502,0.94,82,5,87,601866
chr1,39253519,1,78,0,78,601867
chr1,39253536,0.97,72,2,74,601868
chr1,39253574,0.91,67,7,74,601869
chr1,39253702,0.77,66,20,86,601870
chr1,39253773,0.79,59,16,75,601871
chr1,39253950,0.84,95,18,113,601872
chr1,39253960,0.95,118,6,124,601873
chr1,39254052,0.4,60,91,151,601874
chr1,39254078,0.27,40,107,147,601875
chr1,39254120,0.42,58,81,139,601876
chr1,39254176,0.27,31,83,114,601877
chr1,39254182,0.3,32,74,106,601878
chr1,39254255,0.29,25,60,85,601879
chr1,39254454,0.69,55,25,80,601880
chr1,39254528,0.14,10,63,73,601881
chr1,39254577,0.38,32,53,85,601882
chr1,39254680,0.51,54,52,106,601883
chr1,39254812,0.35,19,36,55,601884
chr1,39254897,0.27,35,93,128,601885
chr1,39254902,0.58,73,53,126,601886
chr1,39254917,0.39,54,86,140,601887
chr1,39254967,0.23,35,117,152,601888
chr1,39255317,0.14,14,87,101,601889
chr1,39255359,0.09,9,91,100,601890
chr1,39255421,0.17,18,88,106,601891
chr1,39255547,0.07,5,64,69,601892
chr1,39255707,0.43,27,36,63,601893
chr1,39255868,0.34,32,63,95,601894
chr1,39255927,0.9,63,7,70,601895
chr1,39256113,0.87,58,9,67,601896
chr1,39256200,0.83,35,7,42,601897
chr1,39256264,0.87,53,8,61,601898
chr1,39256299,0.89,57,7,64,601899
chr1,39256337,0.85,57,10,67,601900
chr1,39256411,0.86,63,10,73,601901
chr1,39257796,0.67,46,23,69,601902
chr1,39258036,0.38,38,63,101,601903
chr1,39258477,0.7,66,28,94,601904
chr1,39258500,0.67,60,30,90,601905
chr1,39258559,0.95,71,4,75,601906
chr1,39259689,0.91,93,9,102,601907
chr1,39260242,0.95,121,7,128,601908
chr1,39260592,0.83,83,17,100,601909
chr1,39260886,0.56,53,41,94,601910
chr1,39261151,0.46,47,56,103,601911
chr1,39261387,0.9,102,11,113,601912
chr1,39261788,0.66,95,48,143,601913
chr1,39261837,0.73,119,43,162,601914
chr1,39261880,0.94,125,8,133,601915
chr1,39262009,0.92,70,6,76,601916
chr1,39262014,0.97,71,2,73,601917
chr1,39262024,0.94,64,4,68,601918
chr1,39262057,0.9,55,6,61,601919
chr1,39262082,1,61,0,61,601920
chr1,39262102,0.98,65,1,66,601921
chr1,39262110,0.97,58,2,60,601922
chr1,39262113,0.98,59,1,60,601923
chr1,39262146,0.96,52,2,54,601924
chr1,39262162,0.98,52,1,53,601925
chr1,39262221,0.95,41,2,43,601926
chr1,39262238,0.79,34,9,43,601927
chr1,39262284,0.93,43,3,46,601928
chr1,39262632,0.92,87,8,95,601929
chr1,39262997,0.22,24,86,110,601930
chr1,39263348,0.88,63,9,72,601931
chr1,39263381,0.87,61,9,70,601932
chr1,39263404,1,69,0,69,601933
chr1,39263443,0.89,64,8,72,601934
chr1,39263467,0.99,77,1,78,601935
chr1,39263475,0.87,61,9,70,601936
chr1,39263675,0.71,84,35,119,601937
chr1,39263928,0.9,74,8,82,601938
chr1,39263943,0.93,68,5,73,601939
chr1,39264122,0.9,88,10,98,601940
chr1,39264240,0.77,84,25,109,601941
chr1,39264261,0.96,101,4,105,601942
chr1,39264266,0.92,98,8,106,601943
chr1,39264468,0.64,63,36,99,601944
chr1,39264820,0.96,99,4,103,601945
chr1,39265385,0.77,65,19,84,601946
chr1,39265426,0.97,83,3,86,601947
chr1,39265443,0.96,79,3,82,601948
chr1,39265625,0.8,81,20,101,601949
chr1,39265808,0.62,47,29,76,601950
chr1,39266284,0.79,81,22,103,601951
chr1,39266544,0.82,59,13,72,601952
chr1,39266658,0.96,66,3,69,601953
chr1,39266694,0.62,29,18,47,601954
chr1,39266697,0.87,61,9,70,601955
chr1,39266795,0.88,61,8,69,601956
chr1,39266817,0.92,81,7,88,601957
chr1,39266823,0.8,66,16,82,601958
chr1,39266833,1,77,0,77,601959
chr1,39266839,0.98,85,2,87,601960
chr1,39266897,0.92,73,6,79,601961
chr1,39266907,0.9,70,8,78,601962
chr1,39267123,0.51,23,22,45,601963
chr1,39267153,0.74,45,16,61,601964
chr1,39267196,0.8,43,11,54,601965
chr1,39267227,0.43,17,23,40,601966
chr1,39267332,0.76,52,16,68,601967
chr1,39267478,0.8,35,9,44,601968
chr1,39267541,0.57,27,20,47,601969
chr1,39267685,0.95,88,5,93,601970
chr1,39267695,0.96,87,4,91,601971
chr1,39267741,0.92,87,8,95,601972
chr1,39267762,0.89,95,12,107,601973
chr1,39267855,0.97,77,2,79,601974
chr1,39267892,0.97,71,2,73,601975
chr1,39267936,0.79,52,14,66,601976
chr1,39268272,0.8,55,14,69,601977
chr1,39268636,0.79,86,23,109,601978
chr1,39268961,0.86,64,10,74,601979
chr1,39268965,0.95,69,4,73,601980
chr1,39268967,0.9,69,8,77,601981
chr1,39269010,0.95,73,4,77,601982
chr1,39269037,0.89,63,8,71,601983
chr1,39269040,0.91,68,7,75,601984
chr1,39269060,0.97,74,2,76,601985
chr1,39269096,0.67,58,28,86,601986
chr1,39269100,0.94,75,5,80,601987
chr1,39269102,0.66,56,29,85,601988
chr1,39269104,0.86,73,12,85,601989
chr1,39269154,0.53,60,53,113,601990
chr1,39269161,0.98,102,2,104,601991
chr1,39269178,0.53,55,48,103,601992
chr1,39269186,0.57,54,40,94,601993
chr1,39269208,0.69,42,19,61,601994
chr1,39269307,0.29,14,35,49,601995
chr1,39269401,0.16,15,80,95,601996
chr1,39269438,0.45,44,54,98,601997
chr1,39269509,0.08,11,122,133,601998
chr1,39269537,0.18,22,100,122,601999
chr1,39269645,0.02,2,83,85,602000
chr1,39269659,0.01,1,70,71,602001
chr1,39269693,0,0,80,80,602002
chr1,39269711,0,0,69,69,602003
chr1,39269730,0.06,3,49,52,602004
chr1,39269733,0.02,1,42,43,602005
chr1,39269736,0,0,36,36,602006
chr1,39269740,0,0,54,54,602007
chr1,39269751,0,0,21,21,602008
chr1,39269756,0,0,13,13,602009
chr1,39269762,0,0,30,30,602010
chr1,39269775,0.04,1,27,28,602011
chr1,39269784,0,0,28,28,602012
chr1,39269790,0,0,17,17,602013
chr1,39269793,0,0,24,24,602014
chr1,39269798,0,0,28,28,602015
chr1,39269802,0,0,21,21,602016
chr1,39269804,0.05,1,20,21,602017
chr1,39269806,0,0,21,21,602018
chr1,39269813,0,0,30,30,602019
chr1,39269818,0,0,22,22,602020
chr1,39269823,0,0,31,31,602021
chr1,39269826,0,0,17,17,602022
chr1,39269830,0,0,27,27,602023
chr1,39269839,0,0,25,25,602024
chr1,39269841,0,0,36,36,602025
chr1,39269851,0,0,31,31,602026
chr1,39269854,0,0,41,41,602027
chr1,39269856,0.03,1,36,37,602028
chr1,39269865,0,0,40,40,602029
chr1,39269878,0,0,45,45,602030
chr1,39269880,0,0,41,41,602031
chr1,39269883,0,0,52,52,602032
chr1,39269885,0,0,48,48,602033
chr1,39269895,0,0,36,36,602034
chr1,39269897,0,0,30,30,602035
chr1,39269902,0,0,48,48,602036
chr1,39269909,0,0,47,47,602037
chr1,39269911,0,0,49,49,602038
chr1,39269915,0,0,51,51,602039
chr1,39269917,0,0,55,55,602040
chr1,39269925,0,0,54,54,602041
chr1,39269928,0,0,49,49,602042
chr1,39269947,0,0,42,42,602043
chr1,39269956,0,0,50,50,602044
chr1,39269958,0,0,51,51,602045
chr1,39269965,0,0,52,52,602046
chr1,39269971,0,0,43,43,602047
chr1,39269974,0,0,51,51,602048
chr1,39269977,0,0,56,56,602049
chr1,39269986,0,0,55,55,602050
chr1,39269988,0.02,1,56,57,602051
chr1,39269992,0,0,36,36,602052
chr1,39269995,0,0,51,51,602053
chr1,39270009,0,0,66,66,602054
chr1,39270050,0,0,63,63,602055
chr1,39270058,0,0,59,59,602056
chr1,39270068,0,0,58,58,602057
chr1,39270073,0.02,1,54,55,602058
chr1,39270075,0,0,58,58,602059
chr1,39270079,0,0,60,60,602060
chr1,39270085,0.02,1,49,50,602061
chr1,39270097,0.02,1,54,55,602062
chr1,39270099,0,0,57,57,602063
chr1,39270103,0.03,2,58,60,602064
chr1,39270107,0,0,57,57,602065
chr1,39270136,0,0,41,41,602066
chr1,39270143,0.03,1,37,38,602067
chr1,39270149,0,0,37,37,602068
chr1,39270159,0.03,1,36,37,602069
chr1,39270175,0,0,25,25,602070
chr1,39270179,0,0,25,25,602071
chr1,39270197,0,0,17,17,602072
chr1,39270222,0,0,6,6,602073
chr1,39270239,0,0,7,7,602074
chr1,39270242,0.19,3,13,16,602075
chr1,39270250,0,0,8,8,602076
chr1,39270295,0.11,2,16,18,602077
chr1,39270310,0.06,2,34,36,602078
chr1,39270363,0.17,8,38,46,602079
chr1,39270382,0.02,1,50,51,602080
chr1,39270386,0.08,3,35,38,602081
chr1,39270399,0.04,2,45,47,602082
chr1,39270401,0.1,5,45,50,602083
chr1,39270441,0.16,12,65,77,602084
chr1,39270495,0.2,16,65,81,602085
chr1,39270538,0.28,26,66,92,602086
chr1,39270714,0.3,29,68,97,602087
chr1,39270730,0.21,20,75,95,602088
chr1,39270826,0.58,29,21,50,602089
chr1,39270924,0.68,39,18,57,602090
chr1,39270937,0.88,53,7,60,602091
chr1,39270970,0.56,55,43,98,602092
chr1,39270981,0.94,99,6,105,602093
chr1,39271100,0.41,39,55,94,602094
chr1,39271172,0.75,53,18,71,602095
chr1,39271180,0.91,61,6,67,602096
chr1,39271281,0.71,68,28,96,602097
chr1,39271345,0.95,87,5,92,602098
chr1,39271628,0.76,78,25,103,602099
chr1,39271845,0.94,89,6,95,602100
chr1,39272399,0.91,59,6,65,602101
chr1,39272467,0.96,48,2,50,602102
chr1,39272498,0.94,30,2,32,602103
chr1,39272539,0.96,22,1,23,602104
chr1,39272547,0.92,24,2,26,602105
chr1,39272571,0.87,33,5,38,602106
chr1,39272592,0.81,39,9,48,602107
chr1,39272603,0.88,42,6,48,602108
chr1,39272610,0.93,43,3,46,602109
chr1,39272633,0.85,35,6,41,602110
chr1,39272665,0.89,16,2,18,602111
chr1,39272673,1,13,0,13,602112
chr1,39272850,0.9,36,4,40,602113
chr1,39272950,0.78,18,5,23,602114
chr1,39272995,0.84,31,6,37,602115
chr1,39273023,0.86,42,7,49,602116
chr1,39273267,0.64,27,15,42,602117
chr1,39273304,0.81,47,11,58,602118
chr1,39273332,0.95,53,3,56,602119
chr1,39273356,0.61,36,23,59,602120
chr1,39273407,0.87,53,8,61,602121
chr1,39273427,0.98,59,1,60,602122
chr1,39273470,0.91,70,7,77,602123
chr1,39273489,0.82,69,15,84,602124
chr1,39273510,0.88,76,10,86,602125
chr1,39273581,0.58,52,38,90,602126
chr1,39274143,0.68,69,33,102,602127
chr1,39274301,0.44,41,52,93,602128
chr1,39274314,0.52,57,53,110,602129
chr1,39274387,0.24,23,74,97,602130
chr1,39274780,0.71,64,26,90,602131
chr1,39274934,0.23,10,33,43,602132
chr1,39275009,0.84,68,13,81,602133
chr1,39275031,0.92,86,7,93,602134
chr1,39275043,0.9,90,10,100,602135
chr1,39275193,0.91,84,8,92,602136
chr1,39275204,0.86,78,13,91,602137
chr1,39275510,0.93,52,4,56,602138
chr1,39275715,0.69,34,15,49,602139
chr1,39275741,0.77,47,14,61,602140
chr1,39275785,0.78,58,16,74,602141
chr1,39275882,0.73,71,26,97,602142
chr1,39275947,0.76,71,23,94,602143
chr1,39276072,0.5,44,44,88,602144
chr1,39276087,0.87,72,11,83,602145
chr1,39276140,0.75,70,23,93,602146
chr1,39276148,0.82,78,17,95,602147
chr1,39276157,0.66,61,31,92,602148
chr1,39276541,0.79,89,23,112,602149
chr1,39276578,0.72,73,29,102,602150
chr1,39276694,0.91,67,7,74,602151
chr1,39277059,0.74,75,27,102,602152
chr1,39277107,0.83,83,17,100,602153
chr1,39277123,0.64,56,31,87,602154
chr1,39277151,0.79,45,12,57,602155
chr1,39277235,1,16,0,16,602156
chr1,39277450,0.66,62,32,94,602157
chr1,39277548,0.85,55,10,65,602158
chr1,39277615,0.98,79,2,81,602159
chr1,39277664,0.67,67,33,100,602160
chr1,39277738,0.54,42,36,78,602161
chr1,39277885,0.9,28,3,31,602162
chr1,39277889,0.92,23,2,25,602163
chr1,39277983,0.77,40,12,52,602164
chr1,39278156,0.89,64,8,72,602165
chr1,39278377,0.41,31,44,75,602166
chr1,39278416,0.35,24,45,69,602167
chr1,39278445,0.85,50,9,59,602168
chr1,39278453,0.36,22,39,61,602169
chr1,39278487,0.79,46,12,58,602170
chr1,39278509,0.26,16,46,62,602171
chr1,39278541,0.79,60,16,76,602172
chr1,39278573,0.37,30,52,82,602173
chr1,39278655,0.82,59,13,72,602174
chr1,39278726,0.25,23,69,92,602175
chr1,39278927,0.55,60,50,110,602176
chr1,39278969,0.63,78,46,124,602177
chr1,39279021,0.79,108,28,136,602178
chr1,39279207,0.21,31,117,148,602179
chr1,39279333,0.84,102,19,121,602180
chr1,39279379,0.91,93,9,102,602181
chr1,39279461,0.92,65,6,71,602182
chr1,39279528,0.82,49,11,60,602183
chr1,39279560,0.93,50,4,54,602184
chr1,39279655,0.86,57,9,66,602185
chr1,39279748,0.56,52,41,93,602186
chr1,39279780,0.58,48,35,83,602187
chr1,39279838,0.33,30,60,90,602188
chr1,39279862,0.56,36,28,64,602189
chr1,39279883,0.56,46,36,82,602190
chr1,39279922,0.56,50,39,89,602191
chr1,39279961,0.78,63,18,81,602192
chr1,39280010,0.81,63,15,78,602193
chr1,39280229,0.64,54,31,85,602194
chr1,39280363,0.48,27,29,56,602195
chr1,39280369,0.65,35,19,54,602196
chr1,39280374,0.34,19,37,56,602197
chr1,39280500,0.94,75,5,80,602198
chr1,39280633,0.59,48,33,81,602199
chr1,39281077,0.71,77,32,109,602200
chr1,39281166,0.73,68,25,93,602201
chr1,39281399,0.62,32,20,52,602202
chr1,39281463,0.53,40,36,76,602203
chr1,39281472,0.44,36,45,81,602204
chr1,39281565,0.31,27,61,88,602205
chr1,39281613,0.21,24,93,117,602206
chr1,39281651,0.24,26,83,109,602207
chr1,39281663,0.39,42,66,108,602208
chr1,39281674,0.21,20,74,94,602209
chr1,39281679,0.63,57,34,91,602210
chr1,39281695,0.39,22,34,56,602211
chr1,39281710,0.2,13,53,66,602212
chr1,39281726,0.08,5,60,65,602213
chr1,39281746,0,0,56,56,602214
chr1,39281760,0.12,7,52,59,602215
chr1,39281803,0.1,7,66,73,602216
chr1,39281841,0.21,12,46,58,602217
chr1,39281862,0.07,3,42,45,602218
chr1,39281864,0.09,4,41,45,602219
chr1,39281887,0.15,4,22,26,602220
chr1,39281895,0,0,46,46,602221
chr1,39281935,0.02,1,56,57,602222
chr1,39281944,0.02,1,53,54,602223
chr1,39281952,0.02,1,53,54,602224
chr1,39281970,0.17,5,24,29,602225
chr1,39281980,0.04,2,53,55,602226
chr1,39281998,0.02,1,50,51,602227
chr1,39282003,0.1,5,44,49,602228
chr1,39282015,0.04,2,45,47,602229
chr1,39282017,0.04,2,54,56,602230
chr1,39282031,0.02,1,58,59,602231
chr1,39282068,0.05,2,38,40,602232
chr1,39282071,0.05,3,52,55,602233
chr1,39282074,0.06,4,59,63,602234
chr1,39282110,0.03,2,66,68,602235
chr1,39282126,0.03,2,74,76,602236
chr1,39282145,0.12,9,67,76,602237
chr1,39282172,0.18,17,76,93,602238
chr1,39282184,0.32,28,59,87,602239
chr1,39282193,0.58,48,35,83,602240
chr1,39282263,0.44,32,40,72,602241
chr1,39282301,0.58,31,22,53,602242
chr1,39282332,0.58,28,20,48,602243
chr1,39282357,0.88,44,6,50,602244
chr1,39282373,0.86,48,8,56,602245
chr1,39282426,0.99,75,1,76,602246
chr1,39282435,0.86,68,11,79,602247
chr1,39282470,0.72,66,26,92,602248
chr1,39282495,0.92,85,7,92,602249
chr1,39282571,0.89,59,7,66,602250
chr1,39282656,0.8,56,14,70,602251
chr1,39282666,0.86,68,11,79,602252
chr1,39282754,0.98,106,2,108,602253
chr1,39283141,0.95,59,3,62,602254
chr1,39283227,0.65,28,15,43,602255
chr1,39283246,0.98,45,1,46,602256
chr1,39283321,0.91,53,5,58,602257
chr1,39283370,0.91,71,7,78,602258
chr1,39283389,0.82,70,15,85,602259
chr1,39283403,0.92,79,7,86,602260
chr1,39283424,0.93,82,6,88,602261
chr1,39283437,0.87,80,12,92,602262
chr1,39283440,0.92,86,7,93,602263
chr1,39283442,0.61,58,37,95,602264
chr1,39283452,0.96,82,3,85,602265
chr1,39283492,0.68,39,18,57,602266
chr1,39283517,0.52,29,27,56,602267
chr1,39283522,0.7,40,17,57,602268
chr1,39283524,0.81,43,10,53,602269
chr1,39283610,0.13,6,42,48,602270
chr1,39283623,0.26,12,34,46,602271
chr1,39283643,0.27,12,32,44,602272
chr1,39283654,0.06,3,48,51,602273
chr1,39283670,0.04,2,44,46,602274
chr1,39283672,0.1,4,35,39,602275
chr1,39283678,0.08,3,36,39,602276
chr1,39283683,0,0,51,51,602277
chr1,39283687,0,0,44,44,602278
chr1,39283693,0,0,55,55,602279
chr1,39283704,0,0,48,48,602280
chr1,39283706,0,0,38,38,602281
chr1,39283708,0.02,1,41,42,602282
chr1,39283712,0.02,1,42,43,602283
chr1,39283738,0.05,1,20,21,602284
chr1,39283744,0,0,38,38,602285
chr1,39283748,0,0,57,57,602286
chr1,39283751,0.02,1,52,53,602287
chr1,39283768,0.02,1,54,55,602288
chr1,39283780,0.1,4,37,41,602289
chr1,39283785,0.04,2,43,45,602290
chr1,39283790,0.05,3,52,55,602291
chr1,39283797,0.04,2,45,47,602292
chr1,39283802,0.05,3,59,62,602293
chr1,39283812,0.03,2,56,58,602294
chr1,39283825,0.07,3,41,44,602295
chr1,39283830,0.06,3,51,54,602296
chr1,39283835,0,0,52,52,602297
chr1,39283895,0,0,49,49,602298
chr1,39283901,0.02,1,41,42,602299
chr1,39283919,0,0,47,47,602300
chr1,39283925,0,0,29,29,602301
chr1,39283932,0,0,55,55,602302
chr1,39283934,0,0,56,56,602303
chr1,39283939,0.03,1,39,40,602304
chr1,39283942,0.05,2,38,40,602305
chr1,39283944,0,0,42,42,602306
chr1,39283956,0,0,53,53,602307
chr1,39283971,0.04,1,25,26,602308
chr1,39283975,0,0,20,20,602309
chr1,39283979,0.06,2,31,33,602310
chr1,39283983,0,0,40,40,602311
chr1,39283988,0.02,1,52,53,602312
chr1,39284011,0,0,51,51,602313
chr1,39284017,0.02,1,48,49,602314
chr1,39284019,0,0,46,46,602315
chr1,39284024,0,0,28,28,602316
chr1,39284027,0.02,1,50,51,602317
chr1,39284030,0,0,52,52,602318
chr1,39284037,0,0,51,51,602319
chr1,39284043,0,0,61,61,602320
chr1,39284048,0,0,59,59,602321
chr1,39284052,0,0,50,50,602322
chr1,39284065,0.02,1,65,66,602323
chr1,39284071,0,0,63,63,602324
chr1,39284073,0.02,1,62,63,602325
chr1,39284079,0,0,57,57,602326
chr1,39284081,0.02,1,58,59,602327
chr1,39284084,0,0,46,46,602328
chr1,39284099,0,0,64,64,602329
chr1,39284110,0,0,51,51,602330
chr1,39284122,0.02,1,64,65,602331
chr1,39284124,0,0,62,62,602332
chr1,39284145,0,0,45,45,602333
chr1,39284167,0.02,1,61,62,602334
chr1,39284177,0,0,61,61,602335
chr1,39284186,0,0,58,58,602336
chr1,39284209,0.02,1,56,57,602337
chr1,39284215,0,0,46,46,602338
chr1,39284218,0.06,3,48,51,602339
chr1,39284225,0,0,45,45,602340
chr1,39284233,0.02,1,47,48,602341
chr1,39284240,0,0,38,38,602342
chr1,39284243,0.06,1,16,17,602343
chr1,39284257,0,0,37,37,602344
chr1,39284267,0,0,13,13,602345
chr1,39284281,0,0,30,30,602346
chr1,39284286,0,0,32,32,602347
chr1,39284294,0,0,42,42,602348
chr1,39284331,0,0,66,66,602349
chr1,39284348,0.1,4,36,40,602350
chr1,39284377,0,0,82,82,602351
chr1,39284449,0.03,2,65,67,602352
chr1,39284459,0,0,59,59,602353
chr1,39284462,0,0,64,64,602354
chr1,39284471,0.02,1,54,55,602355
chr1,39284474,0.02,1,56,57,602356
chr1,39284477,0,0,58,58,602357
chr1,39284499,0.02,1,55,56,602358
chr1,39284527,0.04,2,52,54,602359
chr1,39284529,0.07,4,56,60,602360
chr1,39284532,0.13,4,28,32,602361
chr1,39284549,0.03,2,59,61,602362
chr1,39284567,0,0,41,41,602363
chr1,39284569,0,0,48,48,602364
chr1,39284575,0.04,2,53,55,602365
chr1,39284609,0.08,2,23,25,602366
chr1,39284620,0.02,1,42,43,602367
chr1,39284637,0,0,42,42,602368
chr1,39284732,0.28,13,33,46,602369
chr1,39284783,0.03,2,66,68,602370
chr1,39284816,0.16,12,65,77,602371
chr1,39284839,0.11,8,65,73,602372
chr1,39284841,0.08,6,69,75,602373
chr1,39284863,0.1,7,66,73,602374
chr1,39284916,0.66,44,23,67,602375
chr1,39284955,0.4,17,26,43,602376
chr1,39284966,0.55,21,17,38,602377
chr1,39284978,0.19,13,56,69,602378
chr1,39285149,0.58,35,25,60,602379
chr1,39285158,0.85,28,5,33,602380
chr1,39285335,0.61,38,24,62,602381
chr1,39285493,0.69,61,28,89,602382
chr1,39285662,0.9,90,10,100,602383
chr1,39285667,0.79,83,22,105,602384
chr1,39285669,0.86,92,15,107,602385
chr1,39285730,0.9,75,8,83,602386
chr1,39286826,0.59,45,31,76,602387
chr1,39287019,0.86,78,13,91,602388
chr1,39287054,0.8,109,27,136,602389
chr1,39287069,0.9,129,14,143,602390
chr1,39287091,0.91,143,14,157,602391
chr1,39287135,0.96,129,5,134,602392
chr1,39287278,0.95,60,3,63,602393
chr1,39287369,0.71,56,23,79,602394
chr1,39287395,0.91,83,8,91,602395
chr1,39287440,0.96,93,4,97,602396
chr1,39287507,0.73,80,30,110,602397
chr1,39287790,0.81,89,21,110,602398
chr1,39287850,1,97,0,97,602399
chr1,39287964,0.76,63,20,83,602400
chr1,39288016,0.89,42,5,47,602401
chr1,39288074,0.96,45,2,47,602402
chr1,39288082,0.91,43,4,47,602403
chr1,39288234,0.71,80,33,113,602404
chr1,39288284,0.95,103,5,108,602405
chr1,39288303,0.77,86,26,112,602406
chr1,39288405,0,0,56,56,602407
chr1,39288425,0,0,25,25,602408
chr1,39288431,0.58,14,10,24,602409
chr1,39288495,0.91,49,5,54,602410
chr1,39288698,0.86,65,11,76,602411
chr1,39288799,0.93,65,5,70,602412
chr1,39288845,0.83,60,12,72,602413
chr1,39288884,0.72,50,19,69,602414
chr1,39289120,0.93,55,4,59,602415
chr1,39289269,0.79,46,12,58,602416
chr1,39289336,0.96,74,3,77,602417
chr1,39289373,0.96,66,3,69,602418
chr1,39289413,0.96,65,3,68,602419
chr1,39289476,0.98,55,1,56,602420
chr1,39289483,0.89,41,5,46,602421
chr1,39289493,0.91,40,4,44,602422
chr1,39289573,0.8,4,1,5,602423
chr1,39289579,0.75,3,1,4,602424
chr1,39289589,1,4,0,4,602425
chr1,39289617,0.88,7,1,8,602426
chr1,39289730,0.8,28,7,35,602427
chr1,39289799,0.97,66,2,68,602428
chr1,39289816,0.89,48,6,54,602429
chr1,39289916,0.26,13,37,50,602430
chr1,39289994,0.41,25,36,61,602431
chr1,39290126,0.61,65,41,106,602432
chr1,39290154,0.89,109,13,122,602433
chr1,39290234,0.94,128,8,136,602434
chr1,39290430,0.69,74,33,107,602435
chr1,39290821,0.82,60,13,73,602436
chr1,39290877,0.79,53,14,67,602437
chr1,39291067,0.74,53,19,72,602438
chr1,39291081,0.94,74,5,79,602439
chr1,39291109,0.88,69,9,78,602440
chr1,39291144,0.73,61,22,83,602441
chr1,39291237,0.75,78,26,104,602442
chr1,39291276,0.87,91,14,105,602443
chr1,39291312,0.82,80,17,97,602444
chr1,39291325,0.57,48,36,84,602445
chr1,39291439,0.89,50,6,56,602446
chr1,39291445,0.89,54,7,61,602447
chr1,39291486,0.8,55,14,69,602448
chr1,39291558,0.88,56,8,64,602449
chr1,39291759,0.88,81,11,92,602450
chr1,39292046,0.32,35,76,111,602451
chr1,39292193,0.63,48,28,76,602452
chr1,39292200,0.56,45,35,80,602453
chr1,39292477,0.81,79,19,98,602454
chr1,39292750,0.67,58,29,87,602455
chr1,39293129,0.49,69,71,140,602456
chr1,39293203,0.65,60,32,92,602457
chr1,39293410,0.86,87,14,101,602458
chr1,39293537,0.73,57,21,78,602459
chr1,39293602,0.8,74,18,92,602460
chr1,39293624,0.91,74,7,81,602461
chr1,39293728,0.73,55,20,75,602462
chr1,39293762,0.83,66,14,80,602463
chr1,39293797,0.82,67,15,82,602464
chr1,39293873,0.73,72,26,98,602465
chr1,39293907,0.71,73,30,103,602466
chr1,39294078,0.83,85,17,102,602467
chr1,39294162,0.74,70,25,95,602468
chr1,39294311,0.64,66,37,103,602469
chr1,39294407,0.98,89,2,91,602470
chr1,39294508,0.83,25,5,30,602471
chr1,39294549,1,46,0,46,602472
chr1,39294605,0.78,40,11,51,602473
chr1,39294635,0.87,34,5,39,602474
chr1,39294757,0.7,60,26,86,602475
chr1,39294920,0.56,44,34,78,602476
chr1,39294958,0.62,49,30,79,602477
chr1,39295194,0.11,9,74,83,602478
chr1,39295731,0.75,79,27,106,602479
chr1,39295794,0.8,55,14,69,602480
chr1,39295824,1,37,0,37,602481
chr1,39295826,1,37,0,37,602482
chr1,39295856,0.76,16,5,21,602483
chr1,39296181,0.65,48,26,74,602484
chr1,39296218,0.76,67,21,88,602485
chr1,39296226,0.85,76,13,89,602486
chr1,39296283,0.63,73,43,116,602487
chr1,39296359,0.51,42,40,82,602488
chr1,39296432,0.93,100,7,107,602489
chr1,39296454,0.75,73,24,97,602490
chr1,39296474,0.99,75,1,76,602491
chr1,39296478,0.95,72,4,76,602492
chr1,39296490,0.97,68,2,70,602493
chr1,39296533,0.33,18,37,55,602494
chr1,39296610,0.86,71,12,83,602495
chr1,39296622,0.93,77,6,83,602496
chr1,39296626,0.9,73,8,81,602497
chr1,39296836,0.52,41,38,79,602498
chr1,39296841,0.66,50,26,76,602499
chr1,39296852,0.54,38,33,71,602500
chr1,39296868,0.49,34,36,70,602501
chr1,39296880,0.67,41,20,61,602502
chr1,39296897,0.6,33,22,55,602503
chr1,39297011,0.68,61,29,90,602504
chr1,39297358,0.84,85,16,101,602505
chr1,39297376,0.93,99,7,106,602506
chr1,39297388,0.96,107,4,111,602507
chr1,39297426,0.86,92,15,107,602508
chr1,39297747,0.97,101,3,104,602509
chr1,39297854,0.77,48,14,62,602510
chr1,39297990,0.67,57,28,85,602511
chr1,39298020,0.76,64,20,84,602512
chr1,39298034,0.81,68,16,84,602513
chr1,39298060,0.77,50,15,65,602514
chr1,39298307,0.85,79,14,93,602515
chr1,39298343,0.95,80,4,84,602516
chr1,39298611,0.78,58,16,74,602517
chr1,39298945,0.6,61,40,101,602518
chr1,39299087,0.75,98,32,130,602519
chr1,39299144,0.83,91,19,110,602520
chr1,39299249,0.86,93,15,108,602521
chr1,39299275,0.9,94,11,105,602522
chr1,39299579,0.96,79,3,82,602523
chr1,39299666,0.89,65,8,73,602524
chr1,39299694,0.91,71,7,78,602525
chr1,39299699,0.91,68,7,75,602526
chr1,39299726,0.96,82,3,85,602527
chr1,39299802,0.9,78,9,87,602528
chr1,39299878,0.82,42,9,51,602529
chr1,39299886,0.88,44,6,50,602530
chr1,39300026,0.99,78,1,79,602531
chr1,39300035,0.83,66,14,80,602532
chr1,39300436,0.91,79,8,87,602533
chr1,39300458,0.95,86,5,91,602534
chr1,39300482,0.93,80,6,86,602535
chr1,39300498,0.91,71,7,78,602536
chr1,39300868,0.62,45,28,73,602537
chr1,39301015,0.02,2,91,93,602538
chr1,39301172,0.21,19,73,92,602539
chr1,39301620,0.75,38,13,51,602540
chr1,39301646,0.73,52,19,71,602541
chr1,39301660,0.99,75,1,76,602542
chr1,39301726,0.76,63,20,83,602543
chr1,39301809,0.86,69,11,80,602544
chr1,39301897,0.79,55,15,70,602545
chr1,39301902,0.93,64,5,69,602546
chr1,39301939,0.82,59,13,72,602547
chr1,39301977,0.87,68,10,78,602548
chr1,39302001,0.94,83,5,88,602549
chr1,39302020,0.85,78,14,92,602550
chr1,39302049,0.85,88,15,103,602551
chr1,39302069,0.85,78,14,92,602552
chr1,39302081,0.95,78,4,82,602553
chr1,39302127,0.93,75,6,81,602554
chr1,39302137,0.8,60,15,75,602555
chr1,39302153,0.93,53,4,57,602556
chr1,39302169,0.91,40,4,44,602557
chr1,39302186,0.73,24,9,33,602558
chr1,39302203,0.81,17,4,21,602559
chr1,39302781,0.84,82,16,98,602560
chr1,39302965,0.67,69,34,103,602561
chr1,39302991,0.38,111,181,292,602562
chr1,39303724,0.33,64,131,195,602563
chr1,39303804,0.81,65,15,80,602564
chr1,39303825,0.65,53,28,81,602565
chr1,39303830,0.99,71,1,72,602566
chr1,39303864,0.79,68,18,86,602567
chr1,39304286,0.28,67,169,236,602568
chr1,39304337,0.62,86,53,139,602569
chr1,39304366,0.68,76,36,112,602570
chr1,39304599,0.81,109,26,135,602571
chr1,39304620,0.79,105,28,133,602572
chr1,39304709,0.76,97,30,127,602573
chr1,39304727,0.71,94,39,133,602574
chr1,39304947,0.03,2,64,66,602575
chr1,39304959,0,0,45,45,602576
chr1,39305163,0.42,102,142,244,602577
chr1,39305172,0.58,85,62,147,602578
chr1,39305208,0.29,73,181,254,602579
chr1,39305211,0.38,96,155,251,602580
chr1,39305233,0.53,86,75,161,602581
chr1,39305238,0.56,91,71,162,602582
chr1,39305243,0.68,108,52,160,602583
chr1,39305261,0.39,93,146,239,602584
chr1,39305346,0.31,66,146,212,602585
chr1,39305376,0,0,188,188,602586
chr1,39305459,0.25,51,152,203,602587
chr1,39305517,0.45,54,66,120,602588
chr1,39305536,0.76,94,29,123,602589
chr1,39305556,0.63,66,39,105,602590
chr1,39305584,0.94,44,3,47,602591
chr1,39305589,0.97,37,1,38,602592
chr1,39305600,0,0,169,169,602593
chr1,39305642,0,0,161,161,602594
chr1,39305648,0,0,164,164,602595
chr1,39305676,0.98,49,1,50,602596
chr1,39305688,0.52,54,50,104,602597
chr1,39305736,0.29,64,158,222,602598
chr1,39305806,0.18,33,147,180,602599
chr1,39305811,0,0,156,156,602600
chr1,39305817,0.76,125,39,164,602601
chr1,39305842,0.52,91,84,175,602602
chr1,39305850,0,0,56,56,602603
chr1,39305874,0.6,51,34,85,602604
chr1,39305895,0.43,93,121,214,602605
chr1,39306081,0.29,76,184,260,602606
chr1,39306305,0.77,94,28,122,602607
chr1,39306461,0,0,184,184,602608
chr1,39306993,0.3,55,129,184,602609
chr1,39307147,0.32,64,133,197,602610
chr1,39307534,0.28,45,114,159,602611
chr1,39307536,0.51,142,138,280,602612
chr1,39307546,0.63,40,23,63,602613
chr1,39307561,0.25,40,122,162,602614
chr1,39307574,0.29,42,103,145,602615
chr1,39307670,0.75,77,25,102,602616
chr1,39307678,0.69,74,34,108,602617
chr1,39307726,0.97,72,2,74,602618
chr1,39307740,0.78,70,20,90,602619
chr1,39307804,0.78,76,21,97,602620
chr1,39307812,0.71,147,59,206,602621
chr1,39307816,0.34,65,129,194,602622
chr1,39307868,0.7,39,17,56,602623
chr1,39307875,0.97,35,1,36,602624
chr1,39307892,0.67,34,17,51,602625
chr1,39307898,0.69,36,16,52,602626
chr1,39307930,1,44,0,44,602627
chr1,39308234,0.63,69,40,109,602628
chr1,39308364,0.53,54,47,101,602629
chr1,39308493,0.78,95,27,122,602630
chr1,39308516,0.36,81,143,224,602631
chr1,39308751,0.26,54,156,210,602632
chr1,39308929,0.68,73,35,108,602633
chr1,39309114,0.71,62,25,87,602634
chr1,39309118,0.56,62,49,111,602635
chr1,39309158,0.64,54,30,84,602636
chr1,39309167,0.01,1,73,74,602637
chr1,39309172,0.71,120,49,169,602638
chr1,39309206,0.18,33,152,185,602639
chr1,39309219,0.63,46,27,73,602640
chr1,39309248,0.55,77,64,141,602641
chr1,39309252,0.74,86,31,117,602642
chr1,39309284,0.46,60,71,131,602643
chr1,39309316,0.39,89,142,231,602644
chr1,39309323,0.78,87,25,112,602645
chr1,39309740,0.73,138,50,188,602646
chr1,39309838,0.88,66,9,75,602647
chr1,39309840,0.68,73,35,108,602648
chr1,39309869,0.38,83,134,217,602649
chr1,39309918,0.8,108,27,135,602650
chr1,39309953,0.39,100,159,259,602651
chr1,39309981,0.41,102,149,251,602652
chr1,39310081,0.61,67,42,109,602653
chr1,39310100,0.02,1,63,64,602654
chr1,39310159,0.02,4,179,183,602655
chr1,39310410,0.66,168,87,255,602656
chr1,39310430,0.59,79,56,135,602657
chr1,39310531,0.76,104,33,137,602658
chr1,39310623,0.98,95,2,97,602659
chr1,39310806,0,0,59,59,602660
chr1,39310811,0.59,100,70,170,602661
chr1,39310845,0.51,91,86,177,602662
chr1,39310860,0,0,190,190,602663
chr1,39310870,0,0,188,188,602664
chr1,39310886,0.78,67,19,86,602665
chr1,39310945,0,0,153,153,602666
chr1,39310966,0,0,154,154,602667
chr1,39311202,0.65,62,33,95,602668
chr1,39311257,0.8,87,22,109,602669
chr1,39311261,0.67,74,36,110,602670
chr1,39311386,0.47,99,111,210,602671
chr1,39311450,0.01,1,196,197,602672
chr1,39312043,0.67,64,32,96,602673
chr1,39312159,0.23,39,134,173,602674
chr1,39312182,0.37,74,126,200,602675
chr1,39312339,0.57,134,103,237,602676
chr1,39312404,0.45,118,142,260,602677
chr1,39312492,0.76,78,25,103,602678
chr1,39312545,0.56,71,55,126,602679
chr1,39312573,0.38,67,108,175,602680
chr1,39312588,0.7,67,29,96,602681
chr1,39312638,0.95,92,5,97,602682
chr1,39312696,0.97,92,3,95,602683
chr1,39313332,0.37,77,133,210,602684
chr1,39313384,0.45,110,137,247,602685
chr1,39313587,0.35,77,141,218,602686
chr1,39313644,0.53,63,57,120,602687
chr1,39313698,0,0,178,178,602688
chr1,39313703,0.01,1,173,174,602689
chr1,39313848,0.27,57,158,215,602690
chr1,39314427,0.75,91,31,122,602691
chr1,39314454,0.87,100,15,115,602692
chr1,39314674,0.88,75,10,85,602693
chr1,39314821,0.51,46,45,91,602694
chr1,39314897,0.47,48,54,102,602695
chr1,39315098,0.65,47,25,72,602696
chr1,39315158,0.68,50,23,73,602697
chr1,39315220,0.33,70,139,209,602698
chr1,39315252,0.71,67,28,95,602699
chr1,39315284,0.94,197,12,209,602700
chr1,39315338,0.8,85,21,106,602701
chr1,39315490,0.36,79,142,221,602702
chr1,39315631,0.35,64,121,185,602703
chr1,39315646,0.62,57,35,92,602704
chr1,39315649,0.98,48,1,49,602705
chr1,39315660,0.28,43,111,154,602706
chr1,39315666,0.59,92,64,156,602707
chr1,39315674,1,53,0,53,602708
chr1,39315734,0.96,69,3,72,602709
chr1,39315770,0.25,75,226,301,602710
chr1,39315781,0.49,72,75,147,602711
chr1,39315792,0.5,78,79,157,602712
chr1,39315809,0.43,77,104,181,602713
chr1,39315864,0.75,73,24,97,602714
chr1,39315910,0.29,54,130,184,602715
chr1,39315948,0.98,56,1,57,602716
chr1,39315953,0.76,54,17,71,602717
chr1,39315970,0,0,179,179,602718
chr1,39315982,0.76,56,18,74,602719
chr1,39316013,0.69,55,25,80,602720
chr1,39316046,0.52,43,39,82,602721
chr1,39316054,0.58,32,23,55,602722
chr1,39316070,0,0,42,42,602723
chr1,39316085,0,0,130,130,602724
chr1,39316140,0.26,44,127,171,602725
chr1,39316142,0.58,46,33,79,602726
chr1,39316164,0.31,53,119,172,602727
chr1,39316167,0.59,56,39,95,602728
chr1,39316180,0.54,167,142,309,602729
chr1,39316579,0.93,54,4,58,602730
chr1,39316744,0.77,79,24,103,602731
chr1,39317101,0.4,67,102,169,602732
chr1,39317247,0.88,107,15,122,602733
chr1,39317318,0.89,114,14,128,602734
chr1,39317490,0.75,97,33,130,602735
chr1,39317807,0.86,128,20,148,602736
chr1,39317844,0.29,97,232,329,602737
chr1,39318079,0.34,72,138,210,602738
chr1,39318423,0.23,52,173,225,602739
chr1,39318494,0.13,31,199,230,602740
chr1,39318607,0.38,45,72,117,602741
chr1,39318677,0.51,58,55,113,602742
chr1,39318759,0.31,78,174,252,602743
chr1,39318877,0.63,75,44,119,602744
chr1,39318934,0.31,73,159,232,602745
chr1,39318970,0.53,57,50,107,602746
chr1,39319061,0.76,77,24,101,602747
chr1,39319082,0.8,74,18,92,602748
chr1,39319143,0.85,103,18,121,602749
chr1,39319145,0.79,105,28,133,602750
chr1,39319155,0.75,99,33,132,602751
chr1,39319207,0.83,91,19,110,602752
chr1,39319215,0.87,104,15,119,602753
chr1,39319225,0.41,96,137,233,602754
chr1,39319279,0.77,89,26,115,602755
chr1,39319287,0.88,84,11,95,602756
chr1,39319333,0.94,79,5,84,602757
chr1,39319359,0.35,60,112,172,602758
chr1,39319367,0.35,56,105,161,602759
chr1,39319603,0.97,100,3,103,602760
chr1,39319725,0.02,1,53,54,602761
chr1,39319774,0,0,135,135,602762
chr1,39319780,0.02,1,54,55,602763
chr1,39319800,0.53,89,79,168,602764
chr1,39319825,0,0,57,57,602765
chr1,39319842,1,58,0,58,602766
chr1,39319856,0.01,1,77,78,602767
chr1,39319900,0.62,74,45,119,602768
chr1,39319929,0.42,70,97,167,602769
chr1,39319937,0.97,67,2,69,602770
chr1,39319958,0.01,1,199,200,602771
chr1,39319992,0.83,104,21,125,602772
chr1,39320161,0.91,72,7,79,602773
chr1,39320218,0.32,58,122,180,602774
chr1,39320402,0.94,83,5,88,602775
chr1,39320515,0.74,62,22,84,602776
chr1,39320575,0.72,59,23,82,602777
chr1,39321050,0.82,65,14,79,602778
chr1,39321191,0.45,53,66,119,602779
chr1,39321994,0.65,84,45,129,602780
chr1,39322556,0.73,106,40,146,602781
chr1,39322565,0.45,111,137,248,602782
chr1,39322727,0.74,102,35,137,602783
chr1,39323258,0.14,35,218,253,602784
chr1,39323275,0.64,54,31,85,602785
chr1,39323317,0.55,164,133,297,602786
chr1,39323348,0.56,53,41,94,602787
chr1,39323353,0.65,59,32,91,602788
chr1,39323359,0.36,63,114,177,602789
chr1,39323369,0.62,54,33,87,602790
chr1,39323393,0.6,50,33,83,602791
chr1,39323402,0.67,43,21,64,602792
chr1,39323408,0.55,102,83,185,602793
chr1,39323488,0.3,62,145,207,602794
chr1,39323492,0.29,59,143,202,602795
chr1,39323504,0.67,58,28,86,602796
chr1,39323593,0,0,65,65,602797
chr1,39323610,0.24,44,137,181,602798
chr1,39323622,0,0,172,172,602799
chr1,39323798,0.84,95,18,113,602800
chr1,39323870,0.85,57,10,67,602801
chr1,39324021,0.52,133,125,258,602802
chr1,39324023,0.66,57,29,86,602803
chr1,39324096,0.55,164,134,298,602804
chr1,39324141,0.55,173,144,317,602805
chr1,39324167,0.64,71,40,111,602806
chr1,39324198,0.55,71,57,128,602807
chr1,39324226,0.76,70,22,92,602808
chr1,39324230,0.92,57,5,62,602809
chr1,39324238,0.52,57,53,110,602810
chr1,39324240,0.96,54,2,56,602811
chr1,39324242,0.64,54,31,85,602812
chr1,39324262,0.4,40,61,101,602813
chr1,39324275,0.93,37,3,40,602814
chr1,39324318,0.42,37,52,89,602815
chr1,39324350,0.43,19,25,44,602816
chr1,39324358,0.31,28,63,91,602817
chr1,39324368,0.1,18,166,184,602818
chr1,39324393,0.03,3,84,87,602819
chr1,39324587,0.03,3,116,119,602820
chr1,39324610,0.01,1,106,107,602821
chr1,39324622,0.01,1,113,114,602822
chr1,39324653,0,0,100,100,602823
chr1,39324683,0.08,9,108,117,602824
chr1,39324722,0.01,1,106,107,602825
chr1,39324743,0.04,4,108,112,602826
chr1,39324773,0,0,101,101,602827
chr1,39324784,0,0,99,99,602828
chr1,39324816,0,0,167,167,602829
chr1,39324829,0,0,53,53,602830
chr1,39324838,0,0,88,88,602831
chr1,39324853,0.01,1,70,71,602832
chr1,39324866,0,0,169,169,602833
chr1,39324875,0,0,42,42,602834
chr1,39324903,0,0,140,140,602835
chr1,39324918,0,0,51,51,602836
chr1,39324927,0,0,144,144,602837
chr1,39324931,0.01,1,175,176,602838
chr1,39324936,0,0,170,170,602839
chr1,39324946,0.2,55,221,276,602840
chr1,39324972,0,0,157,157,602841
chr1,39324991,0,0,179,179,602842
chr1,39324996,0.01,1,136,137,602843
chr1,39325001,0,0,176,176,602844
chr1,39325005,0.01,1,170,171,602845
chr1,39325007,0.27,47,130,177,602846
chr1,39325011,0,0,179,179,602847
chr1,39325021,0.02,3,164,167,602848
chr1,39325036,0,0,170,170,602849
chr1,39325102,0,0,59,59,602850
chr1,39325107,0,0,35,35,602851
chr1,39325110,0,0,25,25,602852
chr1,39325152,0.73,96,36,132,602853
chr1,39325156,0,0,132,132,602854
chr1,39325161,0,0,129,129,602855
chr1,39325167,0.76,100,32,132,602856
chr1,39325171,0,0,138,138,602857
chr1,39325186,0,0,145,145,602858
chr1,39325191,0,0,133,133,602859
chr1,39325202,0,0,37,37,602860
chr1,39325207,0,0,35,35,602861
chr1,39325231,0,0,143,143,602862
chr1,39325240,0.03,1,30,31,602863
chr1,39325256,0.01,1,141,142,602864
chr1,39325261,0.01,1,144,145,602865
chr1,39325265,0,0,135,135,602866
chr1,39325267,0.45,64,78,142,602867
chr1,39325270,0,0,46,46,602868
chr1,39325279,0,0,53,53,602869
chr1,39325282,0,0,150,150,602870
chr1,39325298,0.3,21,49,70,602871
chr1,39325303,0,0,80,80,602872
chr1,39325336,0,0,169,169,602873
chr1,39325342,0.79,131,34,165,602874
chr1,39325346,0,0,164,164,602875
chr1,39325381,0,0,163,163,602876
chr1,39325391,0,0,165,165,602877
chr1,39325396,0,0,160,160,602878
chr1,39325400,0.43,99,131,230,602879
chr1,39325406,0,0,158,158,602880
chr1,39325411,0,0,153,153,602881
chr1,39325415,0,0,126,126,602882
chr1,39325417,0.01,1,75,76,602883
chr1,39325421,0,0,146,146,602884
chr1,39325427,0.01,1,84,85,602885
chr1,39325434,0.02,1,59,60,602886
chr1,39325444,0,0,37,37,602887
chr1,39325456,0,0,135,135,602888
chr1,39325463,0,0,101,101,602889
chr1,39325479,0,0,86,86,602890
chr1,39325484,0.01,1,81,82,602891
chr1,39325495,0.02,1,42,43,602892
chr1,39325506,0,0,160,160,602893
chr1,39325510,0,0,48,48,602894
chr1,39325522,0,0,163,163,602895
chr1,39325546,0.01,1,155,156,602896
chr1,39325553,0,0,158,158,602897
chr1,39325566,0,0,144,144,602898
chr1,39325592,0.71,109,44,153,602899
chr1,39325611,0,0,163,163,602900
chr1,39325616,0,0,177,177,602901
chr1,39325622,0.52,91,83,174,602902
chr1,39325652,0.73,130,49,179,602903
chr1,39325660,0,0,169,169,602904
chr1,39325665,0,0,35,35,602905
chr1,39325674,0,0,52,52,602906
chr1,39325686,0,0,174,174,602907
chr1,39325704,0,0,69,69,602908
chr1,39325720,0,0,52,52,602909
chr1,39325739,0,0,80,80,602910
chr1,39325792,0.01,1,130,131,602911
chr1,39325851,0.01,1,172,173,602912
chr1,39325854,0,0,117,117,602913
chr1,39325901,0,0,114,114,602914
chr1,39325911,0,0,144,144,602915
chr1,39325923,0,0,114,114,602916
chr1,39325928,0,0,113,113,602917
chr1,39325951,0,0,183,183,602918
chr1,39325966,0,0,174,174,602919
chr1,39325985,0,0,68,68,602920
chr1,39326089,0,0,60,60,602921
chr1,39326179,0.02,2,115,117,602922
chr1,39326182,0.43,63,85,148,602923
chr1,39326215,0,0,214,214,602924
chr1,39326239,0.07,4,55,59,602925
chr1,39326302,0,0,160,160,602926
chr1,39326373,0.04,5,119,124,602927
chr1,39326538,0.19,30,129,159,602928
chr1,39326546,0.18,35,165,200,602929
chr1,39326639,0.47,29,33,62,602930
chr1,39326690,0.35,74,137,211,602931
chr1,39326714,0.34,79,153,232,602932
chr1,39326767,0.75,66,22,88,602933
chr1,39326771,0.35,71,131,202,602934
chr1,39326773,0.3,55,131,186,602935
chr1,39326775,0.73,64,24,88,602936
chr1,39326785,0.32,65,137,202,602937
chr1,39326818,0.98,55,1,56,602938
chr1,39326835,0,0,75,75,602939
chr1,39326849,0,0,195,195,602940
chr1,39326861,0,0,93,93,602941
chr1,39326906,0.65,51,27,78,602942
chr1,39326910,0.49,36,38,74,602943
chr1,39326918,0.91,31,3,34,602944
chr1,39326922,0.64,28,16,44,602945
chr1,39326942,0.6,27,18,45,602946
chr1,39326955,0,0,61,61,602947
chr1,39326990,0.72,114,44,158,602948
chr1,39326998,0.89,25,3,28,602949
chr1,39327004,0.18,29,128,157,602950
chr1,39327006,0.12,30,211,241,602951
chr1,39327012,0.55,29,24,53,602952
chr1,39327028,0.97,30,1,31,602953
chr1,39327036,0.57,32,24,56,602954
chr1,39327044,0.94,145,10,155,602955
chr1,39327226,0.58,97,70,167,602956
chr1,39327293,0.94,82,5,87,602957
chr1,39327385,0.79,100,26,126,602958
chr1,39327389,0.01,1,123,124,602959
chr1,39327400,0.83,113,23,136,602960
chr1,39327415,0.78,101,28,129,602961
chr1,39327424,0.02,2,128,130,602962
chr1,39327430,0.68,91,42,133,602963
chr1,39327454,0,0,152,152,602964
chr1,39327510,0,0,86,86,602965
chr1,39327516,0.63,65,38,103,602966
chr1,39327544,0.34,71,136,207,602967
chr1,39327642,0.89,87,11,98,602968
chr1,39327701,0.71,103,42,145,602969
chr1,39328038,0.88,92,12,104,602970
chr1,39328230,0.99,101,1,102,602971
chr1,39328654,0.95,83,4,87,602972
chr1,39329081,0.35,65,123,188,602973
chr1,39329255,0.89,96,12,108,602974
chr1,39329894,0.72,54,21,75,602975
chr1,39330352,0.83,90,19,109,602976
chr1,39330988,0.72,84,33,117,602977
chr1,39331232,0.8,86,22,108,602978
chr1,39331254,0.67,68,34,102,602979
chr1,39331330,0.63,101,59,160,602980
chr1,39331533,0.9,79,9,88,602981
chr1,39331598,0.59,91,64,155,602982
chr1,39331789,0.81,51,12,63,602983
chr1,39331813,0.73,44,16,60,602984
chr1,39331908,0.41,74,106,180,602985
chr1,39331951,0.8,82,21,103,602986
chr1,39331999,0.73,72,26,98,602987
chr1,39332009,0.78,69,20,89,602988
chr1,39332078,0.55,38,31,69,602989
chr1,39332151,0.93,80,6,86,602990
chr1,39332181,0.98,97,2,99,602991
chr1,39332191,0.93,100,7,107,602992
chr1,39332213,0.83,86,17,103,602993
chr1,39332249,0.84,75,14,89,602994
chr1,39332308,0.82,85,19,104,602995
chr1,39332338,0.32,43,92,135,602996
chr1,39332366,0.97,56,2,58,602997
chr1,39332376,0.94,66,4,70,602998
chr1,39332387,0.37,63,108,171,602999
chr1,39332477,0.01,1,111,112,603000
chr1,39332488,0.01,1,99,100,603001
chr1,39332608,0.69,97,43,140,603002
chr1,39332622,0.74,90,32,122,603003
chr1,39332846,0.98,97,2,99,603004
chr1,39332856,0.93,102,8,110,603005
chr1,39332900,0.86,106,17,123,603006
chr1,39332923,0.74,107,37,144,603007
chr1,39332945,0.75,83,28,111,603008
chr1,39333017,0.32,57,121,178,603009
chr1,39333033,0.95,161,8,169,603010
chr1,39333050,0.83,55,11,66,603011
chr1,39333075,0.77,46,14,60,603012
chr1,39333112,0,0,128,128,603013
chr1,39333317,0.78,108,31,139,603014
chr1,39333381,0.98,122,3,125,603015
chr1,39333952,0.7,73,31,104,603016
chr1,39333992,0.79,75,20,95,603017
chr1,39334303,0.82,68,15,83,603018
chr1,39334348,0.85,100,17,117,603019
chr1,39334359,0.59,48,33,81,603020
chr1,39334404,0.6,52,34,86,603021
chr1,39334438,0.85,89,16,105,603022
chr1,39334446,0.96,78,3,81,603023
chr1,39334450,0.75,78,26,104,603024
chr1,39334494,0.52,59,55,114,603025
chr1,39334509,0.54,61,52,113,603026
chr1,39334526,0.61,55,35,90,603027
chr1,39334532,0.27,51,137,188,603028
chr1,39334556,0.9,62,7,69,603029
chr1,39334846,0.68,51,24,75,603030
chr1,39334863,0.74,57,20,77,603031
chr1,39334921,0.32,44,92,136,603032
chr1,39334948,0.46,34,40,74,603033
chr1,39334979,0.68,27,13,40,603034
chr1,39335120,0,0,56,56,603035
chr1,39335284,0.77,136,40,176,603036
chr1,39335314,0.76,108,34,142,603037
chr1,39335578,0.57,34,26,60,603038
chr1,39335606,0.66,67,35,102,603039
chr1,39335684,0,0,163,163,603040
chr1,39335724,0.72,95,37,132,603041
chr1,39335800,0.36,17,30,47,603042
chr1,39335815,0.45,17,21,38,603043
chr1,39335875,0.31,38,83,121,603044
chr1,39335889,0.94,47,3,50,603045
chr1,39335997,0.7,88,38,126,603046
chr1,39336014,0.81,93,22,115,603047
chr1,39336067,0.86,205,32,237,603048
chr1,39336076,0.39,93,148,241,603049
chr1,39336187,0.27,45,123,168,603050
chr1,39336191,0.3,44,103,147,603051
chr1,39336193,0.71,121,49,170,603052
chr1,39336203,0.46,33,39,72,603053
chr1,39336321,0,0,19,19,603054
chr1,39336327,0,0,20,20,603055
chr1,39336376,0.53,45,40,85,603056
chr1,39336396,0.54,63,53,116,603057
chr1,39336457,0.9,138,16,154,603058
chr1,39336459,0.71,107,44,151,603059
chr1,39336472,0.94,154,10,164,603060
chr1,39336487,0.68,115,54,169,603061
chr1,39336639,0.96,67,3,70,603062
chr1,39336671,0.45,64,78,142,603063
chr1,39336686,0.23,55,189,244,603064
chr1,39336738,0.57,47,35,82,603065
chr1,39336827,0.8,76,19,95,603066
chr1,39336837,0.62,76,46,122,603067
chr1,39336860,0.94,76,5,81,603068
chr1,39336871,0.68,78,37,115,603069
chr1,39336915,0.97,76,2,78,603070
chr1,39337022,0.01,1,186,187,603071
chr1,39337057,0,0,162,162,603072
chr1,39337083,0,0,155,155,603073
chr1,39337088,0,0,46,46,603074
chr1,39337092,0,0,134,134,603075
chr1,39337097,0,0,132,132,603076
chr1,39337133,0,0,70,70,603077
chr1,39337143,0,0,167,167,603078
chr1,39337157,0,0,177,177,603079
chr1,39337162,0.01,1,118,119,603080
chr1,39337327,0.65,101,54,155,603081
chr1,39337331,0,0,163,163,603082
chr1,39337371,0.01,1,70,71,603083
chr1,39337373,0.35,34,62,96,603084
chr1,39337506,0.4,80,122,202,603085
chr1,39337585,0.82,74,16,90,603086
chr1,39337602,0.55,71,58,129,603087
chr1,39337889,0.82,95,21,116,603088
chr1,39338051,0.5,83,82,165,603089
chr1,39338068,0.6,83,56,139,603090
chr1,39338128,0.35,54,102,156,603091
chr1,39338228,0.42,40,55,95,603092
chr1,39338292,0.03,7,198,205,603093
chr1,39338363,0.01,2,236,238,603094
chr1,39338415,0,0,183,183,603095
chr1,39338436,0.01,1,70,71,603096
chr1,39338480,0,0,62,62,603097
chr1,39338485,0,0,56,56,603098
chr1,39338498,0.08,4,47,51,603099
chr1,39338518,0,0,41,41,603100
chr1,39338522,0.05,2,35,37,603101
chr1,39338525,0,0,34,34,603102
chr1,39338554,0,0,37,37,603103
chr1,39338566,0,0,32,32,603104
chr1,39338576,0.03,1,31,32,603105
chr1,39338580,0.01,1,81,82,603106
chr1,39338587,0,0,98,98,603107
chr1,39338608,0,0,43,43,603108
chr1,39338638,0,0,41,41,603109
chr1,39338641,0.02,3,148,151,603110
chr1,39338648,0.01,1,66,67,603111
chr1,39338653,0,0,183,183,603112
chr1,39338661,0,0,46,46,603113
chr1,39338697,0,0,244,244,603114
chr1,39338715,0,0,83,83,603115
chr1,39338734,0,0,109,109,603116
chr1,39338746,0,0,144,144,603117
chr1,39338751,0,0,41,41,603118
chr1,39338756,0.63,95,56,151,603119
chr1,39338759,0,0,83,83,603120
chr1,39338775,0,0,30,30,603121
chr1,39338782,0,0,159,159,603122
chr1,39338802,0,0,139,139,603123
chr1,39338818,0,0,37,37,603124
chr1,39338832,0,0,158,158,603125
chr1,39338844,0.01,1,146,147,603126
chr1,39338857,0,0,167,167,603127
chr1,39338868,0.02,3,151,154,603128
chr1,39338880,0,0,143,143,603129
chr1,39338882,0.62,96,60,156,603130
chr1,39338884,0,0,47,47,603131
chr1,39338886,0,0,45,45,603132
chr1,39338908,0.52,83,76,159,603133
chr1,39338915,0,0,50,50,603134
chr1,39338930,0,0,65,65,603135
chr1,39338946,0.03,1,38,39,603136
chr1,39338949,0.01,1,79,80,603137
chr1,39338951,0.01,1,148,149,603138
chr1,39338986,0.01,1,171,172,603139
chr1,39338992,0,1,202,203,603140
chr1,39338995,0,0,73,73,603141
chr1,39339004,0,0,86,86,603142
chr1,39339007,0.63,127,74,201,603143
chr1,39339014,0.2,18,74,92,603144
chr1,39339016,0,0,55,55,603145
chr1,39339023,0,0,83,83,603146
chr1,39339048,0.2,41,160,201,603147
chr1,39339050,0.01,1,78,79,603148
chr1,39339060,0.02,1,52,53,603149
chr1,39339062,0,0,156,156,603150
chr1,39339064,0.03,3,89,92,603151
chr1,39339070,0,0,77,77,603152
chr1,39339086,0.01,1,67,68,603153
chr1,39339090,0,0,94,94,603154
chr1,39339096,0,0,60,60,603155
chr1,39339099,0,0,117,117,603156
chr1,39339122,0.48,94,101,195,603157
chr1,39339131,0,0,53,53,603158
chr1,39339160,0.01,1,82,83,603159
chr1,39339172,0,0,192,192,603160
chr1,39339180,0,0,140,140,603161
chr1,39339195,0,0,142,142,603162
chr1,39339201,0,0,38,38,603163
chr1,39339218,0,0,57,57,603164
chr1,39339225,0.01,1,104,105,603165
chr1,39339278,0.02,1,44,45,603166
chr1,39339282,0,0,58,58,603167
chr1,39339295,0,0,72,72,603168
chr1,39339315,0,0,78,78,603169
chr1,39339328,0.01,1,94,95,603170
chr1,39339331,0,0,68,68,603171
chr1,39339335,0,0,81,81,603172
chr1,39339344,0.01,1,92,93,603173
chr1,39339348,0,0,93,93,603174
chr1,39339371,0,0,82,82,603175
chr1,39339413,0.12,13,98,111,603176
chr1,39339512,0.02,2,102,104,603177
chr1,39339553,0,0,107,107,603178
chr1,39339594,0,0,154,154,603179
chr1,39339683,0.03,4,124,128,603180
chr1,39339694,0.07,9,113,122,603181
chr1,39339708,0.03,4,116,120,603182
chr1,39339737,0.01,2,207,209,603183
chr1,39339823,0.04,4,109,113,603184
chr1,39339986,0.26,62,176,238,603185
chr1,39340068,0.51,56,53,109,603186
chr1,39340167,0.53,56,50,106,603187
chr1,39340217,0.68,79,37,116,603188
chr1,39340248,0.85,100,18,118,603189
chr1,39340268,0.61,76,49,125,603190
chr1,39340467,0.68,50,24,74,603191
chr1,39340512,0.71,50,20,70,603192
chr1,39340514,0.93,52,4,56,603193
chr1,39340525,0.9,52,6,58,603194
chr1,39340608,0.69,78,35,113,603195
chr1,39340941,0.32,64,133,197,603196
chr1,39341176,0.93,80,6,86,603197
chr1,39341192,0.85,62,11,73,603198
chr1,39341216,0.68,65,31,96,603199
chr1,39341280,0.89,71,9,80,603200
chr1,39341385,0.35,76,140,216,603201
chr1,39341475,0.87,165,24,189,603202
chr1,39341572,0.74,65,23,88,603203
chr1,39341673,0.77,73,22,95,603204
chr1,39342048,0.37,63,107,170,603205
chr1,39342390,0.4,54,80,134,603206
chr1,39342491,0.56,92,72,164,603207
chr1,39342495,0.02,3,163,166,603208
chr1,39342525,0.01,1,101,102,603209
chr1,39342537,0.65,56,30,86,603210
chr1,39342557,0.49,67,70,137,603211
chr1,39342579,0.95,83,4,87,603212
chr1,39342651,0.64,86,48,134,603213
chr1,39342691,0.78,62,18,80,603214
chr1,39342734,0.93,128,9,137,603215
chr1,39342788,0.44,47,60,107,603216
chr1,39342814,0.93,56,4,60,603217
chr1,39342872,0.7,94,40,134,603218
chr1,39342930,0.31,60,135,195,603219
chr1,39342960,0.01,1,171,172,603220
chr1,39342962,0.79,48,13,61,603221
chr1,39342990,0.28,49,128,177,603222
chr1,39343156,0,0,85,85,603223
chr1,39343208,0.98,56,1,57,603224
chr1,39343229,0.42,68,94,162,603225
chr1,39343237,0.7,61,26,87,603226
chr1,39343240,0.62,70,43,113,603227
chr1,39343254,0.99,76,1,77,603228
chr1,39343271,0.32,85,184,269,603229
chr1,39343313,0.9,83,9,92,603230
chr1,39343330,0.58,78,56,134,603231
chr1,39343359,0.83,64,13,77,603232
chr1,39343390,0.54,63,54,117,603233
chr1,39343404,0.91,53,5,58,603234
chr1,39343410,0,0,66,66,603235
chr1,39343415,0.49,64,66,130,603236
chr1,39343458,0.72,80,31,111,603237
chr1,39343464,0.92,77,7,84,603238
chr1,39343513,0.63,88,51,139,603239
chr1,39343805,0,0,144,144,603240
chr1,39343811,0,0,42,42,603241
chr1,39343860,0.32,61,131,192,603242
chr1,39343907,0.69,85,38,123,603243
chr1,39343939,0.38,67,111,178,603244
chr1,39344001,0,0,57,57,603245
chr1,39344024,0.28,43,109,152,603246
chr1,39344026,0.29,46,112,158,603247
chr1,39344118,0.84,74,14,88,603248
chr1,39344123,0.88,83,11,94,603249
chr1,39344146,0.86,105,17,122,603250
chr1,39344289,0.96,66,3,69,603251
chr1,39344303,0.71,61,25,86,603252
chr1,39344305,0.35,63,118,181,603253
chr1,39344327,0.55,56,45,101,603254
chr1,39344474,1,59,0,59,603255
chr1,39344482,0.45,63,76,139,603256
chr1,39344554,0.63,72,42,114,603257
chr1,39344624,0.99,71,1,72,603258
chr1,39344656,0.34,76,148,224,603259
chr1,39344684,0.75,80,27,107,603260
chr1,39344696,0.62,86,53,139,603261
chr1,39344700,0.35,84,159,243,603262
chr1,39345079,0.96,80,3,83,603263
chr1,39345119,0.9,85,9,94,603264
chr1,39345256,0.41,101,144,245,603265
chr1,39345405,0.74,79,28,107,603266
chr1,39345421,0.8,60,15,75,603267
chr1,39345429,0.73,58,21,79,603268
chr1,39345437,0.96,52,2,54,603269
chr1,39345459,0.49,44,45,89,603270
chr1,39345461,0.98,43,1,44,603271
chr1,39345467,0.85,39,7,46,603272
chr1,39345484,0.98,42,1,43,603273
chr1,39345491,0.96,46,2,48,603274
chr1,39345499,0.94,47,3,50,603275
chr1,39345524,0.93,52,4,56,603276
chr1,39345544,0.97,57,2,59,603277
chr1,39345556,0.97,68,2,70,603278
chr1,39345560,0.91,63,6,69,603279
chr1,39345591,0.78,46,13,59,603280
chr1,39345633,0,0,163,163,603281
chr1,39345643,0,0,157,157,603282
chr1,39345668,0.48,130,142,272,603283
chr1,39345678,0.17,29,143,172,603284
chr1,39345680,0.42,31,42,73,603285
chr1,39345698,0.21,41,153,194,603286
chr1,39345796,0.94,50,3,53,603287
chr1,39345802,0.98,49,1,50,603288
chr1,39345812,0.96,47,2,49,603289
chr1,39345840,0.94,51,3,54,603290
chr1,39345849,0.34,59,114,173,603291
chr1,39345932,0.98,54,1,55,603292
chr1,39345936,0.84,52,10,62,603293
chr1,39345944,0.74,50,18,68,603294
chr1,39345948,0.23,41,135,176,603295
chr1,39345963,0.72,108,41,149,603296
chr1,39345968,0.23,39,129,168,603297
chr1,39345999,0.7,102,44,146,603298
chr1,39346181,0.75,46,15,61,603299
chr1,39346183,0.62,63,38,101,603300
chr1,39346193,0.63,41,24,65,603301
chr1,39346226,0.72,48,19,67,603302
chr1,39346237,0.98,51,1,52,603303
chr1,39346251,0.76,58,18,76,603304
chr1,39346310,0.91,58,6,64,603305
chr1,39346368,0.32,62,129,191,603306
chr1,39346402,0.77,72,21,93,603307
chr1,39346600,0.77,95,28,123,603308
chr1,39346612,0.42,97,135,232,603309
chr1,39346788,0.78,107,30,137,603310
chr1,39347776,0.31,68,153,221,603311
chr1,39348181,0.31,70,154,224,603312
chr1,39348721,0.53,79,69,148,603313
chr1,39348840,0.87,53,8,61,603314
chr1,39348896,0.22,34,123,157,603315
chr1,39348904,0.25,32,94,126,603316
chr1,39348907,0.31,42,92,134,603317
chr1,39348912,0,0,46,46,603318
chr1,39348917,0,0,58,58,603319
chr1,39348926,0.17,19,95,114,603320
chr1,39348931,0,0,102,102,603321
chr1,39348947,0,0,50,50,603322
chr1,39348972,0,0,59,59,603323
chr1,39349032,0.37,36,61,97,603324
chr1,39349366,0,0,124,124,603325
chr1,39349409,0.85,50,9,59,603326
chr1,39349787,0.36,56,101,157,603327
chr1,39349816,0.29,50,125,175,603328
chr1,39349860,0.91,30,3,33,603329
chr1,39349876,0,0,154,154,603330
chr1,39349922,0.81,114,26,140,603331
chr1,39349937,0.82,115,25,140,603332
chr1,39350043,0.25,43,128,171,603333
chr1,39350049,0.69,41,18,59,603334
chr1,39350057,0.56,38,30,68,603335
chr1,39350082,0.76,131,41,172,603336
chr1,39350168,0.66,50,26,76,603337
chr1,39350177,0.53,49,44,93,603338
chr1,39350195,0.17,43,208,251,603339
chr1,39350221,0,0,68,68,603340
chr1,39350234,0.79,22,6,28,603341
chr1,39350314,0.53,41,36,77,603342
chr1,39350377,0.95,200,10,210,603343
chr1,39350401,0.43,74,99,173,603344
chr1,39350424,0.85,74,13,87,603345
chr1,39350439,0.92,77,7,84,603346
chr1,39350482,0.81,75,18,93,603347
chr1,39350600,0.93,37,3,40,603348
chr1,39351062,0.66,76,39,115,603349
chr1,39351084,0.93,74,6,80,603350
chr1,39351165,0.89,81,10,91,603351
chr1,39351372,0.67,85,42,127,603352
chr1,39351646,0.64,85,47,132,603353
chr1,39351653,0.97,88,3,91,603354
chr1,39351683,0.96,79,3,82,603355
chr1,39351691,0.78,76,21,97,603356
chr1,39351708,0.99,74,1,75,603357
chr1,39351745,0.71,79,32,111,603358
chr1,39351771,0.95,82,4,86,603359
chr1,39351779,0.79,76,20,96,603360
chr1,39351783,0.38,74,119,193,603361
chr1,39351873,1,56,0,56,603362
chr1,39351906,0.3,64,148,212,603363
chr1,39351918,0.95,75,4,79,603364
chr1,39351979,0,0,212,212,603365
chr1,39351984,0.6,128,84,212,603366
chr1,39352299,0.5,112,113,225,603367
chr1,39352445,0.61,51,32,83,603368
chr1,39352926,0.87,60,9,69,603369
chr1,39352946,0.86,57,9,66,603370
chr1,39353159,0.87,91,14,105,603371
chr1,39353165,0.88,89,12,101,603372
chr1,39353182,0.41,85,124,209,603373
chr1,39353199,0.82,79,17,96,603374
chr1,39353221,0.91,61,6,67,603375
chr1,39353253,0.82,89,20,109,603376
chr1,39353285,0.9,83,9,92,603377
chr1,39353337,0.97,98,3,101,603378
chr1,39353340,0.54,92,77,169,603379
chr1,39353558,0.51,68,66,134,603380
chr1,39353635,0.98,79,2,81,603381
chr1,39354141,0.63,97,57,154,603382
chr1,39354192,0.8,82,21,103,603383
chr1,39354491,0,0,165,165,603384
chr1,39354507,0.49,38,40,78,603385
chr1,39354804,0.85,68,12,80,603386
chr1,39354834,0.86,77,13,90,603387
chr1,39354851,0.69,88,39,127,603388
chr1,39354875,0.91,86,9,95,603389
chr1,39354926,0.52,96,90,186,603390
chr1,39354957,0.78,91,25,116,603391
chr1,39354965,0.85,95,17,112,603392
chr1,39354993,0.84,97,18,115,603393
chr1,39355025,0.83,86,18,104,603394
chr1,39355172,0.78,42,12,54,603395
chr1,39355267,0.68,54,25,79,603396
chr1,39355362,0.77,63,19,82,603397
chr1,39355388,0.92,95,8,103,603398
chr1,39355632,0.79,54,14,68,603399
chr1,39355732,0.93,25,2,27,603400
chr1,39355748,0.97,31,1,32,603401
chr1,39355810,0.97,64,2,66,603402
chr1,39355898,0.93,53,4,57,603403
chr1,39355927,0.68,34,16,50,603404
chr1,39355938,0.61,41,26,67,603405
chr1,39355943,0.61,41,26,67,603406
chr1,39355961,0.95,56,3,59,603407
chr1,39355971,1,65,0,65,603408
chr1,39355981,0.93,65,5,70,603409
chr1,39356402,0.34,66,128,194,603410
chr1,39356440,0.7,76,33,109,603411
chr1,39356474,0.61,86,56,142,603412
chr1,39356524,0.88,100,14,114,603413
chr1,39356678,0.95,52,3,55,603414
chr1,39356738,0.77,49,15,64,603415
chr1,39356864,0.97,28,1,29,603416
chr1,39356919,1,10,0,10,603417
chr1,39356927,0.85,11,2,13,603418
chr1,39357149,0.59,76,53,129,603419
chr1,39357372,0.84,69,13,82,603420
chr1,39357454,0.57,60,46,106,603421
chr1,39357837,0.88,73,10,83,603422
chr1,39357845,0.86,85,14,99,603423
chr1,39357862,0.99,80,1,81,603424
chr1,39358155,0.65,74,39,113,603425
chr1,39358201,0.7,86,36,122,603426
chr1,39358471,0.93,64,5,69,603427
chr1,39359037,0.8,94,23,117,603428
chr1,39359362,0.83,80,16,96,603429
chr1,39359393,0.55,154,125,279,603430
chr1,39359496,0.92,69,6,75,603431
chr1,39359609,0.64,68,39,107,603432
chr1,39359618,0.35,79,147,226,603433
chr1,39359630,0.57,73,55,128,603434
chr1,39360034,0.56,96,76,172,603435
chr1,39360087,1,41,0,41,603436
chr1,39360097,0.98,40,1,41,603437
chr1,39360141,0.82,36,8,44,603438
chr1,39360183,0.17,29,145,174,603439
chr1,39360203,0.01,1,175,176,603440
chr1,39360214,0.82,128,29,157,603441
chr1,39360235,0.47,46,52,98,603442
chr1,39360447,0,0,167,167,603443
chr1,39360452,0,0,173,173,603444
chr1,39360477,0,0,220,220,603445
chr1,39360482,0,1,216,217,603446
chr1,39360503,0.66,65,33,98,603447
chr1,39360567,0.36,71,129,200,603448
chr1,39360598,0.7,77,33,110,603449
chr1,39360656,0.97,74,2,76,603450
chr1,39360666,0.97,73,2,75,603451
chr1,39360672,0.38,74,119,193,603452
chr1,39360742,0.48,98,108,206,603453
chr1,39360906,0.71,67,28,95,603454
chr1,39360964,0.62,67,41,108,603455
chr1,39361062,0.43,58,76,134,603456
chr1,39361203,0.39,88,138,226,603457
chr1,39361213,0.4,80,120,200,603458
chr1,39361244,0.32,64,136,200,603459
chr1,39361255,0.76,67,21,88,603460
chr1,39361273,0.61,69,45,114,603461
chr1,39361296,1,69,0,69,603462
chr1,39361392,0,0,214,214,603463
chr1,39361422,0,0,209,209,603464
chr1,39361443,0,0,191,191,603465
chr1,39361447,0,0,184,184,603466
chr1,39361468,0.59,100,69,169,603467
chr1,39361568,0.75,56,19,75,603468
chr1,39361780,0.3,60,139,199,603469
chr1,39361977,0.79,77,21,98,603470
chr1,39362190,0.82,71,16,87,603471
chr1,39362364,0.9,111,13,124,603472
chr1,39362811,0.12,18,130,148,603473
chr1,39362815,0.01,1,150,151,603474
chr1,39362841,0.71,105,43,148,603475
chr1,39362846,0.01,1,83,84,603476
chr1,39362851,0.01,1,85,86,603477
chr1,39362865,0,0,130,130,603478
chr1,39362901,0.58,48,35,83,603479
chr1,39362913,0,0,47,47,603480
chr1,39362929,1,21,0,21,603481
chr1,39362962,0.12,2,15,17,603482
chr1,39362991,0,0,40,40,603483
chr1,39363007,0.39,27,42,69,603484
chr1,39363023,0.69,40,18,58,603485
chr1,39363051,0.82,68,15,83,603486
chr1,39363063,0.8,78,19,97,603487
chr1,39363067,0.39,86,133,219,603488
chr1,39363194,0.9,90,10,100,603489
chr1,39363213,0.76,81,25,106,603490
chr1,39363259,0.94,79,5,84,603491
chr1,39363341,0.72,69,27,96,603492
chr1,39363351,0.82,76,17,93,603493
chr1,39363524,0.42,119,166,285,603494
chr1,39363530,0.54,53,45,98,603495
chr1,39363540,0.58,57,41,98,603496
chr1,39363600,0.55,56,46,102,603497
chr1,39363623,0.31,65,142,207,603498
chr1,39363659,0.77,68,20,88,603499
chr1,39363759,0.6,71,47,118,603500
chr1,39363883,0.35,71,134,205,603501
chr1,39363930,0.34,58,111,169,603502
chr1,39364314,0.74,110,38,148,603503
chr1,39364954,0.47,47,53,100,603504
chr1,39364991,0.94,50,3,53,603505
chr1,39365032,0.29,35,87,122,603506
chr1,39365421,0.83,65,13,78,603507
chr1,39365540,0.31,49,107,156,603508
chr1,39365595,0.89,67,8,75,603509
chr1,39365620,0.83,50,10,60,603510
chr1,39365948,0.97,74,2,76,603511
chr1,39365984,0.66,80,41,121,603512
chr1,39366015,0.65,143,77,220,603513
chr1,39366056,0.89,80,10,90,603514
chr1,39366082,0.93,83,6,89,603515
chr1,39366113,0.98,89,2,91,603516
chr1,39366207,0.73,101,37,138,603517
chr1,39366270,0.37,71,123,194,603518
chr1,39366329,0.97,63,2,65,603519
chr1,39366360,0.4,68,103,171,603520
chr1,39366441,0.47,43,48,91,603521
chr1,39366580,0.67,76,38,114,603522
chr1,39366592,0.74,144,50,194,603523
chr1,39366634,0.37,83,143,226,603524
chr1,39366856,0.79,75,20,95,603525
chr1,39366954,0.85,91,16,107,603526
chr1,39367034,0.77,117,35,152,603527
chr1,39367088,0.79,88,23,111,603528
chr1,39367245,0.97,67,2,69,603529
chr1,39367273,0.92,65,6,71,603530
chr1,39367336,0.85,45,8,53,603531
chr1,39367364,0.54,41,35,76,603532
chr1,39367400,0.46,46,54,100,603533
chr1,39367432,0.67,60,29,89,603534
chr1,39367490,0.97,66,2,68,603535
chr1,39367916,0.91,51,5,56,603536
chr1,39367930,0.76,66,21,87,603537
chr1,39367962,0.81,88,20,108,603538
chr1,39368002,0.8,90,23,113,603539
chr1,39368152,0.98,46,1,47,603540
chr1,39368194,0.34,72,139,211,603541
chr1,39368283,0.59,74,51,125,603542
chr1,39368302,0.97,76,2,78,603543
chr1,39368313,0.94,72,5,77,603544
chr1,39368334,0.97,77,2,79,603545
chr1,39368343,0.74,80,28,108,603546
chr1,39368503,0.93,68,5,73,603547
chr1,39368515,0.96,75,3,78,603548
chr1,39368872,0.64,72,41,113,603549
chr1,39368956,0.87,47,7,54,603550
chr1,39369000,0.54,51,43,94,603551
chr1,39369031,0.67,56,27,83,603552
chr1,39369049,0.26,58,166,224,603553
chr1,39369107,0.86,62,10,72,603554
chr1,39369111,0.59,57,39,96,603555
chr1,39369315,0.68,74,35,109,603556
chr1,39369380,0.94,87,6,93,603557
chr1,39369868,0.62,78,47,125,603558
chr1,39369880,0.78,70,20,90,603559
chr1,39369895,0.47,54,62,116,603560
chr1,39369908,0.68,50,23,73,603561
chr1,39369956,0.58,51,37,88,603562
chr1,39369969,0.67,52,26,78,603563
chr1,39370017,0.73,78,29,107,603564
chr1,39370061,0.33,80,163,243,603565
chr1,39370069,0.69,70,31,101,603566
chr1,39370075,0.97,69,2,71,603567
chr1,39370092,0.29,63,153,216,603568
chr1,39370100,0.98,59,1,60,603569
chr1,39370275,0.91,64,6,70,603570
chr1,39370425,0.98,47,1,48,603571
chr1,39370429,0.67,41,20,61,603572
chr1,39370431,0.29,38,93,131,603573
chr1,39370441,0.25,38,115,153,603574
chr1,39370512,0.61,104,66,170,603575
chr1,39370557,0.85,132,24,156,603576
chr1,39370562,0.84,134,25,159,603577
chr1,39370602,0.61,99,63,162,603578
chr1,39370647,0.65,108,59,167,603579
chr1,39370671,0,0,135,135,603580
chr1,39370676,0,0,141,141,603581
chr1,39370681,0.33,20,41,61,603582
chr1,39370702,0,0,73,73,603583
chr1,39370750,0.96,49,2,51,603584
chr1,39370791,0.43,72,97,169,603585
chr1,39370801,0.46,74,86,160,603586
chr1,39370861,0.84,94,18,112,603587
chr1,39371071,0.32,81,176,257,603588
chr1,39371249,0,0,54,54,603589
chr1,39371411,0,0,107,107,603590
chr1,39371441,0.01,1,171,172,603591
chr1,39371446,0.1,19,171,190,603592
chr1,39371653,0.78,47,13,60,603593
chr1,39371693,0.83,33,7,40,603594
chr1,39371782,0.93,69,5,74,603595
chr1,39372068,0.98,55,1,56,603596
chr1,39372072,0.98,55,1,56,603597
chr1,39372104,0.97,58,2,60,603598
chr1,39372117,0.98,56,1,57,603599
chr1,39372142,0.95,42,2,44,603600
chr1,39372162,0.95,36,2,38,603601
chr1,39372238,1,10,0,10,603602
chr1,39372293,1,18,0,18,603603
chr1,39372300,1,21,0,21,603604
chr1,39372324,1,20,0,20,603605
chr1,39372332,1,25,0,25,603606
chr1,39372842,0.91,62,6,68,603607
chr1,39372977,1,40,0,40,603608
chr1,39373009,1,31,0,31,603609
chr1,39373032,0.98,40,1,41,603610
chr1,39373084,1,44,0,44,603611
chr1,39373160,0.96,46,2,48,603612
chr1,39373166,0.98,43,1,44,603613
chr1,39373168,0.98,43,1,44,603614
chr1,39373174,0.98,49,1,50,603615
chr1,39373190,0.98,54,1,55,603616
chr1,39373199,1,59,0,59,603617
chr1,39373311,0.97,84,3,87,603618
chr1,39373337,0.98,81,2,83,603619
chr1,39373950,0.94,50,3,53,603620
chr1,39374040,0.92,55,5,60,603621
chr1,39374076,0.98,52,1,53,603622
chr1,39374179,0.79,19,5,24,603623
chr1,39374270,0.86,36,6,42,603624
chr1,39374277,0.95,39,2,41,603625
chr1,39374281,0.89,40,5,45,603626
chr1,39374297,0.94,50,3,53,603627
chr1,39374344,0.82,60,13,73,603628
chr1,39374371,0.9,74,8,82,603629
chr1,39374564,0.67,70,35,105,603630
chr1,39374636,0.95,62,3,65,603631
chr1,39374666,0.83,53,11,64,603632
chr1,39374674,0.92,57,5,62,603633
chr1,39374706,0.97,61,2,63,603634
chr1,39374708,0.89,58,7,65,603635
chr1,39374715,0.96,65,3,68,603636
chr1,39374737,0.93,69,5,74,603637
chr1,39374745,0.93,68,5,73,603638
chr1,39374767,0.85,73,13,86,603639
chr1,39374781,0.83,76,16,92,603640
chr1,39374819,0.91,73,7,80,603641
chr1,39374847,0.97,62,2,64,603642
chr1,39374906,0.66,33,17,50,603643
chr1,39374922,0.73,32,12,44,603644
chr1,39374999,0.98,61,1,62,603645
chr1,39375006,0.93,54,4,58,603646
chr1,39375074,0.93,83,6,89,603647
chr1,39375156,0.92,69,6,75,603648
chr1,39375211,1,60,0,60,603649
chr1,39375319,0.97,34,1,35,603650
chr1,39375345,1,43,0,43,603651
chr1,39375368,1,38,0,38,603652
chr1,39375392,0.98,46,1,47,603653
chr1,39375737,0.97,86,3,89,603654
chr1,39375785,0.96,87,4,91,603655
chr1,39375956,0.86,73,12,85,603656
chr1,39376015,0.96,70,3,73,603657
chr1,39376084,0.95,80,4,84,603658
chr1,39376217,0.91,69,7,76,603659
chr1,39376381,0.91,68,7,75,603660
chr1,39376474,0.88,46,6,52,603661
chr1,39376536,0.98,53,1,54,603662
chr1,39376670,0.89,58,7,65,603663
chr1,39376684,0.87,59,9,68,603664
chr1,39376736,0.97,75,2,77,603665
chr1,39376871,0.91,80,8,88,603666
chr1,39377029,0.73,58,21,79,603667
chr1,39377242,1,53,0,53,603668
chr1,39377321,0.18,19,85,104,603669
chr1,39377323,0.5,22,22,44,603670
chr1,39377325,0.48,10,11,21,603671
chr1,39377329,0.63,22,13,35,603672
chr1,39377331,0.53,25,22,47,603673
chr1,39377501,0.69,48,22,70,603674
chr1,39377517,0.84,53,10,63,603675
chr1,39377581,0.55,72,58,130,603676
chr1,39377590,0.96,74,3,77,603677
chr1,39377635,0.88,66,9,75,603678
chr1,39377665,0.85,63,11,74,603679
chr1,39377686,0,0,386,386,603680
chr1,39377704,0.01,1,81,82,603681
chr1,39377712,0.72,84,32,116,603682
chr1,39377746,0.31,90,204,294,603683
chr1,39377792,0.82,81,18,99,603684
chr1,39377937,0.94,75,5,80,603685
chr1,39377997,0.96,51,2,53,603686
chr1,39378023,0.91,48,5,53,603687
chr1,39378054,0.94,47,3,50,603688
chr1,39378066,0.95,42,2,44,603689
chr1,39378068,0.96,46,2,48,603690
chr1,39378077,0.98,42,1,43,603691
chr1,39378139,0.94,50,3,53,603692
chr1,39378189,0.84,56,11,67,603693
chr1,39378292,0.91,51,5,56,603694
chr1,39378709,0.73,19,7,26,603695
chr1,39378717,0.84,26,5,31,603696
chr1,39378723,0.82,28,6,34,603697
chr1,39378757,0.93,53,4,57,603698
chr1,39378789,0.97,62,2,64,603699
chr1,39378811,0.99,67,1,68,603700
chr1,39378843,0.98,65,1,66,603701
chr1,39379033,0.96,97,4,101,603702
chr1,39379260,0.97,59,2,61,603703
chr1,39379271,0.98,63,1,64,603704
chr1,39379330,0.76,65,21,86,603705
chr1,39379400,0.92,103,9,112,603706
chr1,39379429,0.97,92,3,95,603707
chr1,39379487,0.99,69,1,70,603708
chr1,39379508,0.99,66,1,67,603709
chr1,39379512,0.92,59,5,64,603710
chr1,39379528,0.98,49,1,50,603711
chr1,39379565,1,27,0,27,603712
chr1,39379617,0.91,10,1,11,603713
chr1,39379649,0.95,36,2,38,603714
chr1,39379659,0.93,43,3,46,603715
chr1,39379681,0.91,59,6,65,603716
chr1,39379737,0.97,58,2,60,603717
chr1,39379743,0.98,54,1,55,603718
chr1,39379751,1,51,0,51,603719
chr1,39379766,1,48,0,48,603720
chr1,39379832,1,64,0,64,603721
chr1,39379974,1,80,0,80,603722
chr1,39379982,0.97,89,3,92,603723
chr1,39379999,0.99,96,1,97,603724
chr1,39380058,0.96,79,3,82,603725
chr1,39380070,1,80,0,80,603726
chr1,39380102,0.9,56,6,62,603727
chr1,39380209,0.86,49,8,57,603728
chr1,39380306,0.97,62,2,64,603729
chr1,39380385,0.94,77,5,82,603730
chr1,39380472,0.96,82,3,85,603731
chr1,39380529,0.94,72,5,77,603732
chr1,39380558,0.98,78,2,80,603733
chr1,39380615,0.93,88,7,95,603734
chr1,39380632,0.99,95,1,96,603735
chr1,39380649,0.93,78,6,84,603736
chr1,39380687,1,58,0,58,603737
chr1,39380867,0.93,50,4,54,603738
chr1,39380873,0.96,55,2,57,603739
chr1,39380890,0.96,65,3,68,603740
chr1,39380929,0.95,75,4,79,603741
chr1,39381016,0.91,69,7,76,603742
chr1,39381329,0.42,27,38,65,603743
chr1,39381447,0.53,44,39,83,603744
chr1,39381557,0.94,61,4,65,603745
chr1,39381664,0.82,50,11,61,603746
chr1,39381708,0.92,68,6,74,603747
chr1,39381711,0.93,68,5,73,603748
chr1,39381768,0.9,54,6,60,603749
chr1,39381924,0.87,60,9,69,603750
chr1,39381965,0.97,65,2,67,603751
chr1,39382242,0.91,61,6,67,603752
chr1,39382340,0.94,34,2,36,603753
chr1,39382403,0.95,19,1,20,603754
chr1,39382474,0.93,54,4,58,603755
chr1,39382522,0.95,37,2,39,603756
chr1,39382530,0.97,36,1,37,603757
chr1,39382750,0.93,25,2,27,603758
chr1,39382790,1,36,0,36,603759
chr1,39382838,1,17,0,17,603760
chr1,39382850,0.8,12,3,15,603761
chr1,39382890,0.91,10,1,11,603762
chr1,39382931,1,33,0,33,603763
chr1,39382968,1,59,0,59,603764
chr1,39382980,0.98,54,1,55,603765
chr1,39382984,0.96,53,2,55,603766
chr1,39383178,0.83,63,13,76,603767
chr1,39383312,0.92,60,5,65,603768
chr1,39383316,0.91,59,6,65,603769
chr1,39383598,0.98,78,2,80,603770
chr1,39384046,0.18,17,78,95,603771
chr1,39384180,0.78,73,21,94,603772
chr1,39384214,0.68,65,30,95,603773
chr1,39384299,0.83,80,16,96,603774
chr1,39384448,0.46,28,33,61,603775
chr1,39384527,0.66,29,15,44,603776
chr1,39384613,0.88,52,7,59,603777
chr1,39384625,0.81,65,15,80,603778
chr1,39384641,0.88,67,9,76,603779
chr1,39384769,0.93,69,5,74,603780
chr1,39384961,0.68,61,29,90,603781
chr1,39384983,0.72,76,29,105,603782
chr1,39384988,0.27,28,75,103,603783
chr1,39385253,0.99,75,1,76,603784
chr1,39385341,1,55,0,55,603785
chr1,39385465,0.94,48,3,51,603786
chr1,39385492,0.98,45,1,46,603787
chr1,39385525,0.81,42,10,52,603788
chr1,39385535,0.81,52,12,64,603789
chr1,39385541,0.96,54,2,56,603790
chr1,39385713,0.74,76,27,103,603791
chr1,39385870,0.97,28,1,29,603792
chr1,39385902,0.97,56,2,58,603793
chr1,39385908,0.97,63,2,65,603794
chr1,39385942,0.97,70,2,72,603795
chr1,39385988,0.99,71,1,72,603796
chr1,39386059,0.9,64,7,71,603797
chr1,39386091,0.91,67,7,74,603798
chr1,39386188,0.95,80,4,84,603799
chr1,39386210,0.95,78,4,82,603800
chr1,39386247,0.61,57,37,94,603801
chr1,39386371,0.95,54,3,57,603802
chr1,39386524,0.01,1,110,111,603803
chr1,39386533,0.37,27,46,73,603804
chr1,39386538,0.4,35,52,87,603805
chr1,39386576,0.31,62,135,197,603806
chr1,39386749,0.99,84,1,85,603807
chr1,39386802,0.95,73,4,77,603808
chr1,39386806,1,78,0,78,603809
chr1,39386818,0.86,78,13,91,603810
chr1,39386879,0.62,82,50,132,603811
chr1,39386924,0.53,80,72,152,603812
chr1,39386967,0.49,82,84,166,603813
chr1,39387052,0.72,48,19,67,603814
chr1,39387082,0.61,52,33,85,603815
chr1,39387184,0.82,77,17,94,603816
chr1,39387387,0.63,65,39,104,603817
chr1,39387476,0.86,126,21,147,603818
chr1,39387813,0.73,52,19,71,603819
chr1,39388008,0.97,32,1,33,603820
chr1,39388187,0.08,1,11,12,603821
chr1,39388401,0.93,14,1,15,603822
chr1,39388407,1,21,0,21,603823
chr1,39388485,0.9,77,9,86,603824
chr1,39388529,0.94,95,6,101,603825
chr1,39388535,0.85,101,18,119,603826
chr1,39388597,0.9,104,12,116,603827
chr1,39388716,0.94,72,5,77,603828
chr1,39388740,0,0,52,52,603829
chr1,39389041,0.89,68,8,76,603830
chr1,39389165,0.68,90,42,132,603831
chr1,39389255,0.94,107,7,114,603832
chr1,39389269,0.94,99,6,105,603833
chr1,39389403,0.77,86,25,111,603834
chr1,39389534,0.88,84,11,95,603835
chr1,39389568,0.92,78,7,85,603836
chr1,39390004,0.89,65,8,73,603837
chr1,39390031,0.95,74,4,78,603838
chr1,39390041,0.69,75,33,108,603839
chr1,39390062,0.95,58,3,61,603840
chr1,39390126,0.89,31,4,35,603841
chr1,39390134,0.86,30,5,35,603842
chr1,39390138,1,31,0,31,603843
chr1,39390197,1,4,0,4,603844
chr1,39390214,0.48,40,43,83,603845
chr1,39390222,0.55,47,38,85,603846
chr1,39390244,0.46,44,52,96,603847
chr1,39390257,0,0,53,53,603848
chr1,39390260,0.37,56,95,151,603849
chr1,39390286,0.32,108,225,333,603850
chr1,39390516,0.86,51,8,59,603851
chr1,39390522,0.6,53,36,89,603852
chr1,39390752,0.63,80,46,126,603853
chr1,39390935,0.9,112,13,125,603854
chr1,39390963,0.93,113,9,122,603855
chr1,39390967,0.94,116,7,123,603856
chr1,39391026,0.97,110,3,113,603857
chr1,39391062,0.94,88,6,94,603858
chr1,39391120,0.96,50,2,52,603859
chr1,39391167,0.94,33,2,35,603860
chr1,39391690,0.94,79,5,84,603861
chr1,39391696,0.63,59,34,93,603862
chr1,39391751,0.89,79,10,89,603863
chr1,39391925,0.74,50,18,68,603864
chr1,39391964,0.87,65,10,75,603865
chr1,39391986,0.9,72,8,80,603866
chr1,39392001,0.92,69,6,75,603867
chr1,39392225,0.56,80,62,142,603868
chr1,39392234,0.72,89,34,123,603869
chr1,39392236,0.55,84,69,153,603870
chr1,39392246,0.94,81,5,86,603871
chr1,39392279,0.95,75,4,79,603872
chr1,39392283,0.94,68,4,72,603873
chr1,39392298,0.44,75,95,170,603874
chr1,39392306,0.94,79,5,84,603875
chr1,39392345,0.96,96,4,100,603876
chr1,39392426,0.73,66,24,90,603877
chr1,39392436,0.67,60,30,90,603878
chr1,39392466,0.87,59,9,68,603879
chr1,39392498,0.94,72,5,77,603880
chr1,39392547,0.95,99,5,104,603881
chr1,39392574,0.97,99,3,102,603882
chr1,39392621,0.89,93,12,105,603883
chr1,39392629,0.87,86,13,99,603884
chr1,39392816,0.97,58,2,60,603885
chr1,39392825,0.98,54,1,55,603886
chr1,39392827,0.98,54,1,55,603887
chr1,39392837,1,46,0,46,603888
chr1,39392870,0.88,22,3,25,603889
chr1,39392895,0.67,2,1,3,603890
chr1,39392955,1,6,0,6,603891
chr1,39392959,1,8,0,8,603892
chr1,39392967,1,9,0,9,603893
chr1,39392971,1,11,0,11,603894
chr1,39392991,0.71,10,4,14,603895
chr1,39393012,1,27,0,27,603896
chr1,39393030,1,28,0,28,603897
chr1,39393047,1,32,0,32,603898
chr1,39393053,1,33,0,33,603899
chr1,39393055,1,32,0,32,603900
chr1,39393077,1,28,0,28,603901
chr1,39393150,0.98,54,1,55,603902
chr1,39393611,0.92,65,6,71,603903
chr1,39393615,0.99,70,1,71,603904
chr1,39393663,0.99,80,1,81,603905
chr1,39393836,0.71,5,2,7,603906
chr1,39393844,0.86,6,1,7,603907
chr1,39393852,1,8,0,8,603908
chr1,39393876,1,19,0,19,603909
chr1,39393916,0.98,39,1,40,603910
chr1,39393970,0.99,69,1,70,603911
chr1,39394004,0.69,61,28,89,603912
chr1,39394015,0.97,67,2,69,603913
chr1,39394060,0.57,52,40,92,603914
chr1,39394065,1,53,0,53,603915
chr1,39394102,0.97,35,1,36,603916
chr1,39394105,0.62,28,17,45,603917
chr1,39394109,0.93,28,2,30,603918
chr1,39394181,0.87,34,5,39,603919
chr1,39394243,0.94,61,4,65,603920
chr1,39394267,0.94,63,4,67,603921
chr1,39394275,0.97,63,2,65,603922
chr1,39394337,0.97,57,2,59,603923
chr1,39394364,0.99,72,1,73,603924
chr1,39394369,0.95,74,4,78,603925
chr1,39394380,0.93,80,6,86,603926
chr1,39394498,0.95,60,3,63,603927
chr1,39394553,1,59,0,59,603928
chr1,39394635,0.83,70,14,84,603929
chr1,39394657,0.99,80,1,81,603930
chr1,39394666,0.84,81,16,97,603931
chr1,39394730,0.99,75,1,76,603932
chr1,39394899,0.89,48,6,54,603933
chr1,39394903,0.94,49,3,52,603934
chr1,39394981,0.69,55,25,80,603935
chr1,39394984,0.93,65,5,70,603936
chr1,39395007,0.82,55,12,67,603937
chr1,39395016,0.88,58,8,66,603938
chr1,39395078,0.79,49,13,62,603939
chr1,39395165,0.72,66,26,92,603940
chr1,39395266,0.36,47,84,131,603941
chr1,39395279,0.69,71,32,103,603942
chr1,39395317,0.92,67,6,73,603943
chr1,39395373,0.54,28,24,52,603944
chr1,39395389,0.84,37,7,44,603945
chr1,39395667,0.66,114,59,173,603946
chr1,39395777,0.9,74,8,82,603947
chr1,39395863,0.47,59,66,125,603948
chr1,39395866,0.31,69,152,221,603949
chr1,39395942,0.73,97,35,132,603950
chr1,39395968,0.89,89,11,100,603951
chr1,39396107,0.89,95,12,107,603952
chr1,39396281,1,68,0,68,603953
chr1,39396505,0.7,78,34,112,603954
chr1,39396773,0.71,80,33,113,603955
chr1,39396911,0.74,84,29,113,603956
chr1,39396931,0.77,72,21,93,603957
chr1,39396959,0.73,35,13,48,603958
chr1,39396975,0.64,23,13,36,603959
chr1,39396989,0.57,16,12,28,603960
chr1,39397020,0.57,20,15,35,603961
chr1,39397053,0.52,58,54,112,603962
chr1,39397061,0.6,67,45,112,603963
chr1,39397065,0.71,63,26,89,603964
chr1,39397085,0.69,68,30,98,603965
chr1,39397142,0.57,54,40,94,603966
chr1,39397150,0.59,67,47,114,603967
chr1,39397180,0.91,42,4,46,603968
chr1,39397188,0.56,25,20,45,603969
chr1,39397559,0.92,85,7,92,603970
chr1,39397664,0.87,41,6,47,603971
chr1,39397698,0.48,31,33,64,603972
chr1,39398170,0.86,49,8,57,603973
chr1,39398194,0.92,54,5,59,603974
chr1,39398280,1,83,0,83,603975
chr1,39398303,0.98,80,2,82,603976
chr1,39398339,0.98,81,2,83,603977
chr1,39398367,1,79,0,79,603978
chr1,39398369,0.99,73,1,74,603979
chr1,39398411,0.97,58,2,60,603980
chr1,39398600,0.91,89,9,98,603981
chr1,39398675,0.44,70,90,160,603982
chr1,39398699,0.9,89,10,99,603983
chr1,39398832,0.42,27,37,64,603984
chr1,39398857,0.49,37,38,75,603985
chr1,39398995,0.43,43,56,99,603986
chr1,39399029,0.32,29,61,90,603987
chr1,39399298,0.45,25,30,55,603988
chr1,39399358,0.79,37,10,47,603989
chr1,39399361,0.96,46,2,48,603990
chr1,39399689,0.8,59,15,74,603991
chr1,39399757,0.98,55,1,56,603992
chr1,39399934,0.7,44,19,63,603993
chr1,39399968,0.89,54,7,61,603994
chr1,39400051,0.66,120,63,183,603995
chr1,39400094,0.28,58,149,207,603996
chr1,39400124,0.94,44,3,47,603997
chr1,39400155,0.43,42,56,98,603998
chr1,39400221,0.65,78,42,120,603999
chr1,39400242,0.67,73,36,109,604000
chr1,39400252,0.58,73,53,126,604001
chr1,39400287,0.98,45,1,46,604002
chr1,39400289,0.46,45,52,97,604003
chr1,39400355,0.88,30,4,34,604004
chr1,39400357,0.94,31,2,33,604005
chr1,39400400,0.47,46,51,97,604006
chr1,39400411,0.47,49,55,104,604007
chr1,39400456,0.54,55,47,102,604008
chr1,39400627,0.7,33,14,47,604009
chr1,39400719,0.57,61,46,107,604010
chr1,39401205,0.98,114,2,116,604011
chr1,39401287,0.88,76,10,86,604012
chr1,39401377,0.91,62,6,68,604013
chr1,39401490,0.85,71,13,84,604014
chr1,39401505,0.85,75,13,88,604015
chr1,39401523,0.86,73,12,85,604016
chr1,39401581,0.92,44,4,48,604017
chr1,39401669,0.9,45,5,50,604018
chr1,39401741,0.97,88,3,91,604019
chr1,39401763,0.76,83,26,109,604020
chr1,39401826,0.58,49,36,85,604021
chr1,39402232,0.94,44,3,47,604022
chr1,39402234,0.89,40,5,45,604023
chr1,39402257,0.88,59,8,67,604024
chr1,39402296,0.97,67,2,69,604025
chr1,39402304,0.65,66,36,102,604026
chr1,39402461,0.96,53,2,55,604027
chr1,39402494,0.92,54,5,59,604028
chr1,39402557,0.78,61,17,78,604029
chr1,39402605,0.79,50,13,63,604030
chr1,39402615,0.98,40,1,41,604031
chr1,39402688,1,21,0,21,604032
chr1,39402705,1,22,0,22,604033
chr1,39402712,0.43,9,12,21,604034
chr1,39402768,0.81,26,6,32,604035
chr1,39402864,0.96,53,2,55,604036
chr1,39402869,0.89,48,6,54,604037
chr1,39402897,0.9,43,5,48,604038
chr1,39402907,1,54,0,54,604039
chr1,39402909,0.95,53,3,56,604040
chr1,39402924,0.91,58,6,64,604041
chr1,39402952,0.73,57,21,78,604042
chr1,39403247,0.93,70,5,75,604043
chr1,39403618,0.97,70,2,72,604044
chr1,39403747,1,71,0,71,604045
chr1,39403750,1,77,0,77,604046
chr1,39403792,0.97,74,2,76,604047
chr1,39403838,0.99,67,1,68,604048
chr1,39403908,0.96,44,2,46,604049
chr1,39403933,0.98,43,1,44,604050
chr1,39403938,0.6,46,31,77,604051
chr1,39403966,0.85,50,9,59,604052
chr1,39403976,0.62,51,31,82,604053
chr1,39403978,0.77,61,18,79,604054
chr1,39404041,0.96,67,3,70,604055
chr1,39404416,0.96,85,4,89,604056
chr1,39404677,0.85,99,17,116,604057
chr1,39404807,0.8,71,18,89,604058
chr1,39404970,0.95,40,2,42,604059
chr1,39404988,0.82,37,8,45,604060
chr1,39405000,0.98,47,1,48,604061
chr1,39405117,0.95,71,4,75,604062
chr1,39405281,0.96,44,2,46,604063
chr1,39405492,0.94,49,3,52,604064
chr1,39405499,0.94,45,3,48,604065
chr1,39405509,1,45,0,45,604066
chr1,39405545,1,48,0,48,604067
chr1,39405637,1,84,0,84,604068
chr1,39406098,0.73,40,15,55,604069
chr1,39406125,0.9,63,7,70,604070
chr1,39406130,0.9,54,6,60,604071
chr1,39406152,0.93,67,5,72,604072
chr1,39406196,0.86,85,14,99,604073
chr1,39406220,0.67,97,48,145,604074
chr1,39406229,0.93,96,7,103,604075
chr1,39406441,0.78,75,21,96,604076
chr1,39406444,0.98,82,2,84,604077
chr1,39406759,0.99,86,1,87,604078
chr1,39406902,0.75,57,19,76,604079
chr1,39406909,0.81,57,13,70,604080
chr1,39407029,0.11,4,31,35,604081
chr1,39407121,0,0,35,35,604082
chr1,39407192,0.06,4,64,68,604083
chr1,39407232,0.16,7,36,43,604084
chr1,39407276,0.08,3,33,36,604085
chr1,39407297,0.17,2,10,12,604086
chr1,39407375,0.05,2,39,41,604087
chr1,39407387,0.13,3,20,23,604088
chr1,39407394,0.03,2,60,62,604089
chr1,39407403,0.02,1,55,56,604090
chr1,39407434,0.06,3,48,51,604091
chr1,39407451,0.1,3,28,31,604092
chr1,39407463,0.08,2,24,26,604093
chr1,39407471,0.05,2,35,37,604094
chr1,39407567,0.04,2,51,53,604095
chr1,39407624,0.07,3,39,42,604096
chr1,39407651,0.02,1,48,49,604097
chr1,39407760,0.1,7,65,72,604098
chr1,39407769,0.1,10,92,102,604099
chr1,39407851,0.39,55,85,140,604100
chr1,39407998,0.88,60,8,68,604101
chr1,39408054,0.86,56,9,65,604102
chr1,39408099,0.89,54,7,61,604103
chr1,39408151,0.95,37,2,39,604104
chr1,39408159,1,31,0,31,604105
chr1,39408253,0.89,8,1,9,604106
chr1,39408275,0.92,12,1,13,604107
chr1,39408285,0.94,17,1,18,604108
chr1,39408292,1,21,0,21,604109
chr1,39408317,1,34,0,34,604110
chr1,39408348,0.97,30,1,31,604111
chr1,39408355,1,31,0,31,604112
chr1,39408504,0.94,85,5,90,604113
chr1,39408558,0.95,90,5,95,604114
chr1,39408702,0.93,77,6,83,604115
chr1,39408755,0.86,43,7,50,604116
chr1,39408763,0.96,43,2,45,604117
chr1,39409027,0.95,52,3,55,604118
chr1,39409054,0.97,67,2,69,604119
chr1,39409072,0.97,67,2,69,604120
chr1,39409250,0.77,93,28,121,604121
chr1,39409312,0.72,101,39,140,604122
chr1,39409359,0.88,115,16,131,604123
chr1,39409689,0.66,72,37,109,604124
chr1,39409773,1,67,0,67,604125
chr1,39409783,0.98,61,1,62,604126
chr1,39409811,0.96,46,2,48,604127
chr1,39409914,0.97,73,2,75,604128
chr1,39409977,0.98,93,2,95,604129
chr1,39410018,0.96,87,4,91,604130
chr1,39410032,1,80,0,80,604131
chr1,39410076,0.91,72,7,79,604132
chr1,39410109,0.97,84,3,87,604133
chr1,39410154,0.94,79,5,84,604134
chr1,39410165,0.95,81,4,85,604135
chr1,39410208,0.91,89,9,98,604136
chr1,39410230,0.91,92,9,101,604137
chr1,39410269,0.98,102,2,104,604138
chr1,39410332,1,62,0,62,604139
chr1,39410428,1,95,0,95,604140
chr1,39410643,0.92,45,4,49,604141
chr1,39411360,0.98,50,1,51,604142
chr1,39411362,0.96,53,2,55,604143
chr1,39411405,0.94,46,3,49,604144
chr1,39411432,0.89,42,5,47,604145
chr1,39411455,0.64,41,23,64,604146
chr1,39411619,0.91,69,7,76,604147
chr1,39411625,0.95,71,4,75,604148
chr1,39411686,0.81,70,16,86,604149
chr1,39411843,0.93,66,5,71,604150
chr1,39411851,0.99,73,1,74,604151
chr1,39411899,0.93,52,4,56,604152
chr1,39411931,1,32,0,32,604153
chr1,39411994,0.79,33,9,42,604154
chr1,39412098,0.79,56,15,71,604155
chr1,39412306,0.91,30,3,33,604156
chr1,39412338,1,51,0,51,604157
chr1,39412371,0.9,64,7,71,604158
chr1,39412434,0.75,48,16,64,604159
chr1,39412462,0.63,56,33,89,604160
chr1,39412472,0.48,60,65,125,604161
chr1,39413264,0.79,64,17,81,604162
chr1,39413316,0.93,93,7,100,604163
chr1,39413378,0.99,83,1,84,604164
chr1,39413384,0.98,93,2,95,604165
chr1,39413591,0.9,70,8,78,604166
chr1,39413708,0.96,45,2,47,604167
chr1,39413713,0.96,43,2,45,604168
chr1,39413740,0.9,27,3,30,604169
chr1,39413805,1,29,0,29,604170
chr1,39413821,1,36,0,36,604171
chr1,39413873,1,45,0,45,604172
chr1,39413880,1,43,0,43,604173
chr1,39413903,1,42,0,42,604174
chr1,39413926,0.64,34,19,53,604175
chr1,39413942,0.44,30,38,68,604176
chr1,39414087,0.78,50,14,64,604177
chr1,39414098,0.71,48,20,68,604178
chr1,39414107,0.8,48,12,60,604179
chr1,39414224,0.9,66,7,73,604180
chr1,39414228,0.91,70,7,77,604181
chr1,39414437,0.95,78,4,82,604182
chr1,39414459,0.99,92,1,93,604183
chr1,39414499,0.92,69,6,75,604184
chr1,39414592,0.88,43,6,49,604185
chr1,39414780,0.62,92,57,149,604186
chr1,39414831,0.54,80,68,148,604187
chr1,39414893,0.55,71,57,128,604188
chr1,39414896,0.56,86,68,154,604189
chr1,39415155,0.84,65,12,77,604190
chr1,39415225,0.89,67,8,75,604191
chr1,39415245,0.84,67,13,80,604192
chr1,39415256,0.82,63,14,77,604193
chr1,39415300,0.7,88,38,126,604194
chr1,39415311,0.36,67,120,187,604195
chr1,39415356,0.69,75,33,108,604196
chr1,39415363,0.43,77,104,181,604197
chr1,39415380,0.43,40,52,92,604198
chr1,39415388,0.68,42,20,62,604199
chr1,39415418,0.89,42,5,47,604200
chr1,39415426,0.35,44,80,124,604201
chr1,39415634,0.5,69,70,139,604202
chr1,39415699,0.42,86,117,203,604203
chr1,39415727,0.48,89,97,186,604204
chr1,39415767,0.91,75,7,82,604205
chr1,39415783,0.93,66,5,71,604206
chr1,39415903,0.84,69,13,82,604207
chr1,39415915,0.92,77,7,84,604208
chr1,39415957,0.89,76,9,85,604209
chr1,39415967,0.89,65,8,73,604210
chr1,39415997,0.93,56,4,60,604211
chr1,39416021,0.85,35,6,41,604212
chr1,39416080,0.87,41,6,47,604213
chr1,39416189,0.84,49,9,58,604214
chr1,39416363,0.21,19,72,91,604215
chr1,39416517,0.89,75,9,84,604216
chr1,39416837,0.37,34,58,92,604217
chr1,39416868,0.27,31,82,113,604218
chr1,39416996,0.66,57,30,87,604219
chr1,39417004,0.63,46,27,73,604220
chr1,39417026,0.8,71,18,89,604221
chr1,39417028,0.88,76,10,86,604222
chr1,39417034,0.63,75,45,120,604223
chr1,39417056,0.52,98,92,190,604224
chr1,39417066,0.68,99,47,146,604225
chr1,39417118,0.45,85,105,190,604226
chr1,39417123,0.26,80,223,303,604227
chr1,39417127,0.26,83,234,317,604228
chr1,39417158,0.45,58,70,128,604229
chr1,39417168,0.34,56,108,164,604230
chr1,39417260,0.96,72,3,75,604231
chr1,39417264,0.91,71,7,78,604232
chr1,39417402,0.19,17,74,91,604233
chr1,39417428,0.31,23,51,74,604234
chr1,39417433,0.38,26,42,68,604235
chr1,39417471,0.71,40,16,56,604236
chr1,39417573,0.92,68,6,74,604237
chr1,39417577,0.95,59,3,62,604238
chr1,39417619,0.92,70,6,76,604239
chr1,39417636,0.98,62,1,63,604240
chr1,39417659,0.94,51,3,54,604241
chr1,39417661,1,53,0,53,604242
chr1,39417683,0.95,39,2,41,604243
chr1,39417691,0.98,44,1,45,604244
chr1,39417750,0.96,52,2,54,604245
chr1,39417772,0.54,63,53,116,604246
chr1,39417859,0.89,80,10,90,604247
chr1,39417926,0.94,65,4,69,604248
chr1,39417950,0.95,59,3,62,604249
chr1,39417990,0.96,76,3,79,604250
chr1,39418208,0.99,67,1,68,604251
chr1,39418263,0.99,66,1,67,604252
chr1,39418420,0.96,85,4,89,604253
chr1,39418545,0.92,46,4,50,604254
chr1,39418577,1,28,0,28,604255
chr1,39418687,0.94,78,5,83,604256
chr1,39418690,0.61,67,42,109,604257
chr1,39418932,0.21,19,70,89,604258
chr1,39419197,0.01,1,81,82,604259
chr1,39419345,0.14,9,55,64,604260
chr1,39419353,0.37,26,45,71,604261
chr1,39419484,0.45,43,52,95,604262
chr1,39419574,0.94,62,4,66,604263
chr1,39419585,0.9,61,7,68,604264
chr1,39419804,0.28,8,21,29,604265
chr1,39419820,0.7,23,10,33,604266
chr1,39419867,1,54,0,54,604267
chr1,39419898,1,38,0,38,604268
chr1,39419983,0.93,27,2,29,604269
chr1,39419993,0.65,30,16,46,604270
chr1,39420000,0.7,39,17,56,604271
chr1,39420023,0.98,52,1,53,604272
chr1,39420064,0.78,72,20,92,604273
chr1,39420226,0.97,70,2,72,604274
chr1,39420457,0.9,53,6,59,604275
chr1,39420776,0.62,26,16,42,604276
chr1,39420784,0.79,27,7,34,604277
chr1,39420814,0.93,38,3,41,604278
chr1,39420839,0.95,55,3,58,604279
chr1,39420846,0.95,60,3,63,604280
chr1,39420848,0.85,52,9,61,604281
chr1,39420854,0.89,57,7,64,604282
chr1,39420885,1,59,0,59,604283
chr1,39420891,1,56,0,56,604284
chr1,39420897,0.87,52,8,60,604285
chr1,39420944,0.92,24,2,26,604286
chr1,39420978,0.79,22,6,28,604287
chr1,39421032,0.9,55,6,61,604288
chr1,39421038,0.94,60,4,64,604289
chr1,39421079,0.85,75,13,88,604290
chr1,39421485,0.95,100,5,105,604291
chr1,39421487,0.95,100,5,105,604292
chr1,39421497,0.96,101,4,105,604293
chr1,39421557,0.88,90,12,102,604294
chr1,39421615,0.85,71,13,84,604295
chr1,39421640,0.92,72,6,78,604296
chr1,39421662,0.97,68,2,70,604297
chr1,39421702,0.88,43,6,49,604298
chr1,39421732,0.94,45,3,48,604299
chr1,39421949,0.54,30,26,56,604300
chr1,39422016,0.86,63,10,73,604301
chr1,39422028,0.71,59,24,83,604302
chr1,39422050,0.75,56,19,75,604303
chr1,39422060,0.84,58,11,69,604304
chr1,39422087,0.96,52,2,54,604305
chr1,39422095,0.96,48,2,50,604306
chr1,39422103,0.96,45,2,47,604307
chr1,39422169,0.6,32,21,53,604308
chr1,39422269,0,0,201,201,604309
chr1,39422305,0.73,43,16,59,604310
chr1,39422326,0.21,56,214,270,604311
chr1,39422351,0.23,63,209,272,604312
chr1,39422363,0.44,54,69,123,604313
chr1,39422375,0.31,51,114,165,604314
chr1,39422417,0.32,36,78,114,604315
chr1,39422487,0.9,44,5,49,604316
chr1,39422510,0.97,60,2,62,604317
chr1,39422542,0.94,76,5,81,604318
chr1,39422598,0.97,77,2,79,604319
chr1,39422646,0.96,75,3,78,604320
chr1,39422827,0.74,52,18,70,604321
chr1,39422836,0.38,52,84,136,604322
chr1,39422954,0.88,46,6,52,604323
chr1,39423055,0,0,115,115,604324
chr1,39423163,0.67,88,44,132,604325
chr1,39423269,0.41,92,130,222,604326
chr1,39423286,0.84,104,20,124,604327
chr1,39423351,0.84,103,20,123,604328
chr1,39423389,0.9,86,10,96,604329
chr1,39423392,0.86,92,15,107,604330
chr1,39423439,0.39,72,112,184,604331
chr1,39423450,0.5,57,58,115,604332
chr1,39423515,0.15,26,151,177,604333
chr1,39423579,0.96,47,2,49,604334
chr1,39423601,0.84,37,7,44,604335
chr1,39423617,0.74,35,12,47,604336
chr1,39423716,0.63,57,34,91,604337
chr1,39423988,0.96,94,4,98,604338
chr1,39424022,0.63,79,46,125,604339
chr1,39424148,0.38,48,78,126,604340
chr1,39424205,0.4,83,123,206,604341
chr1,39424222,0.37,85,146,231,604342
chr1,39424539,0.94,75,5,80,604343
chr1,39424733,0.98,50,1,51,604344
chr1,39424743,0.98,45,1,46,604345
chr1,39425097,0.93,70,5,75,604346
chr1,39425214,0.9,75,8,83,604347
chr1,39425321,0.97,61,2,63,604348
chr1,39425339,0.94,61,4,65,604349
chr1,39425396,0.98,87,2,89,604350
chr1,39425560,0.93,77,6,83,604351
chr1,39425585,0.93,78,6,84,604352
chr1,39425599,0.96,64,3,67,604353
chr1,39425603,0.94,59,4,63,604354
chr1,39425606,0.97,57,2,59,604355
chr1,39425615,0.93,52,4,56,604356
chr1,39425643,0.97,33,1,34,604357
chr1,39425648,0.91,29,3,32,604358
chr1,39425673,0.94,17,1,18,604359
chr1,39425704,0.93,37,3,40,604360
chr1,39425738,0.96,67,3,70,604361
chr1,39425746,0.97,70,2,72,604362
chr1,39425771,0.9,64,7,71,604363
chr1,39425794,0.95,62,3,65,604364
chr1,39425802,0.9,60,7,67,604365
chr1,39425809,1,54,0,54,604366
chr1,39425826,0.94,48,3,51,604367
chr1,39425832,0.98,45,1,46,604368
chr1,39425834,0.95,40,2,42,604369
chr1,39425842,0.95,39,2,41,604370
chr1,39425866,0.92,33,3,36,604371
chr1,39425945,0.89,42,5,47,604372
chr1,39425965,0.81,54,13,67,604373
chr1,39425973,0.84,58,11,69,604374
chr1,39426071,0.83,81,17,98,604375
chr1,39426144,0.83,72,15,87,604376
chr1,39426401,0.97,84,3,87,604377
chr1,39426603,0.96,55,2,57,604378
chr1,39426637,0.97,31,1,32,604379
chr1,39426965,0.86,65,11,76,604380
chr1,39426993,0.89,68,8,76,604381
chr1,39427021,0.9,55,6,61,604382
chr1,39427116,0.85,41,7,48,604383
chr1,39427120,0.95,42,2,44,604384
chr1,39427132,0.94,44,3,47,604385
chr1,39427174,0.64,42,24,66,604386
chr1,39427237,0.01,1,143,144,604387
chr1,39427609,0.83,67,14,81,604388
chr1,39427790,0.95,87,5,92,604389
chr1,39427845,0,0,182,182,604390
chr1,39427898,0.19,47,202,249,604391
chr1,39427903,0.42,38,52,90,604392
chr1,39428263,0.69,66,29,95,604393
chr1,39428356,0.57,74,55,129,604394
chr1,39428364,0.41,54,78,132,604395
chr1,39428396,0.43,71,96,167,604396
chr1,39428444,0.49,60,62,122,604397
chr1,39428486,0.98,78,2,80,604398
chr1,39428547,0.67,87,43,130,604399
chr1,39428836,0.92,54,5,59,604400
chr1,39428862,0.95,56,3,59,604401
chr1,39428868,0.84,54,10,64,604402
chr1,39428873,0.93,50,4,54,604403
chr1,39428959,0.92,67,6,73,604404
chr1,39428963,0.92,66,6,72,604405
chr1,39428973,0.94,65,4,69,604406
chr1,39429057,0.95,69,4,73,604407
chr1,39429059,0.94,68,4,72,604408
chr1,39429093,0.95,77,4,81,604409
chr1,39429107,0.67,46,23,69,604410
chr1,39429133,0.64,48,27,75,604411
chr1,39429151,0.83,70,14,84,604412
chr1,39429375,0.84,46,9,55,604413
chr1,39429397,0.89,63,8,71,604414
chr1,39429459,0.89,73,9,82,604415
chr1,39429860,0.65,52,28,80,604416
chr1,39429903,0.76,57,18,75,604417
chr1,39430159,0.68,32,15,47,604418
chr1,39430262,0.95,61,3,64,604419
chr1,39430354,0.95,58,3,61,604420
chr1,39430376,0.99,72,1,73,604421
chr1,39430384,0.95,79,4,83,604422
chr1,39430422,1,108,0,108,604423
chr1,39430444,0.88,95,13,108,604424
chr1,39430480,0.95,95,5,100,604425
chr1,39430507,0.89,73,9,82,604426
chr1,39430523,0.93,70,5,75,604427
chr1,39430538,0.97,69,2,71,604428
chr1,39430561,0.92,61,5,66,604429
chr1,39430570,0.92,58,5,63,604430
chr1,39430598,0.95,70,4,74,604431
chr1,39430614,0.83,65,13,78,604432
chr1,39430741,0.95,71,4,75,604433
chr1,39430744,0.92,66,6,72,604434
chr1,39430748,0.98,64,1,65,604435
chr1,39430750,0.95,62,3,65,604436
chr1,39430788,0.91,31,3,34,604437
chr1,39430793,1,33,0,33,604438
chr1,39430804,1,24,0,24,604439
chr1,39430878,0.93,28,2,30,604440
chr1,39430890,0.91,30,3,33,604441
chr1,39430938,0.89,47,6,53,604442
chr1,39430946,0.77,48,14,62,604443
chr1,39430970,0.81,47,11,58,604444
chr1,39431008,0.69,47,21,68,604445
chr1,39431016,0.98,64,1,65,604446
chr1,39431144,0.92,93,8,101,604447
chr1,39431389,0.73,55,20,75,604448
chr1,39431573,0.44,35,45,80,604449
chr1,39431609,0.97,90,3,93,604450
chr1,39431613,0.94,81,5,86,604451
chr1,39431659,0.98,79,2,81,604452
chr1,39431662,0.95,72,4,76,604453
chr1,39431699,0.96,47,2,49,604454
chr1,39431712,0.8,36,9,45,604455
chr1,39431730,1,34,0,34,604456
chr1,39431744,0.95,41,2,43,604457
chr1,39431751,1,38,0,38,604458
chr1,39431895,0.88,73,10,83,604459
chr1,39432150,0.91,61,6,67,604460
chr1,39432171,1,78,0,78,604461
chr1,39432201,0.91,78,8,86,604462
chr1,39432301,0.98,43,1,44,604463
chr1,39432306,0.95,38,2,40,604464
chr1,39432350,0.95,39,2,41,604465
chr1,39432465,0.98,47,1,48,604466
chr1,39432470,0.98,39,1,40,604467
chr1,39432474,0.32,27,57,84,604468
chr1,39432555,0.93,25,2,27,604469
chr1,39432613,0.5,30,30,60,604470
chr1,39432686,0.16,19,102,121,604471
chr1,39432885,0.99,76,1,77,604472
chr1,39432897,1,77,0,77,604473
chr1,39432979,0.94,49,3,52,604474
chr1,39433012,1,42,0,42,604475
chr1,39433730,0.72,71,28,99,604476
chr1,39433762,0.85,60,11,71,604477
chr1,39433794,0.98,42,1,43,604478
chr1,39433798,0.9,35,4,39,604479
chr1,39433856,0.97,34,1,35,604480
chr1,39433888,0.98,39,1,40,604481
chr1,39434040,0.81,50,12,62,604482
chr1,39434074,0.97,65,2,67,604483
chr1,39434224,1,70,0,70,604484
chr1,39434252,0.45,29,36,65,604485
chr1,39434262,0.93,64,5,69,604486
chr1,39434268,0.93,57,4,61,604487
chr1,39434620,0.89,85,10,95,604488
chr1,39434634,0.84,76,15,91,604489
chr1,39434717,0.93,99,8,107,604490
chr1,39434917,0.57,44,33,77,604491
chr1,39434949,0.34,18,35,53,604492
chr1,39434979,0.38,20,32,52,604493
chr1,39435273,0.87,90,14,104,604494
chr1,39435284,0.97,102,3,105,604495
chr1,39435356,0.74,99,35,134,604496
chr1,39435433,0.97,132,4,136,604497
chr1,39435567,0.9,84,9,93,604498
chr1,39435605,0.94,91,6,97,604499
chr1,39435630,0.98,105,2,107,604500
chr1,39435669,0.91,88,9,97,604501
chr1,39435789,0.91,41,4,45,604502
chr1,39435798,0.88,38,5,43,604503
chr1,39435838,0.98,61,1,62,604504
chr1,39436333,0.95,36,2,38,604505
chr1,39436364,0.97,59,2,61,604506
chr1,39436389,0.97,67,2,69,604507
chr1,39436406,0.95,75,4,79,604508
chr1,39436420,1,70,0,70,604509
chr1,39436498,0.44,31,39,70,604510
chr1,39436529,0.92,44,4,48,604511
chr1,39436551,0.98,39,1,40,604512
chr1,39436556,1,56,0,56,604513
chr1,39436589,0.96,64,3,67,604514
chr1,39436605,0.94,67,4,71,604515
chr1,39436630,0.89,79,10,89,604516
chr1,39436737,0.98,83,2,85,604517
chr1,39436866,1,20,0,20,604518
chr1,39436874,0.86,19,3,22,604519
chr1,39436906,0.95,37,2,39,604520
chr1,39436950,0.42,24,33,57,604521
chr1,39436962,0.95,58,3,61,604522
chr1,39436996,0.86,49,8,57,604523
chr1,39437101,0.9,57,6,63,604524
chr1,39437173,0.98,60,1,61,604525
chr1,39437185,0.98,56,1,57,604526
chr1,39437218,0.96,48,2,50,604527
chr1,39437308,0.98,98,2,100,604528
chr1,39437318,0.86,94,15,109,604529
chr1,39437362,0.96,103,4,107,604530
chr1,39437434,0.97,32,1,33,604531
chr1,39437491,1,19,0,19,604532
chr1,39437495,0.83,15,3,18,604533
chr1,39437497,1,19,0,19,604534
chr1,39437535,0.94,30,2,32,604535
chr1,39437540,0.87,34,5,39,604536
chr1,39437565,0.96,43,2,45,604537
chr1,39437585,0.91,52,5,57,604538
chr1,39437596,0.9,62,7,69,604539
chr1,39437636,0.95,56,3,59,604540
chr1,39437640,0.98,52,1,53,604541
chr1,39437660,0.89,39,5,44,604542
chr1,39437692,1,39,0,39,604543
chr1,39437716,0.89,32,4,36,604544
chr1,39437754,1,37,0,37,604545
chr1,39437762,0.81,29,7,36,604546
chr1,39437955,0.61,45,29,74,604547
chr1,39438098,0.54,42,36,78,604548
chr1,39438180,0.97,35,1,36,604549
chr1,39438210,0.96,53,2,55,604550
chr1,39438219,0.96,55,2,57,604551
chr1,39438260,0.58,38,27,65,604552
chr1,39438304,0.96,68,3,71,604553
chr1,39438336,0.93,68,5,73,604554
chr1,39438374,0.99,77,1,78,604555
chr1,39438391,0.93,75,6,81,604556
chr1,39438515,0.89,58,7,65,604557
chr1,39438564,0.95,72,4,76,604558
chr1,39438752,0.89,73,9,82,604559
chr1,39438909,0.95,62,3,65,604560
chr1,39439008,0.65,26,14,40,604561
chr1,39439094,0.97,58,2,60,604562
chr1,39439132,0.86,56,9,65,604563
chr1,39439164,0.88,53,7,60,604564
chr1,39439235,0.67,36,18,54,604565
chr1,39439290,0.96,24,1,25,604566
chr1,39439313,0.69,9,4,13,604567
chr1,39439345,0.88,7,1,8,604568
chr1,39439440,0.04,3,71,74,604569
chr1,39439446,0.07,5,68,73,604570
chr1,39439546,0.04,2,47,49,604571
chr1,39439558,0.06,3,44,47,604572
chr1,39439563,0.09,4,41,45,604573
chr1,39439572,0.09,4,43,47,604574
chr1,39439774,0.68,54,25,79,604575
chr1,39439875,0.45,33,40,73,604576
chr1,39439886,0.29,22,55,77,604577
chr1,39439894,0.2,14,57,71,604578
chr1,39439917,0.49,32,33,65,604579
chr1,39439985,0.32,22,46,68,604580
chr1,39440307,0.71,34,14,48,604581
chr1,39440379,0.99,79,1,80,604582
chr1,39440425,0.98,79,2,81,604583
chr1,39440465,0.94,83,5,88,604584
chr1,39440528,0.94,74,5,79,604585
chr1,39440556,0.95,70,4,74,604586
chr1,39440568,0.97,66,2,68,604587
chr1,39440788,0.95,52,3,55,604588
chr1,39440813,1,65,0,65,604589
chr1,39440872,0.98,80,2,82,604590
chr1,39440947,0.9,47,5,52,604591
chr1,39441017,0.98,78,2,80,604592
chr1,39441359,0.92,90,8,98,604593
chr1,39441389,0.98,95,2,97,604594
chr1,39441393,0.88,84,12,96,604595
chr1,39441480,0.98,50,1,51,604596
chr1,39441509,0.94,61,4,65,604597
chr1,39441513,0.94,61,4,65,604598
chr1,39441756,0.96,78,3,81,604599
chr1,39441766,0.99,84,1,85,604600
chr1,39441794,0.98,86,2,88,604601
chr1,39441840,1,68,0,68,604602
chr1,39441988,0.98,58,1,59,604603
chr1,39442026,0.94,61,4,65,604604
chr1,39442034,0.93,64,5,69,604605
chr1,39442127,0.82,69,15,84,604606
chr1,39442465,0.61,38,24,62,604607
chr1,39442559,0.82,70,15,85,604608
chr1,39442619,0.59,61,43,104,604609
chr1,39442643,0.74,77,27,104,604610
chr1,39442772,0.93,57,4,61,604611
chr1,39442839,0.9,46,5,51,604612
chr1,39442871,0.96,51,2,53,604613
chr1,39442879,0.81,47,11,58,604614
chr1,39442904,0.98,54,1,55,604615
chr1,39442927,0.92,60,5,65,604616
chr1,39442966,0.96,66,3,69,604617
chr1,39442988,0.97,63,2,65,604618
chr1,39442998,1,65,0,65,604619
chr1,39443075,0.74,37,13,50,604620
chr1,39443248,0.91,72,7,79,604621
chr1,39443289,0.77,41,12,53,604622
chr1,39443382,0.9,28,3,31,604623
chr1,39443432,0.94,58,4,62,604624
chr1,39443466,0.95,77,4,81,604625
chr1,39443485,0.95,84,4,88,604626
chr1,39443533,0.94,90,6,96,604627
chr1,39443645,0.96,43,2,45,604628
chr1,39443656,1,49,0,49,604629
chr1,39443757,0.77,59,18,77,604630
chr1,39443837,1,54,0,54,604631
chr1,39443950,0.6,29,19,48,604632
chr1,39444027,0.97,58,2,60,604633
chr1,39444034,0.98,61,1,62,604634
chr1,39444131,0.99,104,1,105,604635
chr1,39444139,0.98,103,2,105,604636
chr1,39444213,0.95,35,2,37,604637
chr1,39444261,0.95,42,2,44,604638
chr1,39444282,0.9,53,6,59,604639
chr1,39444291,0.85,53,9,62,604640
chr1,39444359,0.98,53,1,54,604641
chr1,39444389,0.98,56,1,57,604642
chr1,39444497,0.85,22,4,26,604643
chr1,39444608,0.93,26,2,28,604644
chr1,39444616,0.97,30,1,31,604645
chr1,39444654,0.84,43,8,51,604646
chr1,39444678,0.86,56,9,65,604647
chr1,39444686,0.96,65,3,68,604648
chr1,39444710,0.82,50,11,61,604649
chr1,39444730,0.98,55,1,56,604650
chr1,39444742,0.98,48,1,49,604651
chr1,39444746,0.96,45,2,47,604652
chr1,39444786,0.97,29,1,30,604653
chr1,39444806,0.86,38,6,44,604654
chr1,39444827,0.86,44,7,51,604655
chr1,39444836,0.9,47,5,52,604656
chr1,39444864,0.92,59,5,64,604657
chr1,39444876,0.97,74,2,76,604658
chr1,39444994,0.58,45,32,77,604659
chr1,39445041,0.7,49,21,70,604660
chr1,39445133,0.63,43,25,68,604661
chr1,39445458,0.86,50,8,58,604662
chr1,39445683,0.86,77,13,90,604663
chr1,39445782,0.9,65,7,72,604664
chr1,39445811,0.91,69,7,76,604665
chr1,39445823,0.97,63,2,65,604666
chr1,39445827,0.95,57,3,60,604667
chr1,39445847,0.81,51,12,63,604668
chr1,39445886,0.98,56,1,57,604669
chr1,39445903,0.93,53,4,57,604670
chr1,39445942,0.93,52,4,56,604671
chr1,39446105,0.98,39,1,40,604672
chr1,39446220,0.56,40,31,71,604673
chr1,39446224,0.98,78,2,80,604674
chr1,39446276,0.9,61,7,68,604675
chr1,39446321,0.95,69,4,73,604676
chr1,39446641,0.94,62,4,66,604677
chr1,39446718,0.95,83,4,87,604678
chr1,39446759,0.97,85,3,88,604679
chr1,39446768,0.85,78,14,92,604680
chr1,39446954,0.79,53,14,67,604681
chr1,39446967,0.94,66,4,70,604682
chr1,39446998,0.96,73,3,76,604683
chr1,39447023,1,82,0,82,604684
chr1,39447036,0.93,77,6,83,604685
chr1,39447080,0.98,62,1,63,604686
chr1,39447084,0.98,61,1,62,604687
chr1,39447135,0.41,34,48,82,604688
chr1,39447173,0.96,69,3,72,604689
chr1,39447215,0.82,49,11,60,604690
chr1,39447231,0.86,50,8,58,604691
chr1,39447516,0.86,60,10,70,604692
chr1,39447546,0.51,38,37,75,604693
chr1,39447563,0.96,53,2,55,604694
chr1,39447570,0.91,49,5,54,604695
chr1,39447602,0.79,42,11,53,604696
chr1,39447638,0.91,51,5,56,604697
chr1,39447664,0.93,69,5,74,604698
chr1,39447698,0.82,50,11,61,604699
chr1,39447712,0.85,56,10,66,604700
chr1,39447719,0.97,57,2,59,604701
chr1,39447766,0.93,57,4,61,604702
chr1,39447768,0.97,62,2,64,604703
chr1,39447776,0.97,70,2,72,604704
chr1,39447841,0.69,59,26,85,604705
chr1,39448124,0.77,99,30,129,604706
chr1,39448140,0.73,96,36,132,604707
chr1,39448311,0.55,71,58,129,604708
chr1,39448543,0.98,50,1,51,604709
chr1,39448585,1,38,0,38,604710
chr1,39448617,0.9,35,4,39,604711
chr1,39448734,0.98,44,1,45,604712
chr1,39448768,1,23,0,23,604713
chr1,39448776,1,21,0,21,604714
chr1,39448806,0.87,20,3,23,604715
chr1,39448821,0.9,18,2,20,604716
chr1,39448877,0.85,40,7,47,604717
chr1,39448887,0.93,54,4,58,604718
chr1,39448915,0.95,69,4,73,604719
chr1,39449022,0.74,70,24,94,604720
chr1,39449084,0.93,93,7,100,604721
chr1,39449104,0.98,91,2,93,604722
chr1,39449128,0.91,86,9,95,604723
chr1,39449189,0.91,92,9,101,604724
chr1,39449537,0.83,63,13,76,604725
chr1,39449567,0.91,79,8,87,604726
chr1,39449598,0.99,82,1,83,604727
chr1,39449619,0.96,69,3,72,604728
chr1,39449663,0.92,55,5,60,604729
chr1,39449712,0.98,42,1,43,604730
chr1,39449717,1,42,0,42,604731
chr1,39449764,0.91,42,4,46,604732
chr1,39449925,0.92,22,2,24,604733
chr1,39449933,1,34,0,34,604734
chr1,39449941,0.95,37,2,39,604735
chr1,39449944,0.87,39,6,45,604736
chr1,39449971,0.98,57,1,58,604737
chr1,39449995,1,62,0,62,604738
chr1,39450003,1,65,0,65,604739
chr1,39450047,1,56,0,56,604740
chr1,39450051,0.97,61,2,63,604741
chr1,39450107,0.91,51,5,56,604742
chr1,39450127,0.93,51,4,55,604743
chr1,39450148,0.98,40,1,41,604744
chr1,39450152,0.95,40,2,42,604745
chr1,39450195,0.87,26,4,30,604746
chr1,39450201,1,23,0,23,604747
chr1,39450269,0.96,52,2,54,604748
chr1,39450275,0.98,60,1,61,604749
chr1,39450283,0.98,64,1,65,604750
chr1,39450299,1,76,0,76,604751
chr1,39450309,0.99,74,1,75,604752
chr1,39450323,1,75,0,75,604753
chr1,39450393,0.96,67,3,70,604754
chr1,39450455,0.89,49,6,55,604755
chr1,39450656,0.99,66,1,67,604756
chr1,39450664,0.97,57,2,59,604757
chr1,39450686,0.96,52,2,54,604758
chr1,39450711,1,54,0,54,604759
chr1,39450728,0.94,48,3,51,604760
chr1,39450770,0.98,63,1,64,604761
chr1,39450786,0.96,68,3,71,604762
chr1,39450878,0.95,55,3,58,604763
chr1,39451192,0.39,38,60,98,604764
chr1,39451247,0.55,61,49,110,604765
chr1,39451249,0.69,78,35,113,604766
chr1,39451280,0.76,75,24,99,604767
chr1,39451509,0.96,97,4,101,604768
chr1,39451556,0.49,40,41,81,604769
chr1,39451857,0.85,46,8,54,604770
chr1,39451869,0.86,44,7,51,604771
chr1,39452056,0.55,54,45,99,604772
chr1,39452128,0.94,110,7,117,604773
chr1,39452136,0.75,95,32,127,604774
chr1,39452153,0.72,83,33,116,604775
chr1,39452585,0.51,35,33,68,604776
chr1,39452767,0.64,39,22,61,604777
chr1,39452819,0.52,45,41,86,604778
chr1,39453245,1,37,0,37,604779
chr1,39453387,0.97,58,2,60,604780
chr1,39453488,0.99,80,1,81,604781
chr1,39453578,0.95,74,4,78,604782
chr1,39453621,0.97,61,2,63,604783
chr1,39453632,0.95,57,3,60,604784
chr1,39453646,1,60,0,60,604785
chr1,39453723,0.96,69,3,72,604786
chr1,39453777,0.96,68,3,71,604787
chr1,39453809,0.96,74,3,77,604788
chr1,39453831,0.97,72,2,74,604789
chr1,39453839,1,76,0,76,604790
chr1,39453907,0.81,57,13,70,604791
chr1,39454038,0.96,49,2,51,604792
chr1,39454044,0.94,48,3,51,604793
chr1,39454054,0.96,48,2,50,604794
chr1,39454091,0.98,51,1,52,604795
chr1,39454114,1,55,0,55,604796
chr1,39454176,1,73,0,73,604797
chr1,39454184,0.97,68,2,70,604798
chr1,39454238,0.86,62,10,72,604799
chr1,39454245,0.99,68,1,69,604800
chr1,39454247,0.97,64,2,66,604801
chr1,39454607,0.92,73,6,79,604802
chr1,39454623,0.95,72,4,76,604803
chr1,39454651,0.92,59,5,64,604804
chr1,39454656,1,59,0,59,604805
chr1,39454660,0.98,45,1,46,604806
chr1,39454697,0.96,55,2,57,604807
chr1,39454707,0.93,56,4,60,604808
chr1,39454751,0.96,72,3,75,604809
chr1,39454803,0.87,66,10,76,604810
chr1,39454810,0.99,73,1,74,604811
chr1,39454896,0.7,66,28,94,604812
chr1,39455264,0.96,99,4,103,604813
chr1,39455328,0.95,78,4,82,604814
chr1,39455418,0.93,37,3,40,604815
chr1,39455423,0.94,46,3,49,604816
chr1,39455450,0.93,55,4,59,604817
chr1,39455460,1,67,0,67,604818
chr1,39455470,0.97,72,2,74,604819
chr1,39455728,0.45,41,50,91,604820
chr1,39455936,0.57,55,42,97,604821
chr1,39456076,0.8,47,12,59,604822
chr1,39456103,0.16,10,52,62,604823
chr1,39456105,0.51,35,34,69,604824
chr1,39456295,0.01,1,82,83,604825
chr1,39456332,0.02,1,61,62,604826
chr1,39456418,0.16,7,37,44,604827
chr1,39456490,0,0,77,77,604828
chr1,39456525,0.01,1,77,78,604829
chr1,39456578,0,0,56,56,604830
chr1,39456656,0,0,22,22,604831
chr1,39456660,0,0,37,37,604832
chr1,39456662,0.03,1,32,33,604833
chr1,39456667,0,0,38,38,604834
chr1,39456675,0,0,36,36,604835
chr1,39456695,0.03,1,30,31,604836
chr1,39456699,0,0,20,20,604837
chr1,39456701,0,0,22,22,604838
chr1,39456715,0,0,23,23,604839
chr1,39456741,0,0,13,13,604840
chr1,39456765,0,0,17,17,604841
chr1,39456784,0,0,17,17,604842
chr1,39456791,0,0,15,15,604843
chr1,39456800,0,0,27,27,604844
chr1,39456823,0.14,1,6,7,604845
chr1,39456828,0,0,34,34,604846
chr1,39456833,0,0,34,34,604847
chr1,39456838,0.03,1,35,36,604848
chr1,39456854,0,0,36,36,604849
chr1,39456872,0,0,36,36,604850
chr1,39456890,0,0,36,36,604851
chr1,39456894,0,0,27,27,604852
chr1,39456904,0,0,24,24,604853
chr1,39456908,0,0,36,36,604854
chr1,39456913,0,0,35,35,604855
chr1,39456925,0,0,34,34,604856
chr1,39456934,0,0,32,32,604857
chr1,39456937,0,0,44,44,604858
chr1,39456943,0,0,50,50,604859
chr1,39456956,0,0,32,32,604860
chr1,39456968,0,0,52,52,604861
chr1,39456980,0,0,42,42,604862
chr1,39456986,0,0,46,46,604863
chr1,39457007,0,0,45,45,604864
chr1,39457016,0,0,41,41,604865
chr1,39457019,0,0,47,47,604866
chr1,39457021,0,0,41,41,604867
chr1,39457025,0,0,35,35,604868
chr1,39457031,0,0,48,48,604869
chr1,39457049,0,0,45,45,604870
chr1,39457057,0,0,40,40,604871
chr1,39457061,0,0,42,42,604872
chr1,39457066,0,0,31,31,604873
chr1,39457069,0,0,45,45,604874
chr1,39457077,0.02,1,41,42,604875
chr1,39457091,0,0,51,51,604876
chr1,39457096,0,0,40,40,604877
chr1,39457099,0,0,36,36,604878
chr1,39457112,0,0,45,45,604879
chr1,39457120,0,0,51,51,604880
chr1,39457125,0.02,1,44,45,604881
chr1,39457128,0.03,1,39,40,604882
chr1,39457131,0,0,28,28,604883
chr1,39457136,0,0,26,26,604884
chr1,39457148,0.02,1,44,45,604885
chr1,39457159,0.02,1,51,52,604886
chr1,39457174,0,0,45,45,604887
chr1,39457178,0,0,31,31,604888
chr1,39457181,0,0,42,42,604889
chr1,39457186,0.04,1,26,27,604890
chr1,39457189,0.04,1,26,27,604891
chr1,39457192,0,0,33,33,604892
chr1,39457195,0.04,2,44,46,604893
chr1,39457204,0,0,37,37,604894
chr1,39457216,0,0,42,42,604895
chr1,39457235,0,0,29,29,604896
chr1,39457240,0,0,38,38,604897
chr1,39457244,0,0,48,48,604898
chr1,39457250,0,0,43,43,604899
chr1,39457254,0,0,38,38,604900
chr1,39457257,0,0,22,22,604901
chr1,39457270,0,0,49,49,604902
chr1,39457411,0,0,48,48,604903
chr1,39457430,0,0,50,50,604904
chr1,39457447,0,0,51,51,604905
chr1,39457473,0.02,1,45,46,604906
chr1,39457546,0,0,27,27,604907
chr1,39457551,0,0,36,36,604908
chr1,39457565,0,0,33,33,604909
chr1,39457586,0,0,30,30,604910
chr1,39457593,0,0,27,27,604911
chr1,39457604,0.06,2,31,33,604912
chr1,39457653,0,0,57,57,604913
chr1,39457671,0,0,26,26,604914
chr1,39457688,0,0,20,20,604915
chr1,39457696,0.02,1,50,51,604916
chr1,39457706,0.05,1,18,19,604917
chr1,39457708,0.03,1,31,32,604918
chr1,39457714,0,0,40,40,604919
chr1,39457773,0,0,64,64,604920
chr1,39457776,0,0,70,70,604921
chr1,39457787,0,0,76,76,604922
chr1,39457794,0,0,86,86,604923
chr1,39457829,0,0,86,86,604924
chr1,39457856,0.01,1,81,82,604925
chr1,39457878,0,0,83,83,604926
chr1,39457911,0,0,80,80,604927
chr1,39457918,0.02,2,84,86,604928
chr1,39457978,0.02,1,65,66,604929
chr1,39458008,0,0,75,75,604930
chr1,39458030,0,0,65,65,604931
chr1,39458071,0,0,51,51,604932
chr1,39458088,0,0,51,51,604933
chr1,39458103,0,0,30,30,604934
chr1,39458129,0,0,54,54,604935
chr1,39458183,0.02,1,64,65,604936
chr1,39458255,0.01,1,66,67,604937
chr1,39458343,0.06,7,109,116,604938
chr1,39458462,0.38,36,59,95,604939
chr1,39458562,0.09,10,103,113,604940
chr1,39458583,0.32,39,83,122,604941
chr1,39458666,0.42,36,49,85,604942
chr1,39458780,0.92,85,7,92,604943
chr1,39458924,0.95,78,4,82,604944
chr1,39458946,0.97,76,2,78,604945
chr1,39458978,0.83,67,14,81,604946
chr1,39459008,0.89,64,8,72,604947
chr1,39459059,0.93,76,6,82,604948
chr1,39459063,0.96,66,3,69,604949
chr1,39459085,0.94,73,5,78,604950
chr1,39459087,0.95,72,4,76,604951
chr1,39459108,0.95,69,4,73,604952
chr1,39459116,0.96,67,3,70,604953
chr1,39459217,0.86,50,8,58,604954
chr1,39459227,0.97,56,2,58,604955
chr1,39459250,1,53,0,53,604956
chr1,39459267,0.98,44,1,45,604957
chr1,39459290,1,26,0,26,604958
chr1,39459336,0.97,29,1,30,604959
chr1,39459408,0.97,72,2,74,604960
chr1,39459464,0.97,73,2,75,604961
chr1,39459468,0.97,69,2,71,604962
chr1,39459507,0.95,57,3,60,604963
chr1,39459513,0.98,61,1,62,604964
chr1,39459517,0.9,46,5,51,604965
chr1,39459532,0.9,43,5,48,604966
chr1,39459634,0.96,67,3,70,604967
chr1,39459656,0.94,68,4,72,604968
chr1,39459673,0.97,66,2,68,604969
chr1,39459682,0.97,69,2,71,604970
chr1,39459690,0.96,64,3,67,604971
chr1,39459697,0.94,63,4,67,604972
chr1,39459791,0.86,83,13,96,604973
chr1,39460080,0.87,103,15,118,604974
chr1,39460099,0.71,82,33,115,604975
chr1,39460240,0.91,63,6,69,604976
chr1,39460260,0.98,78,2,80,604977
chr1,39460263,0.87,68,10,78,604978
chr1,39460280,0.97,74,2,76,604979
chr1,39460334,0.67,32,16,48,604980
chr1,39460338,0.7,28,12,40,604981
chr1,39460386,0.4,18,27,45,604982
chr1,39460391,0.92,44,4,48,604983
chr1,39460430,0.65,40,22,62,604984
chr1,39460464,0.93,67,5,72,604985
chr1,39460491,0.94,77,5,82,604986
chr1,39460506,0.97,84,3,87,604987
chr1,39460604,1,76,0,76,604988
chr1,39460657,0.93,77,6,83,604989
chr1,39460749,0.99,73,1,74,604990
chr1,39460754,0.99,80,1,81,604991
chr1,39460790,0.97,88,3,91,604992
chr1,39460837,0.96,87,4,91,604993
chr1,39460852,0.86,80,13,93,604994
chr1,39461048,0.93,88,7,95,604995
chr1,39461213,0.92,73,6,79,604996
chr1,39461328,0.95,105,6,111,604997
chr1,39461432,0.98,63,1,64,604998
chr1,39461442,1,62,0,62,604999
chr1,39461470,0.94,50,3,53,605000
chr1,39461475,1,51,0,51,605001
chr1,39461479,1,38,0,38,605002
chr1,39461574,0.99,66,1,67,605003
chr1,39461684,0.96,50,2,52,605004
chr1,39461835,1,60,0,60,605005
chr1,39461913,0.92,72,6,78,605006
chr1,39461961,0.97,75,2,77,605007
chr1,39461984,0.97,77,2,79,605008
chr1,39462037,0.98,79,2,81,605009
chr1,39462086,0.83,39,8,47,605010
chr1,39462142,0.98,55,1,56,605011
chr1,39462270,0.79,53,14,67,605012
chr1,39462295,0.9,69,8,77,605013
chr1,39462348,0.8,70,17,87,605014
chr1,39462358,0.81,76,18,94,605015
chr1,39462391,0.41,37,54,91,605016
chr1,39462422,0.89,76,9,85,605017
chr1,39463114,0.33,25,51,76,605018
chr1,39463224,0.11,8,62,70,605019
chr1,39463276,0.86,44,7,51,605020
chr1,39463438,0.8,69,17,86,605021
chr1,39463672,0.15,15,88,103,605022
chr1,39463681,0.1,10,91,101,605023
chr1,39463699,0.86,81,13,94,605024
chr1,39463878,0.79,63,17,80,605025
chr1,39463936,0.85,60,11,71,605026
chr1,39464010,0.97,73,2,75,605027
chr1,39464086,0.81,64,15,79,605028
chr1,39464297,0.94,62,4,66,605029
chr1,39464350,0.95,60,3,63,605030
chr1,39464379,0.97,67,2,69,605031
chr1,39464448,0.91,81,8,89,605032
chr1,39464470,0.79,64,17,81,605033
chr1,39464648,0.94,101,6,107,605034
chr1,39464976,0.94,93,6,99,605035
chr1,39465593,0.98,56,1,57,605036
chr1,39465615,0.96,49,2,51,605037
chr1,39465679,0.92,65,6,71,605038
chr1,39465699,0.99,67,1,68,605039
chr1,39465744,0.95,42,2,44,605040
chr1,39465764,0.93,42,3,45,605041
chr1,39465775,0.98,48,1,49,605042
chr1,39465802,0.73,49,18,67,605043
chr1,39465834,0.9,77,9,86,605044
chr1,39466040,0.79,27,7,34,605045
chr1,39466059,0.88,46,6,52,605046
chr1,39466088,0.97,65,2,67,605047
chr1,39466105,0.96,80,3,83,605048
chr1,39466122,0.93,82,6,88,605049
chr1,39466176,0.89,77,10,87,605050
chr1,39466241,0.95,74,4,78,605051
chr1,39466264,0.97,73,2,75,605052
chr1,39466273,0.95,69,4,73,605053
chr1,39466312,0.97,64,2,66,605054
chr1,39466316,0.97,62,2,64,605055
chr1,39466353,0.83,40,8,48,605056
chr1,39466411,0.98,96,2,98,605057
chr1,39466421,0.97,107,3,110,605058
chr1,39466453,0.93,98,7,105,605059
chr1,39466485,0.95,93,5,98,605060
chr1,39466529,0.77,56,17,73,605061
chr1,39466561,1,62,0,62,605062
chr1,39466608,0.93,67,5,72,605063
chr1,39466685,0.91,74,7,81,605064
chr1,39466709,0.98,83,2,85,605065
chr1,39466739,0.83,74,15,89,605066
chr1,39466894,1,58,0,58,605067
chr1,39467021,0.98,56,1,57,605068
chr1,39467038,0.8,53,13,66,605069
chr1,39467084,0.99,66,1,67,605070
chr1,39467180,1,66,0,66,605071
chr1,39467217,0.88,61,8,69,605072
chr1,39467227,0.54,35,30,65,605073
chr1,39467229,0.98,61,1,62,605074
chr1,39467589,0.94,49,3,52,605075
chr1,39467994,0.82,51,11,62,605076
chr1,39468124,0.98,58,1,59,605077
chr1,39468128,0.95,54,3,57,605078
chr1,39468140,0.96,55,2,57,605079
chr1,39468168,0.98,53,1,54,605080
chr1,39468173,0.98,51,1,52,605081
chr1,39468198,0.93,39,3,42,605082
chr1,39468218,0.95,40,2,42,605083
chr1,39468229,0.88,37,5,42,605084
chr1,39468258,0.96,47,2,49,605085
chr1,39468294,0.95,54,3,57,605086
chr1,39468318,0.98,58,1,59,605087
chr1,39468325,0.98,62,1,63,605088
chr1,39468358,0.97,37,1,38,605089
chr1,39468758,0.42,33,45,78,605090
chr1,39468957,0.73,56,21,77,605091
chr1,39469063,0.86,67,11,78,605092
chr1,39469066,0.94,75,5,80,605093
chr1,39469613,0.78,69,20,89,605094
chr1,39469845,0.65,72,38,110,605095
chr1,39469881,0.96,101,4,105,605096
chr1,39470058,0.96,128,6,134,605097
chr1,39470164,0.84,102,19,121,605098
chr1,39470305,0.87,94,14,108,605099
chr1,39470347,0.97,83,3,86,605100
chr1,39470357,0.95,80,4,84,605101
chr1,39470377,0.75,57,19,76,605102
chr1,39470406,0.88,61,8,69,605103
chr1,39470489,0.98,59,1,60,605104
chr1,39470631,0.85,44,8,52,605105
chr1,39470703,0.87,34,5,39,605106
chr1,39470715,0.91,42,4,46,605107
chr1,39470743,0.98,46,1,47,605108
chr1,39470752,0.9,53,6,59,605109
chr1,39470775,0.98,58,1,59,605110
chr1,39470836,0.88,66,9,75,605111
chr1,39470840,0.92,70,6,76,605112
chr1,39470852,0.88,59,8,67,605113
chr1,39470914,0.99,78,1,79,605114
chr1,39470966,0.67,34,17,51,605115
chr1,39470974,0.78,35,10,45,605116
chr1,39471018,0.75,52,17,69,605117
chr1,39471088,0.89,88,11,99,605118
chr1,39471094,0.92,92,8,100,605119
chr1,39471430,0.95,87,5,92,605120
chr1,39472053,0.98,56,1,57,605121
chr1,39472357,0.86,74,12,86,605122
chr1,39472373,0.84,73,14,87,605123
chr1,39472607,0.95,62,3,65,605124
chr1,39472614,0.98,59,1,60,605125
chr1,39472618,0.93,52,4,56,605126
chr1,39472662,0.55,36,29,65,605127
chr1,39472738,0.8,39,10,49,605128
chr1,39472746,0.9,43,5,48,605129
chr1,39472750,0.95,38,2,40,605130
chr1,39472783,0.94,46,3,49,605131
chr1,39472810,0.98,61,1,62,605132
chr1,39472827,0.85,55,10,65,605133
chr1,39472971,0.97,87,3,90,605134
chr1,39473078,0.92,102,9,111,605135
chr1,39473215,0.88,75,10,85,605136
chr1,39473664,0.91,77,8,85,605137
chr1,39473702,0.98,61,1,62,605138
chr1,39473707,0.93,56,4,60,605139
chr1,39473792,0.9,69,8,77,605140
chr1,39473796,0.9,69,8,77,605141
chr1,39473884,0.89,49,6,55,605142
chr1,39474488,0.95,58,3,61,605143
chr1,39474586,0.93,67,5,72,605144
chr1,39474603,0.98,84,2,86,605145
chr1,39474610,0.94,84,5,89,605146
chr1,39474674,0.99,79,1,80,605147
chr1,39474705,0.9,60,7,67,605148
chr1,39474750,0.99,68,1,69,605149
chr1,39474761,0.97,67,2,69,605150
chr1,39474804,1,60,0,60,605151
chr1,39474912,0.95,41,2,43,605152
chr1,39475003,0.95,62,3,65,605153
chr1,39475019,0.97,74,2,76,605154
chr1,39475028,0.99,80,1,81,605155
chr1,39475031,0.98,81,2,83,605156
chr1,39475084,0.97,70,2,72,605157
chr1,39475088,0.97,69,2,71,605158
chr1,39475096,0.99,75,1,76,605159
chr1,39475170,0.94,66,4,70,605160
chr1,39475181,0.97,76,2,78,605161
chr1,39475214,0.89,73,9,82,605162
chr1,39475224,0.98,82,2,84,605163
chr1,39475226,1,84,0,84,605164
chr1,39475292,0.97,65,2,67,605165
chr1,39475320,0.98,51,1,52,605166
chr1,39475330,0.94,50,3,53,605167
chr1,39475351,1,56,0,56,605168
chr1,39475419,0.92,67,6,73,605169
chr1,39475448,0.96,68,3,71,605170
chr1,39475452,0.98,63,1,64,605171
chr1,39475460,0.98,65,1,66,605172
chr1,39475464,0.95,53,3,56,605173
chr1,39475822,0.86,63,10,73,605174
chr1,39475855,0.97,77,2,79,605175
chr1,39475863,0.98,81,2,83,605176
chr1,39475869,0.96,76,3,79,605177
chr1,39475893,0.96,86,4,90,605178
chr1,39475924,0.93,95,7,102,605179
chr1,39476031,0.87,76,11,87,605180
chr1,39476052,0.99,91,1,92,605181
chr1,39476092,0.98,84,2,86,605182
chr1,39476100,0.9,79,9,88,605183
chr1,39476414,0.94,87,6,93,605184
chr1,39476435,0.99,81,1,82,605185
chr1,39476758,0.94,29,2,31,605186
chr1,39476805,0.98,39,1,40,605187
chr1,39476909,0.99,75,1,76,605188
chr1,39476940,0.97,64,2,66,605189
chr1,39476958,0.97,64,2,66,605190
chr1,39476967,0.98,79,2,81,605191
chr1,39477010,0.96,75,3,78,605192
chr1,39477012,0.99,74,1,75,605193
chr1,39477085,1,60,0,60,605194
chr1,39477142,1,58,0,58,605195
chr1,39477225,0.99,75,1,76,605196
chr1,39477315,0.75,3,1,4,605197
chr1,39477323,1,4,0,4,605198
chr1,39477353,1,12,0,12,605199
chr1,39477393,0.95,36,2,38,605200
chr1,39477404,1,58,0,58,605201
chr1,39477441,0.99,81,1,82,605202
chr1,39477449,0.98,80,2,82,605203
chr1,39477485,0.94,72,5,77,605204
chr1,39477496,0.95,76,4,80,605205
chr1,39477516,0.99,72,1,73,605206
chr1,39477527,0.97,70,2,72,605207
chr1,39477534,0.94,64,4,68,605208
chr1,39477543,1,60,0,60,605209
chr1,39477571,0.98,63,1,64,605210
chr1,39477581,0.92,56,5,61,605211
chr1,39477583,0.98,59,1,60,605212
chr1,39477587,1,56,0,56,605213
chr1,39477892,0.8,66,16,82,605214
chr1,39477956,0.89,92,11,103,605215
chr1,39478039,0.96,73,3,76,605216
chr1,39478084,0.96,51,2,53,605217
chr1,39478105,1,36,0,36,605218
chr1,39478149,1,28,0,28,605219
chr1,39478179,0.97,38,1,39,605220
chr1,39478244,1,34,0,34,605221
chr1,39478252,1,32,0,32,605222
chr1,39478256,1,27,0,27,605223
chr1,39478276,1,18,0,18,605224
chr1,39478315,1,3,0,3,605225
chr1,39478332,1,3,0,3,605226
chr1,39478340,0.8,4,1,5,605227
chr1,39478362,0.86,6,1,7,605228
chr1,39478370,1,7,0,7,605229
chr1,39478447,0.98,53,1,54,605230
chr1,39478770,0.93,55,4,59,605231
chr1,39478784,0.96,52,2,54,605232
chr1,39478790,1,52,0,52,605233
chr1,39478800,0.96,48,2,50,605234
chr1,39478837,1,35,0,35,605235
chr1,39478918,0.97,57,2,59,605236
chr1,39478922,0.95,55,3,58,605237
chr1,39478954,0.94,58,4,62,605238
chr1,39478976,1,55,0,55,605239
chr1,39479002,0.98,42,1,43,605240
chr1,39479290,0.9,54,6,60,605241
chr1,39479344,0.97,70,2,72,605242
chr1,39479352,1,70,0,70,605243
chr1,39479536,0.98,49,1,50,605244
chr1,39479553,1,47,0,47,605245
chr1,39479560,0.98,52,1,53,605246
chr1,39479570,0.96,52,2,54,605247
chr1,39479617,0.98,59,1,60,605248
chr1,39479658,0.86,68,11,79,605249
chr1,39479751,0.9,76,8,84,605250
chr1,39479759,0.95,80,4,84,605251
chr1,39479761,0.98,81,2,83,605252
chr1,39479765,0.99,80,1,81,605253
chr1,39479854,0.98,62,1,63,605254
chr1,39479881,1,69,0,69,605255
chr1,39479889,0.99,73,1,74,605256
chr1,39479940,0.94,93,6,99,605257
chr1,39479950,0.95,91,5,96,605258
chr1,39479977,0.88,83,11,94,605259
chr1,39479981,0.96,88,4,92,605260
chr1,39479988,1,94,0,94,605261
chr1,39480064,0.97,64,2,66,605262
chr1,39480083,0.94,60,4,64,605263
chr1,39480152,0.82,60,13,73,605264
chr1,39480187,0.96,69,3,72,605265
chr1,39480243,1,78,0,78,605266
chr1,39480270,0.99,87,1,88,605267
chr1,39480291,0.92,82,7,89,605268
chr1,39480301,0.96,85,4,89,605269
chr1,39480345,0.93,77,6,83,605270
chr1,39480388,1,61,0,61,605271
chr1,39480413,0.98,59,1,60,605272
chr1,39480444,0.92,59,5,64,605273
chr1,39480476,0.94,73,5,78,605274
chr1,39480529,0.99,78,1,79,605275
chr1,39480546,0.95,75,4,79,605276
chr1,39480555,0.95,75,4,79,605277
chr1,39480571,1,75,0,75,605278
chr1,39480592,0.94,72,5,77,605279
chr1,39480600,0.97,75,2,77,605280
chr1,39480730,1,56,0,56,605281
chr1,39480734,0.85,50,9,59,605282
chr1,39480795,0.9,65,7,72,605283
chr1,39480892,0.92,66,6,72,605284
chr1,39480914,0.64,50,28,78,605285
chr1,39480932,0.97,64,2,66,605286
chr1,39480942,0.79,55,15,70,605287
chr1,39481019,0.77,46,14,60,605288
chr1,39481205,0.88,84,11,95,605289
chr1,39481438,0.95,59,3,62,605290
chr1,39481440,0.97,64,2,66,605291
chr1,39481450,0.96,64,3,67,605292
chr1,39481478,0.97,83,3,86,605293
chr1,39481483,0.87,77,12,89,605294
chr1,39481493,0.96,86,4,90,605295
chr1,39481567,0.99,92,1,93,605296
chr1,39481572,0.97,87,3,90,605297
chr1,39481582,0.95,81,4,85,605298
chr1,39481584,0.99,82,1,83,605299
chr1,39481690,0.83,55,11,66,605300
chr1,39481706,0.89,62,8,70,605301
chr1,39482070,0.99,101,1,102,605302
chr1,39482106,0.62,67,41,108,605303
chr1,39482160,0.75,71,24,95,605304
chr1,39482395,0.51,38,36,74,605305
chr1,39482424,0.85,57,10,67,605306
chr1,39482522,0.8,53,13,66,605307
chr1,39482586,0.57,41,31,72,605308
chr1,39482594,0.45,32,39,71,605309
chr1,39482608,0.75,56,19,75,605310
chr1,39482624,0.85,60,11,71,605311
chr1,39482758,0.47,26,29,55,605312
chr1,39482794,0.71,35,14,49,605313
chr1,39482805,0.81,43,10,53,605314
chr1,39483086,0.83,93,19,112,605315
chr1,39483128,0.77,76,23,99,605316
chr1,39483137,0.94,91,6,97,605317
chr1,39483154,0.75,66,22,88,605318
chr1,39483165,0.9,70,8,78,605319
chr1,39483195,0.51,34,33,67,605320
chr1,39483536,0.96,43,2,45,605321
chr1,39483564,0.96,45,2,47,605322
chr1,39483575,1,53,0,53,605323
chr1,39483624,1,80,0,80,605324
chr1,39483626,0.97,77,2,79,605325
chr1,39483644,0.92,79,7,86,605326
chr1,39483666,0.97,95,3,98,605327
chr1,39483782,0.91,83,8,91,605328
chr1,39483828,0.91,59,6,65,605329
chr1,39483911,0.97,88,3,91,605330
chr1,39483969,0.92,56,5,61,605331
chr1,39483998,0.92,59,5,64,605332
chr1,39484050,0.96,88,4,92,605333
chr1,39484099,0.86,81,13,94,605334
chr1,39484103,0.7,75,32,107,605335
chr1,39484127,0.9,101,11,112,605336
chr1,39484214,0.88,57,8,65,605337
chr1,39484373,0.95,76,4,80,605338
chr1,39484467,0.74,61,21,82,605339
chr1,39484509,0.96,85,4,89,605340
chr1,39484531,0.85,76,13,89,605341
chr1,39484551,1,91,0,91,605342
chr1,39484563,0.95,89,5,94,605343
chr1,39484608,0.56,49,39,88,605344
chr1,39484766,0.75,9,3,12,605345
chr1,39484804,0.94,31,2,33,605346
chr1,39484806,0.97,34,1,35,605347
chr1,39484811,0.87,34,5,39,605348
chr1,39484828,0.96,43,2,45,605349
chr1,39484835,0.82,40,9,49,605350
chr1,39484887,0.97,28,1,29,605351
chr1,39484891,0.97,31,1,32,605352
chr1,39484899,1,29,0,29,605353
chr1,39484903,0.96,24,1,25,605354
chr1,39484931,1,14,0,14,605355
chr1,39484977,0.95,35,2,37,605356
chr1,39484988,0.98,49,1,50,605357
chr1,39484994,1,54,0,54,605358
chr1,39485031,0.97,93,3,96,605359
chr1,39485033,0.94,90,6,96,605360
chr1,39485037,0.96,94,4,98,605361
chr1,39485061,0.97,102,3,105,605362
chr1,39485090,0.98,98,2,100,605363
chr1,39485433,0.87,72,11,83,605364
chr1,39485783,0.96,22,1,23,605365
chr1,39485792,1,27,0,27,605366
chr1,39485814,0.97,37,1,38,605367
chr1,39485827,1,46,0,46,605368
chr1,39485910,0.97,64,2,66,605369
chr1,39485913,0.98,61,1,62,605370
chr1,39485996,0.85,69,12,81,605371
chr1,39486049,0.92,76,7,83,605372
chr1,39486277,0.95,42,2,44,605373
chr1,39486592,0.95,53,3,56,605374
chr1,39486617,0.98,58,1,59,605375
chr1,39486720,0.94,60,4,64,605376
chr1,39487191,0.67,66,32,98,605377
chr1,39487549,0.7,63,27,90,605378
chr1,39487890,0.86,97,16,113,605379
chr1,39488010,0.83,35,7,42,605380
chr1,39488023,0.95,42,2,44,605381
chr1,39488044,0.82,41,9,50,605382
chr1,39488095,0.96,50,2,52,605383
chr1,39488107,0.96,54,2,56,605384
chr1,39488111,0.93,54,4,58,605385
chr1,39488202,0.8,35,9,44,605386
chr1,39488240,0.91,41,4,45,605387
chr1,39488244,0.8,36,9,45,605388
chr1,39488285,0.78,35,10,45,605389
chr1,39488345,0.75,39,13,52,605390
chr1,39488394,0.8,61,15,76,605391
chr1,39488448,0.89,78,10,88,605392
chr1,39488552,0.97,62,2,64,605393
chr1,39488569,0.97,56,2,58,605394
chr1,39488577,0.98,57,1,58,605395
chr1,39488599,0.96,53,2,55,605396
chr1,39488783,0.95,86,5,91,605397
chr1,39489066,0.58,49,36,85,605398
chr1,39489220,0.92,61,5,66,605399
chr1,39489409,0.98,58,1,59,605400
chr1,39489415,0.95,62,3,65,605401
chr1,39489449,0.97,83,3,86,605402
chr1,39489938,0.91,69,7,76,605403
chr1,39489942,0.99,71,1,72,605404
chr1,39489954,0.96,75,3,78,605405
chr1,39489987,1,74,0,74,605406
chr1,39489998,0.97,70,2,72,605407
chr1,39490043,0.93,68,5,73,605408
chr1,39490087,1,57,0,57,605409
chr1,39490133,0.96,50,2,52,605410
chr1,39490535,0.95,40,2,42,605411
chr1,39490827,0.8,53,13,66,605412
chr1,39490862,0.99,74,1,75,605413
chr1,39490940,0.94,82,5,87,605414
chr1,39490988,0.77,37,11,48,605415
chr1,39491066,0.97,35,1,36,605416
chr1,39491087,1,53,0,53,605417
chr1,39491089,1,55,0,55,605418
chr1,39491112,0.98,58,1,59,605419
chr1,39491119,0.97,57,2,59,605420
chr1,39491129,0.97,56,2,58,605421
chr1,39491143,0.95,40,2,42,605422
chr1,39491177,0.98,57,1,58,605423
chr1,39491248,0.93,64,5,69,605424
chr1,39491269,0.99,73,1,74,605425
chr1,39491278,0.95,73,4,77,605426
chr1,39491318,0.73,60,22,82,605427
chr1,39491322,0.72,60,23,83,605428
chr1,39491348,0.68,56,26,82,605429
chr1,39491459,0.45,15,18,33,605430
chr1,39491759,0.02,1,51,52,605431
chr1,39491763,0.01,1,68,69,605432
chr1,39491799,0.01,1,71,72,605433
chr1,39491822,0,0,69,69,605434
chr1,39491882,0,0,53,53,605435
chr1,39491892,0,0,58,58,605436
chr1,39491905,0.02,1,62,63,605437
chr1,39491911,0,0,62,62,605438
chr1,39491936,0.01,1,68,69,605439
chr1,39491951,0,0,69,69,605440
chr1,39491958,0.01,1,68,69,605441
chr1,39491961,0,0,56,56,605442
chr1,39491964,0,0,69,69,605443
chr1,39491966,0,0,68,68,605444
chr1,39491975,0,0,67,67,605445
chr1,39491980,0,0,68,68,605446
chr1,39491998,0,0,67,67,605447
chr1,39492005,0,0,46,46,605448
chr1,39492009,0.02,1,61,62,605449
chr1,39492011,0,0,59,59,605450
chr1,39492014,0.02,1,62,63,605451
chr1,39492025,0.03,2,71,73,605452
chr1,39492035,0,0,67,67,605453
chr1,39492038,0.02,1,60,61,605454
chr1,39492061,0,0,65,65,605455
chr1,39492068,0,0,67,67,605456
chr1,39492093,0,0,62,62,605457
chr1,39492095,0,0,59,59,605458
chr1,39492097,0.02,1,59,60,605459
chr1,39492125,0,0,52,52,605460
chr1,39492193,0.02,1,51,52,605461
chr1,39492215,0,0,58,58,605462
chr1,39492241,0.01,1,81,82,605463
chr1,39492258,0,0,53,53,605464
chr1,39492295,0,0,92,92,605465
chr1,39492337,0,0,93,93,605466
chr1,39492366,0,0,91,91,605467
chr1,39492374,0,0,84,84,605468
chr1,39492380,0,0,77,77,605469
chr1,39492383,0,0,83,83,605470
chr1,39492414,0,0,72,72,605471
chr1,39492423,0.01,1,74,75,605472
chr1,39492428,0,0,62,62,605473
chr1,39492474,0,0,93,93,605474
chr1,39492521,0,0,111,111,605475
chr1,39492527,0.01,1,112,113,605476
chr1,39492559,0,0,125,125,605477
chr1,39492570,0.02,2,120,122,605478
chr1,39492584,0.01,1,112,113,605479
chr1,39492600,0,0,113,113,605480
chr1,39492620,0,0,108,108,605481
chr1,39492628,0,0,103,103,605482
chr1,39492651,0.01,1,92,93,605483
chr1,39492670,0,0,95,95,605484
chr1,39492689,0.01,1,89,90,605485
chr1,39492770,0.23,16,55,71,605486
chr1,39492803,0.08,4,47,51,605487
chr1,39492805,0.02,1,57,58,605488
chr1,39492811,0.01,1,67,68,605489
chr1,39492835,0.08,5,57,62,605490
chr1,39492845,0.09,5,51,56,605491
chr1,39492867,0.03,2,64,66,605492
chr1,39492891,0.22,9,32,41,605493
chr1,39492899,0.11,5,42,47,605494
chr1,39492903,0.09,6,60,66,605495
chr1,39492940,0.58,30,22,52,605496
chr1,39492969,0.53,21,19,40,605497
chr1,39492971,0.53,20,18,38,605498
chr1,39492986,0.71,20,8,28,605499
chr1,39492990,0.68,26,12,38,605500
chr1,39492995,0.52,22,20,42,605501
chr1,39493023,0.87,41,6,47,605502
chr1,39493035,0.93,42,3,45,605503
chr1,39493100,0.97,59,2,61,605504
chr1,39493102,0.98,60,1,61,605505
chr1,39493104,0.98,56,1,57,605506
chr1,39493246,0.94,17,1,18,605507
chr1,39493281,1,12,0,12,605508
chr1,39493390,0.97,35,1,36,605509
chr1,39493521,0.95,20,1,21,605510
chr1,39493551,0.92,45,4,49,605511
chr1,39493614,0.95,56,3,59,605512
chr1,39493646,1,60,0,60,605513
chr1,39493680,0.86,63,10,73,605514
chr1,39493738,0.97,68,2,70,605515
chr1,39493783,1,81,0,81,605516
chr1,39493874,0.93,50,4,54,605517
chr1,39493878,1,52,0,52,605518
chr1,39493913,1,61,0,61,605519
chr1,39493964,0.98,54,1,55,605520
chr1,39493974,1,62,0,62,605521
chr1,39494018,0.99,76,1,77,605522
chr1,39494029,0.98,82,2,84,605523
chr1,39494067,0.97,106,3,109,605524
chr1,39494088,0.95,101,5,106,605525
chr1,39494104,0.93,99,8,107,605526
chr1,39494121,0.97,101,3,104,605527
chr1,39494131,1,100,0,100,605528
chr1,39494195,0.97,56,2,58,605529
chr1,39494426,0.94,119,7,126,605530
chr1,39494442,0.91,122,12,134,605531
chr1,39494490,0.95,128,7,135,605532
chr1,39494537,0.98,116,2,118,605533
chr1,39494547,0.91,108,11,119,605534
chr1,39494585,0.96,101,4,105,605535
chr1,39494601,1,93,0,93,605536
chr1,39494611,0.88,68,9,77,605537
chr1,39494725,0.98,44,1,45,605538
chr1,39494733,0.98,53,1,54,605539
chr1,39494767,0.99,77,1,78,605540
chr1,39494772,1,85,0,85,605541
chr1,39494774,0.95,83,4,87,605542
chr1,39494789,0.96,73,3,76,605543
chr1,39494821,0.95,72,4,76,605544
chr1,39494853,0.93,75,6,81,605545
chr1,39494907,0.97,73,2,75,605546
chr1,39494954,0.15,8,45,53,605547
chr1,39495412,1,87,0,87,605548
chr1,39495421,0.97,83,3,86,605549
chr1,39495492,0.89,57,7,64,605550
chr1,39495502,0.97,57,2,59,605551
chr1,39495535,0.8,40,10,50,605552
chr1,39495546,0.94,49,3,52,605553
chr1,39495655,0.97,37,1,38,605554
chr1,39495687,1,34,0,34,605555
chr1,39495694,1,33,0,33,605556
chr1,39495711,0.97,36,1,37,605557
chr1,39495725,0.97,33,1,34,605558
chr1,39495741,0.92,34,3,37,605559
chr1,39495749,0.87,40,6,46,605560
chr1,39495851,0.97,34,1,35,605561
chr1,39495905,0.89,40,5,45,605562
chr1,39495991,1,64,0,64,605563
chr1,39496055,0.97,30,1,31,605564
chr1,39496063,1,25,0,25,605565
chr1,39496101,0.88,29,4,33,605566
chr1,39496144,0.93,40,3,43,605567
chr1,39496153,0.98,44,1,45,605568
chr1,39496174,1,46,0,46,605569
chr1,39496205,0.96,52,2,54,605570
chr1,39496251,0.99,79,1,80,605571
chr1,39496271,0.92,84,7,91,605572
chr1,39496316,0.96,66,3,69,605573
chr1,39496340,0.91,41,4,45,605574
chr1,39496370,0.92,35,3,38,605575
chr1,39496378,1,34,0,34,605576
chr1,39496569,0.99,71,1,72,605577
chr1,39496580,0.95,73,4,77,605578
chr1,39496583,0.97,68,2,70,605579
chr1,39496599,0.99,75,1,76,605580
chr1,39496605,0.99,80,1,81,605581
chr1,39496698,0.99,66,1,67,605582
chr1,39496761,0.96,48,2,50,605583
chr1,39496923,0.98,59,1,60,605584
chr1,39496990,0.96,55,2,57,605585
chr1,39497023,0.99,69,1,70,605586
chr1,39497041,1,78,0,78,605587
chr1,39497141,0.96,80,3,83,605588
chr1,39497215,0.84,67,13,80,605589
chr1,39497264,0.99,78,1,79,605590
chr1,39497269,0.99,87,1,88,605591
chr1,39497600,1,68,0,68,605592
chr1,39497745,0.95,60,3,63,605593
chr1,39497755,0.95,63,3,66,605594
chr1,39497762,1,65,0,65,605595
chr1,39497787,0.97,59,2,61,605596
chr1,39498163,0.87,109,17,126,605597
chr1,39498188,0.91,112,11,123,605598
chr1,39498822,0.95,54,3,57,605599
chr1,39498967,0.98,47,1,48,605600
chr1,39498973,0.98,41,1,42,605601
chr1,39498983,1,42,0,42,605602
chr1,39499011,1,31,0,31,605603
chr1,39499020,0.95,21,1,22,605604
chr1,39499027,0.89,17,2,19,605605
chr1,39499041,1,14,0,14,605606
chr1,39499101,1,16,0,16,605607
chr1,39499117,0.94,17,1,18,605608
chr1,39499132,1,26,0,26,605609
chr1,39499137,1,34,0,34,605610
chr1,39499161,1,52,0,52,605611
chr1,39499163,0.98,53,1,54,605612
chr1,39499176,1,60,0,60,605613
chr1,39499234,0.96,55,2,57,605614
chr1,39499236,0.98,56,1,57,605615
chr1,39499259,0.98,49,1,50,605616
chr1,39499266,0.98,50,1,51,605617
chr1,39499276,0.95,40,2,42,605618
chr1,39499318,0.97,36,1,37,605619
chr1,39499320,1,36,0,36,605620
chr1,39499322,0.97,31,1,32,605621
chr1,39499330,0.98,39,1,40,605622
chr1,39499414,0.94,15,1,16,605623
chr1,39499418,0.96,25,1,26,605624
chr1,39499423,1,24,0,24,605625
chr1,39499451,0.91,42,4,46,605626
chr1,39499463,0.96,53,2,55,605627
chr1,39499558,0.99,83,1,84,605628
chr1,39499597,0.94,88,6,94,605629
chr1,39499718,0.91,69,7,76,605630
chr1,39499925,0.97,87,3,90,605631
chr1,39499946,0.93,83,6,89,605632
chr1,39500070,0.85,53,9,62,605633
chr1,39500094,0.96,46,2,48,605634
chr1,39500160,0.91,41,4,45,605635
chr1,39500237,0.99,68,1,69,605636
chr1,39500387,0.98,53,1,54,605637
chr1,39500576,0.97,64,2,66,605638
chr1,39500606,0.92,72,6,78,605639
chr1,39500876,0.89,31,4,35,605640
chr1,39500898,0.93,56,4,60,605641
chr1,39500923,1,80,0,80,605642
chr1,39500940,0.97,91,3,94,605643
chr1,39500994,0.96,85,4,89,605644
chr1,39501026,0.96,69,3,72,605645
chr1,39501057,0.93,50,4,54,605646
chr1,39501079,1,41,0,41,605647
chr1,39501124,1,22,0,22,605648
chr1,39501255,0.96,71,3,74,605649
chr1,39501257,0.93,66,5,71,605650
chr1,39501509,0.98,56,1,57,605651
chr1,39501515,0.96,54,2,56,605652
chr1,39501549,0.99,66,1,67,605653
chr1,39501591,0.97,74,2,76,605654
chr1,39501593,0.98,78,2,80,605655
chr1,39501666,0.95,71,4,75,605656
chr1,39501721,0.41,28,41,69,605657
chr1,39501799,0.96,49,2,51,605658
chr1,39501893,0.95,72,4,76,605659
chr1,39501925,0.99,85,1,86,605660
chr1,39501988,0.95,38,2,40,605661
chr1,39502011,1,16,0,16,605662
chr1,39502024,0.39,11,17,28,605663
chr1,39502029,0.61,25,16,41,605664
chr1,39502163,0.97,69,2,71,605665
chr1,39502171,0.97,75,2,77,605666
chr1,39502230,1,74,0,74,605667
chr1,39502237,0.94,80,5,85,605668
chr1,39502267,0.98,81,2,83,605669
chr1,39502330,1,85,0,85,605670
chr1,39502532,0.86,81,13,94,605671
chr1,39502604,0.99,81,1,82,605672
chr1,39502644,0.95,79,4,83,605673
chr1,39502674,0.92,85,7,92,605674
chr1,39502728,0.97,102,3,105,605675
chr1,39502756,0.93,91,7,98,605676
chr1,39502859,1,62,0,62,605677
chr1,39502939,0.98,57,1,58,605678
chr1,39502950,0.94,47,3,50,605679
chr1,39502955,1,51,0,51,605680
chr1,39503120,1,85,0,85,605681
chr1,39503136,0.99,85,1,86,605682
chr1,39503144,0.99,87,1,88,605683
chr1,39503198,0.97,83,3,86,605684
chr1,39503369,0.89,72,9,81,605685
chr1,39503718,0.97,66,2,68,605686
chr1,39503823,0.96,93,4,97,605687
chr1,39503843,0.98,97,2,99,605688
chr1,39504129,0.86,64,10,74,605689
chr1,39504271,0.69,36,16,52,605690
chr1,39504287,0.93,50,4,54,605691
chr1,39504378,0.91,52,5,57,605692
chr1,39504519,0.98,51,1,52,605693
chr1,39504534,0.94,46,3,49,605694
chr1,39504598,0.95,40,2,42,605695
chr1,39504716,1,67,0,67,605696
chr1,39504722,0.97,60,2,62,605697
chr1,39504760,0.97,33,1,34,605698
chr1,39504765,1,27,0,27,605699
chr1,39504776,1,24,0,24,605700
chr1,39504790,0.93,13,1,14,605701
chr1,39504810,1,6,0,6,605702
chr1,39504821,1,5,0,5,605703
chr1,39504850,1,2,0,2,605704
chr1,39504866,1,5,0,5,605705
chr1,39504886,1,6,0,6,605706
chr1,39504910,0.92,23,2,25,605707
chr1,39504942,0.92,36,3,39,605708
chr1,39504948,0.86,32,5,37,605709
chr1,39505046,1,19,0,19,605710
chr1,39505074,0.94,34,2,36,605711
chr1,39505106,0.94,45,3,48,605712
chr1,39505169,0.98,61,1,62,605713
chr1,39505177,1,61,0,61,605714
chr1,39505223,0.97,67,2,69,605715
chr1,39505265,0.98,52,1,53,605716
chr1,39505491,0.81,58,14,72,605717
chr1,39505869,0.77,75,23,98,605718
chr1,39505905,0.93,96,7,103,605719
chr1,39505908,0.99,100,1,101,605720
chr1,39505932,0.96,95,4,99,605721
chr1,39505995,0.95,70,4,74,605722
chr1,39506074,0.98,64,1,65,605723
chr1,39506136,0.87,53,8,61,605724
chr1,39506220,0.89,47,6,53,605725
chr1,39506236,0.83,43,9,52,605726
chr1,39506401,0.92,91,8,99,605727
chr1,39506450,0.81,79,18,97,605728
chr1,39506489,0.71,67,27,94,605729
chr1,39506595,0.98,80,2,82,605730
chr1,39506634,0.97,72,2,74,605731
chr1,39506648,0.89,65,8,73,605732
chr1,39506735,1,76,0,76,605733
chr1,39506757,0.99,82,1,83,605734
chr1,39506766,0.96,76,3,79,605735
chr1,39506773,0.9,69,8,77,605736
chr1,39506783,0.97,72,2,74,605737
chr1,39506836,0.97,70,2,72,605738
chr1,39506901,0.98,57,1,58,605739
chr1,39506909,0.92,49,4,53,605740
chr1,39506928,0.96,68,3,71,605741
chr1,39506933,0.9,66,7,73,605742
chr1,39506973,1,83,0,83,605743
chr1,39507165,0.98,78,2,80,605744
chr1,39507365,0.75,74,25,99,605745
chr1,39507412,0.94,81,5,86,605746
chr1,39507443,0.97,68,2,70,605747
chr1,39507506,0.96,74,3,77,605748
chr1,39507552,1,88,0,88,605749
chr1,39507592,0.93,76,6,82,605750
chr1,39507650,0.94,73,5,78,605751
chr1,39507895,0.96,76,3,79,605752
chr1,39507933,0.99,76,1,77,605753
chr1,39507997,0.97,38,1,39,605754
chr1,39508025,0.95,20,1,21,605755
chr1,39508029,1,17,0,17,605756
chr1,39508100,1,22,0,22,605757
chr1,39508155,1,16,0,16,605758
chr1,39508508,0.92,99,9,108,605759
chr1,39508547,0.94,95,6,101,605760
chr1,39508744,0.96,67,3,70,605761
chr1,39509040,0.97,63,2,65,605762
chr1,39509103,0.95,87,5,92,605763
chr1,39509173,0.98,78,2,80,605764
chr1,39509175,0.99,81,1,82,605765
chr1,39509236,0.95,79,4,83,605766
chr1,39509247,0.74,65,23,88,605767
chr1,39509433,1,67,0,67,605768
chr1,39509616,0.87,55,8,63,605769
chr1,39509687,0.95,78,4,82,605770
chr1,39509712,0.98,78,2,80,605771
chr1,39509741,0.97,62,2,64,605772
chr1,39509916,0.95,39,2,41,605773
chr1,39509998,0.98,55,1,56,605774
chr1,39510028,0.95,55,3,58,605775
chr1,39510086,0.99,71,1,72,605776
chr1,39510090,1,74,0,74,605777
chr1,39510111,0.97,75,2,77,605778
chr1,39510153,0.99,75,1,76,605779
chr1,39510363,0.71,68,28,96,605780
chr1,39510824,0.91,74,7,81,605781
chr1,39510999,0.96,66,3,69,605782
chr1,39511057,0.97,84,3,87,605783
chr1,39511093,0.89,76,9,85,605784
chr1,39511113,0.96,72,3,75,605785
chr1,39511137,0.97,72,2,74,605786
chr1,39511139,1,70,0,70,605787
chr1,39511216,0.98,41,1,42,605788
chr1,39511475,1,10,0,10,605789
chr1,39511481,0.83,10,2,12,605790
chr1,39511498,1,20,0,20,605791
chr1,39511557,1,50,0,50,605792
chr1,39511567,1,53,0,53,605793
chr1,39511569,1,49,0,49,605794
chr1,39511573,1,48,0,48,605795
chr1,39511632,1,38,0,38,605796
chr1,39511662,0.93,41,3,44,605797
chr1,39511706,1,67,0,67,605798
chr1,39511767,0.96,81,3,84,605799
chr1,39511829,0.96,54,2,56,605800
chr1,39511839,0.96,55,2,57,605801
chr1,39511896,0.97,33,1,34,605802
chr1,39512058,1,44,0,44,605803
chr1,39512152,0.96,23,1,24,605804
chr1,39512176,0.96,25,1,26,605805
chr1,39512188,0.97,30,1,31,605806
chr1,39512228,0.96,25,1,26,605807
chr1,39512248,0.97,33,1,34,605808
chr1,39512262,1,34,0,34,605809
chr1,39512273,0.98,40,1,41,605810
chr1,39512316,0.79,48,13,61,605811
chr1,39512534,0.79,75,20,95,605812
chr1,39512536,0.75,73,24,97,605813
chr1,39512751,0.51,35,34,69,605814
chr1,39512766,0.39,32,50,82,605815
chr1,39512823,0.94,81,5,86,605816
chr1,39512992,0.86,64,10,74,605817
chr1,39513134,0.1,7,66,73,605818
chr1,39513219,0.26,36,102,138,605819
chr1,39513257,0.78,128,36,164,605820
chr1,39513269,0.49,80,84,164,605821
chr1,39513326,0.77,92,27,119,605822
chr1,39513646,0.76,68,22,90,605823
chr1,39513684,0.73,61,23,84,605824
chr1,39513714,0.58,47,34,81,605825
chr1,39513844,0.48,38,42,80,605826
chr1,39513892,0.9,78,9,87,605827
chr1,39513958,0.89,33,4,37,605828
chr1,39513988,0.83,19,4,23,605829
chr1,39513996,0.71,25,10,35,605830
chr1,39514018,0.98,46,1,47,605831
chr1,39514026,0.94,51,3,54,605832
chr1,39514028,0.98,52,1,53,605833
chr1,39514034,0.97,65,2,67,605834
chr1,39514044,1,69,0,69,605835
chr1,39514051,0.97,74,2,76,605836
chr1,39514058,0.98,78,2,80,605837
chr1,39514065,0.93,68,5,73,605838
chr1,39514111,0.97,35,1,36,605839
chr1,39514115,0.97,34,1,35,605840
chr1,39514123,0.97,29,1,30,605841
chr1,39514127,0.93,25,2,27,605842
chr1,39514158,1,1,0,1,605843
chr1,39514189,1,8,0,8,605844
chr1,39514203,0.94,17,1,18,605845
chr1,39514214,0.96,22,1,23,605846
chr1,39514219,1,24,0,24,605847
chr1,39514247,0.93,42,3,45,605848
chr1,39514257,1,52,0,52,605849
chr1,39514263,0.98,60,1,61,605850
chr1,39514302,0.97,72,2,74,605851
chr1,39514342,0.99,88,1,89,605852
chr1,39514695,0.62,42,26,68,605853
chr1,39514769,0.88,36,5,41,605854
chr1,39514853,1,85,0,85,605855
chr1,39514900,0.8,48,12,60,605856
chr1,39514939,0.97,70,2,72,605857
chr1,39514941,1,68,0,68,605858
chr1,39515037,0.93,84,6,90,605859
chr1,39515126,0.98,52,1,53,605860
chr1,39515130,1,64,0,64,605861
chr1,39515135,1,63,0,63,605862
chr1,39515173,0.91,68,7,75,605863
chr1,39515179,0.87,67,10,77,605864
chr1,39515320,0.97,89,3,92,605865
chr1,39515461,0.77,61,18,79,605866
chr1,39515485,0.99,81,1,82,605867
chr1,39515491,0.88,65,9,74,605868
chr1,39515515,0.96,75,3,78,605869
chr1,39515551,0.96,70,3,73,605870
chr1,39515570,0.98,60,1,61,605871
chr1,39515627,0.89,63,8,71,605872
chr1,39515834,0.96,45,2,47,605873
chr1,39515861,0.84,49,9,58,605874
chr1,39515941,0.95,77,4,81,605875
chr1,39516009,0.99,83,1,84,605876
chr1,39516085,0.99,88,1,89,605877
chr1,39516179,0.95,81,4,85,605878
chr1,39516436,0.98,90,2,92,605879
chr1,39516562,0.92,109,10,119,605880
chr1,39516635,0.96,103,4,107,605881
chr1,39516919,0.85,44,8,52,605882
chr1,39517106,0,0,57,57,605883
chr1,39517118,0.98,60,1,61,605884
chr1,39517135,0.91,60,6,66,605885
chr1,39517177,0.81,56,13,69,605886
chr1,39517222,0.9,73,8,81,605887
chr1,39517253,0.97,91,3,94,605888
chr1,39517280,0.96,99,4,103,605889
chr1,39517324,0.94,68,4,72,605890
chr1,39517413,0.91,40,4,44,605891
chr1,39517505,0.92,56,5,61,605892
chr1,39517507,0.94,58,4,62,605893
chr1,39517530,0.99,71,1,72,605894
chr1,39517589,0.92,71,6,77,605895
chr1,39517591,0.95,70,4,74,605896
chr1,39517663,0.9,69,8,77,605897
chr1,39517677,0.94,76,5,81,605898
chr1,39517693,0.96,77,3,80,605899
chr1,39517733,0.95,97,5,102,605900
chr1,39518076,0.83,59,12,71,605901
chr1,39518291,0.69,27,12,39,605902
chr1,39518299,0.9,37,4,41,605903
chr1,39518378,0.65,66,36,102,605904
chr1,39518421,0.95,100,5,105,605905
chr1,39518493,0.96,72,3,75,605906
chr1,39518513,0.87,73,11,84,605907
chr1,39518524,0.93,76,6,82,605908
chr1,39518557,0.94,75,5,80,605909
chr1,39518569,0.67,55,27,82,605910
chr1,39518597,0.87,47,7,54,605911
chr1,39518658,0.93,41,3,44,605912
chr1,39518704,0.6,39,26,65,605913
chr1,39518723,0.84,58,11,69,605914
chr1,39518745,0.97,69,2,71,605915
chr1,39518779,0.9,57,6,63,605916
chr1,39519567,0.93,71,5,76,605917
chr1,39519591,0.98,84,2,86,605918
chr1,39519621,0.94,97,6,103,605919
chr1,39519717,0.82,64,14,78,605920
chr1,39519748,0.75,60,20,80,605921
chr1,39519808,0.6,37,25,62,605922
chr1,39519883,0.93,63,5,68,605923
chr1,39519921,0.87,55,8,63,605924
chr1,39520024,0.86,60,10,70,605925
chr1,39520034,0.79,52,14,66,605926
chr1,39520091,1,65,0,65,605927
chr1,39520108,0.93,50,4,54,605928
chr1,39520360,0.93,89,7,96,605929
chr1,39520426,0.95,72,4,76,605930
chr1,39520455,0.97,65,2,67,605931
chr1,39520463,0.97,63,2,65,605932
chr1,39520541,0.98,48,1,49,605933
chr1,39520543,0.96,46,2,48,605934
chr1,39520583,0.94,62,4,66,605935
chr1,39520627,0.85,69,12,81,605936
chr1,39520680,0.64,58,33,91,605937
chr1,39520799,0.84,75,14,89,605938
chr1,39520919,0.7,66,28,94,605939
chr1,39520937,0.93,88,7,95,605940
chr1,39521124,0.52,42,39,81,605941
chr1,39521259,1,57,0,57,605942
chr1,39521269,0.9,52,6,58,605943
chr1,39521292,0.99,66,1,67,605944
chr1,39521324,0.93,64,5,69,605945
chr1,39521354,0.9,54,6,60,605946
chr1,39521426,0.79,27,7,34,605947
chr1,39521432,0.89,34,4,38,605948
chr1,39521442,0.8,33,8,41,605949
chr1,39521479,0.92,33,3,36,605950
chr1,39521502,1,37,0,37,605951
chr1,39521613,0.92,61,5,66,605952
chr1,39521620,0.94,60,4,64,605953
chr1,39521665,0.82,50,11,61,605954
chr1,39521761,0.9,47,5,52,605955
chr1,39521791,0.92,54,5,59,605956
chr1,39521823,0.98,49,1,50,605957
chr1,39521877,0.94,73,5,78,605958
chr1,39521913,0.87,86,13,99,605959
chr1,39521962,0.94,72,5,77,605960
chr1,39521968,0.97,70,2,72,605961
chr1,39522016,0.84,43,8,51,605962
chr1,39522221,0.94,74,5,79,605963
chr1,39522481,0.93,82,6,88,605964
chr1,39522630,0.91,86,9,95,605965
chr1,39523008,1,45,0,45,605966
chr1,39523064,0.99,77,1,78,605967
chr1,39523094,1,60,0,60,605968
chr1,39523104,0.97,60,2,62,605969
chr1,39523138,0.88,36,5,41,605970
chr1,39523184,0.88,53,7,60,605971
chr1,39523201,0.97,70,2,72,605972
chr1,39523216,0.89,71,9,80,605973
chr1,39523240,0.9,60,7,67,605974
chr1,39523264,0.95,72,4,76,605975
chr1,39523272,0.93,67,5,72,605976
chr1,39523307,0.9,45,5,50,605977
chr1,39523318,0.96,46,2,48,605978
chr1,39523359,1,44,0,44,605979
chr1,39523368,0.96,45,2,47,605980
chr1,39523396,0.98,49,1,50,605981
chr1,39523406,0.93,50,4,54,605982
chr1,39523412,0.96,52,2,54,605983
chr1,39523665,0.94,97,6,103,605984
chr1,39523729,0.99,90,1,91,605985
chr1,39523820,0.98,100,2,102,605986
chr1,39523834,0.87,90,14,104,605987
chr1,39523871,1,76,0,76,605988
chr1,39523875,0.97,67,2,69,605989
chr1,39523887,0.99,71,1,72,605990
chr1,39523920,1,61,0,61,605991
chr1,39524038,0.91,83,8,91,605992
chr1,39524100,0.92,66,6,72,605993
chr1,39524142,0.94,64,4,68,605994
chr1,39524195,0.97,57,2,59,605995
chr1,39524239,0.98,44,1,45,605996
chr1,39524313,1,84,0,84,605997
chr1,39524324,0.99,86,1,87,605998
chr1,39524379,0.98,80,2,82,605999
chr1,39524404,0.97,59,2,61,606000
chr1,39524434,0.97,36,1,37,606001
chr1,39524442,0.97,35,1,36,606002
chr1,39524806,1,51,0,51,606003
chr1,39524818,0.98,46,1,47,606004
chr1,39524846,0.95,41,2,43,606005
chr1,39524864,0.94,50,3,53,606006
chr1,39524876,0.98,55,1,56,606007
chr1,39524896,0.95,52,3,55,606008
chr1,39524948,1,58,0,58,606009
chr1,39524952,1,54,0,54,606010
chr1,39525004,0.92,57,5,62,606011
chr1,39525011,1,60,0,60,606012
chr1,39525034,0.91,50,5,55,606013
chr1,39525309,0.98,94,2,96,606014
chr1,39525353,0.95,92,5,97,606015
chr1,39525940,0.89,64,8,72,606016
chr1,39526008,0.9,57,6,63,606017
chr1,39526081,0.74,66,23,89,606018
chr1,39526126,0.84,84,16,100,606019
chr1,39526167,0.9,60,7,67,606020
chr1,39526247,0.85,23,4,27,606021
chr1,39526287,0.94,34,2,36,606022
chr1,39526292,0.94,33,2,35,606023
chr1,39526296,1,32,0,32,606024
chr1,39526303,0.94,29,2,31,606025
chr1,39526337,0.87,20,3,23,606026
chr1,39526348,0.92,22,2,24,606027
chr1,39526427,0.66,23,12,35,606028
chr1,39526453,1,38,0,38,606029
chr1,39526465,0.73,27,10,37,606030
chr1,39526767,0.99,71,1,72,606031
chr1,39526777,0.94,78,5,83,606032
chr1,39526993,0.94,59,4,63,606033
chr1,39527184,0.89,32,4,36,606034
chr1,39527207,0.93,50,4,54,606035
chr1,39527270,1,82,0,82,606036
chr1,39527340,1,58,0,58,606037
chr1,39527354,1,56,0,56,606038
chr1,39527365,0.96,50,2,52,606039
chr1,39527398,0.98,55,1,56,606040
chr1,39527414,0.97,64,2,66,606041
chr1,39527601,0.99,67,1,68,606042
chr1,39527684,0.94,60,4,64,606043
chr1,39527778,0.72,71,28,99,606044
chr1,39527881,0.56,77,61,138,606045
chr1,39528006,0.95,87,5,92,606046
chr1,39528074,0.89,86,11,97,606047
chr1,39528095,0.96,85,4,89,606048
chr1,39528099,0.98,80,2,82,606049
chr1,39528101,0.96,81,3,84,606050
chr1,39528111,0.91,75,7,82,606051
chr1,39528163,0.96,72,3,75,606052
chr1,39528171,0.98,80,2,82,606053
chr1,39528202,0.96,88,4,92,606054
chr1,39528230,0.96,103,4,107,606055
chr1,39528317,0.51,59,57,116,606056
chr1,39528323,0.98,111,2,113,606057
chr1,39528325,0.99,114,1,115,606058
chr1,39528369,0.96,78,3,81,606059
chr1,39528425,0.85,40,7,47,606060
chr1,39528630,1,92,0,92,606061
chr1,39528669,0.92,100,9,109,606062
chr1,39528705,0.95,90,5,95,606063
chr1,39528733,0.95,82,4,86,606064
chr1,39528787,0.9,78,9,87,606065
chr1,39528824,0.78,71,20,91,606066
chr1,39528940,0.96,101,4,105,606067
chr1,39528982,0.73,56,21,77,606068
chr1,39529061,0.84,76,14,90,606069
chr1,39529131,0.25,24,72,96,606070
chr1,39529156,0.59,60,41,101,606071
chr1,39529212,0.53,47,41,88,606072
chr1,39529232,0.64,47,26,73,606073
chr1,39529398,0.83,68,14,82,606074
chr1,39529568,0.05,5,91,96,606075
chr1,39529581,0.26,25,72,97,606076
chr1,39529662,0.49,43,44,87,606077
chr1,39529785,0.87,77,12,89,606078
chr1,39529793,0.89,82,10,92,606079
chr1,39529833,0.94,80,5,85,606080
chr1,39529913,0.5,1,1,2,606081
chr1,39529920,0.5,1,1,2,606082
chr1,39529929,0,0,2,2,606083
chr1,39529962,0.95,19,1,20,606084
chr1,39529987,1,39,0,39,606085
chr1,39530060,1,60,0,60,606086
chr1,39530062,0.9,53,6,59,606087
chr1,39530256,0.78,40,11,51,606088
chr1,39530286,0.95,60,3,63,606089
chr1,39530304,0.78,60,17,77,606090
chr1,39530317,0.96,69,3,72,606091
chr1,39530342,0.97,75,2,77,606092
chr1,39530353,0.98,80,2,82,606093
chr1,39530399,0.94,62,4,66,606094
chr1,39530406,0.9,60,7,67,606095
chr1,39530420,0.97,59,2,61,606096
chr1,39530485,0.95,87,5,92,606097
chr1,39530493,0.92,83,7,90,606098
chr1,39530573,0.91,41,4,45,606099
chr1,39530581,1,38,0,38,606100
chr1,39530656,0.92,46,4,50,606101
chr1,39530671,1,61,0,61,606102
chr1,39530727,0.97,70,2,72,606103
chr1,39530734,1,64,0,64,606104
chr1,39530898,0.79,54,14,68,606105
chr1,39530977,0.88,84,11,95,606106
chr1,39531027,0.95,79,4,83,606107
chr1,39531044,0.55,32,26,58,606108
chr1,39531067,0.98,39,1,40,606109
chr1,39531091,0.83,35,7,42,606110
chr1,39531107,0.86,36,6,42,606111
chr1,39531189,0.75,69,23,92,606112
chr1,39531272,0.93,68,5,73,606113
chr1,39531352,0.79,52,14,66,606114
chr1,39531431,0.69,48,22,70,606115
chr1,39531643,0.48,42,46,88,606116
chr1,39531727,0.55,52,42,94,606117
chr1,39532006,0.89,58,7,65,606118
chr1,39532066,0.82,56,12,68,606119
chr1,39532074,0.94,67,4,71,606120
chr1,39532096,0.99,73,1,74,606121
chr1,39532137,0.77,60,18,78,606122
chr1,39532147,0.86,66,11,77,606123
chr1,39532176,0.96,68,3,71,606124
chr1,39532282,0.89,17,2,19,606125
chr1,39532366,0.96,64,3,67,606126
chr1,39532370,0.97,75,2,77,606127
chr1,39532378,0.99,79,1,80,606128
chr1,39532466,0.99,98,1,99,606129
chr1,39532518,0.92,81,7,88,606130
chr1,39532593,1,77,0,77,606131
chr1,39532598,0.55,39,32,71,606132
chr1,39532607,0.95,74,4,78,606133
chr1,39532733,0.98,39,1,40,606134
chr1,39532741,0.89,33,4,37,606135
chr1,39532749,0.9,35,4,39,606136
chr1,39532771,0.78,31,9,40,606137
chr1,39532788,0.98,51,1,52,606138
chr1,39532794,0.96,53,2,55,606139
chr1,39532827,0.88,44,6,50,606140
chr1,39532859,0.94,49,3,52,606141
chr1,39532922,0.95,55,3,58,606142
chr1,39532942,0.96,50,2,52,606143
chr1,39532979,0.96,51,2,53,606144
chr1,39533181,0.96,72,3,75,606145
chr1,39533275,0.94,88,6,94,606146
chr1,39533330,0.56,43,34,77,606147
chr1,39533500,1,37,0,37,606148
chr1,39533502,0.95,39,2,41,606149
chr1,39533508,0.89,40,5,45,606150
chr1,39533525,1,44,0,44,606151
chr1,39533540,0.96,52,2,54,606152
chr1,39533564,0.92,56,5,61,606153
chr1,39533588,1,45,0,45,606154
chr1,39533600,0.98,44,1,45,606155
chr1,39533629,0.93,25,2,27,606156
chr1,39533674,0.88,15,2,17,606157
chr1,39533685,0.88,28,4,32,606158
chr1,39533718,1,61,0,61,606159
chr1,39533728,0.97,66,2,68,606160
chr1,39533793,0.95,83,4,87,606161
chr1,39533809,0.97,91,3,94,606162
chr1,39533878,0.97,76,2,78,606163
chr1,39533900,0.96,74,3,77,606164
chr1,39533940,1,65,0,65,606165
chr1,39533964,0.98,55,1,56,606166
chr1,39533986,1,51,0,51,606167
chr1,39534003,0.91,43,4,47,606168
chr1,39534020,1,43,0,43,606169
chr1,39534192,0.97,58,2,60,606170
chr1,39534338,0.8,52,13,65,606171
chr1,39534724,0.9,111,13,124,606172
chr1,39534800,0.84,83,16,99,606173
chr1,39534966,1,41,0,41,606174
chr1,39534974,0.98,43,1,44,606175
chr1,39535116,0.99,69,1,70,606176
chr1,39535139,0.99,72,1,73,606177
chr1,39535185,0.97,58,2,60,606178
chr1,39535188,0.98,59,1,60,606179
chr1,39535192,0.95,56,3,59,606180
chr1,39535212,0.93,55,4,59,606181
chr1,39535216,0.95,74,4,78,606182
chr1,39535259,0.66,68,35,103,606183
chr1,39535474,0.68,52,25,77,606184
chr1,39535531,0.99,75,1,76,606185
chr1,39535541,0.99,70,1,71,606186
chr1,39535696,0.96,49,2,51,606187
chr1,39535718,0.98,39,1,40,606188
chr1,39535728,0.98,42,1,43,606189
chr1,39535752,0.97,34,1,35,606190
chr1,39535760,1,37,0,37,606191
chr1,39536049,0.91,63,6,69,606192
chr1,39536080,1,49,0,49,606193
chr1,39536082,0.94,44,3,47,606194
chr1,39536085,0.96,43,2,45,606195
chr1,39536120,0.91,39,4,43,606196
chr1,39536154,0.96,54,2,56,606197
chr1,39536270,0.99,89,1,90,606198
chr1,39536280,0.97,96,3,99,606199
chr1,39536310,0.98,79,2,81,606200
chr1,39536312,0.96,79,3,82,606201
chr1,39536475,0.94,59,4,63,606202
chr1,39536872,0.92,88,8,96,606203
chr1,39536879,0.96,94,4,98,606204
chr1,39536888,0.97,94,3,97,606205
chr1,39536916,0.94,103,6,109,606206
chr1,39536925,0.87,96,14,110,606207
chr1,39536928,0.85,88,15,103,606208
chr1,39537210,0.59,70,48,118,606209
chr1,39537898,0.89,48,6,54,606210
chr1,39538056,0.93,57,4,61,606211
chr1,39538313,0.95,42,2,44,606212
chr1,39538319,0.96,43,2,45,606213
chr1,39538321,0.95,40,2,42,606214
chr1,39538395,1,54,0,54,606215
chr1,39538399,0.96,54,2,56,606216
chr1,39538540,0.99,66,1,67,606217
chr1,39538580,0.93,42,3,45,606218
chr1,39538585,1,46,0,46,606219
chr1,39538594,1,38,0,38,606220
chr1,39538596,0.89,33,4,37,606221
chr1,39538683,0.98,54,1,55,606222
chr1,39538707,1,59,0,59,606223
chr1,39538731,1,82,0,82,606224
chr1,39538763,1,75,0,75,606225
chr1,39538769,1,68,0,68,606226
chr1,39538771,1,66,0,66,606227
chr1,39538776,0.97,75,2,77,606228
chr1,39538793,0.99,70,1,71,606229
chr1,39538801,1,69,0,69,606230
chr1,39538844,0.89,65,8,73,606231
chr1,39538907,1,67,0,67,606232
chr1,39538919,0.98,56,1,57,606233
chr1,39538953,0.98,44,1,45,606234
chr1,39539466,1,88,0,88,606235
chr1,39539481,0.94,85,5,90,606236
chr1,39539628,0.96,65,3,68,606237
chr1,39539632,0.98,64,1,65,606238
chr1,39539634,1,66,0,66,606239
chr1,39539644,0.94,66,4,70,606240
chr1,39539671,0.99,66,1,67,606241
chr1,39539677,0.97,68,2,70,606242
chr1,39539681,0.93,55,4,59,606243
chr1,39539733,0.91,81,8,89,606244
chr1,39539763,0.97,97,3,100,606245
chr1,39539767,0.99,93,1,94,606246
chr1,39539775,1,94,0,94,606247
chr1,39539779,0.99,77,1,78,606248
chr1,39539800,0.86,66,11,77,606249
chr1,39539838,1,62,0,62,606250
chr1,39539863,0.85,35,6,41,606251
chr1,39539901,0.9,19,2,21,606252
chr1,39540219,0.83,64,13,77,606253
chr1,39540244,0.99,93,1,94,606254
chr1,39540315,0.94,110,7,117,606255
chr1,39540319,0.94,115,7,122,606256
chr1,39540346,0.93,94,7,101,606257
chr1,39540385,0.88,84,12,96,606258
chr1,39540437,0.97,90,3,93,606259
chr1,39540447,0.91,86,9,95,606260
chr1,39540453,0.93,89,7,96,606261
chr1,39540581,0.94,81,5,86,606262
chr1,39540654,0.96,89,4,93,606263
chr1,39540676,0.85,68,12,80,606264
chr1,39540696,0.93,62,5,67,606265
chr1,39540708,0.97,58,2,60,606266
chr1,39540712,0.98,62,1,63,606267
chr1,39540740,0.88,59,8,67,606268
chr1,39540771,0.97,70,2,72,606269
chr1,39541071,0.93,52,4,56,606270
chr1,39541111,0.98,84,2,86,606271
chr1,39541164,0.96,89,4,93,606272
chr1,39541168,0.82,80,17,97,606273
chr1,39541199,0.95,83,4,87,606274
chr1,39541259,0.95,56,3,59,606275
chr1,39541297,1,51,0,51,606276
chr1,39541299,0.98,47,1,48,606277
chr1,39541313,0.98,54,1,55,606278
chr1,39541529,0.95,83,4,87,606279
chr1,39541551,0.96,77,3,80,606280
chr1,39541591,0.92,34,3,37,606281
chr1,39541639,0.88,7,1,8,606282
chr1,39541647,1,12,0,12,606283
chr1,39541651,1,14,0,14,606284
chr1,39541680,0.75,15,5,20,606285
chr1,39541711,1,28,0,28,606286
chr1,39541725,1,30,0,30,606287
chr1,39541732,0.96,27,1,28,606288
chr1,39541736,0.9,36,4,40,606289
chr1,39541741,0.97,38,1,39,606290
chr1,39541813,0.97,77,2,79,606291
chr1,39541844,0.93,80,6,86,606292
chr1,39541865,0.98,80,2,82,606293
chr1,39541882,0.92,84,7,91,606294
chr1,39541899,0.87,86,13,99,606295
chr1,39541952,0.6,64,42,106,606296
chr1,39541966,0.24,26,84,110,606297
chr1,39542058,0.75,66,22,88,606298
chr1,39542167,0.72,52,20,72,606299
chr1,39542252,0.1,7,61,68,606300
chr1,39542315,0.02,2,89,91,606301
chr1,39542356,0.1,9,83,92,606302
chr1,39542368,0.08,7,86,93,606303
chr1,39542576,0.72,36,14,50,606304
chr1,39542620,0.91,39,4,43,606305
chr1,39543000,1,83,0,83,606306
chr1,39543004,0.89,72,9,81,606307
chr1,39543007,1,79,0,79,606308
chr1,39543029,1,80,0,80,606309
chr1,39543069,0.94,81,5,86,606310
chr1,39543091,0.97,67,2,69,606311
chr1,39543211,1,27,0,27,606312
chr1,39543216,0.92,24,2,26,606313
chr1,39543244,1,45,0,45,606314
chr1,39543256,1,53,0,53,606315
chr1,39543263,1,58,0,58,606316
chr1,39543421,0.98,65,1,66,606317
chr1,39543423,1,66,0,66,606318
chr1,39543429,1,61,0,61,606319
chr1,39543434,0.98,64,1,65,606320
chr1,39543437,1,61,0,61,606321
chr1,39543463,0.96,55,2,57,606322
chr1,39543485,1,53,0,53,606323
chr1,39543509,0.96,48,2,50,606324
chr1,39543649,0.96,75,3,78,606325
chr1,39543655,0.96,80,3,83,606326
chr1,39543706,0.96,47,2,49,606327
chr1,39543738,0.98,40,1,41,606328
chr1,39543761,0.97,31,1,32,606329
chr1,39543778,1,29,0,29,606330
chr1,39543789,0.64,18,10,28,606331
chr1,39543878,0.88,22,3,25,606332
chr1,39543925,0.98,49,1,50,606333
chr1,39543932,0.95,53,3,56,606334
chr1,39543942,0.93,54,4,58,606335
chr1,39544028,0.97,56,2,58,606336
chr1,39544059,0.97,68,2,70,606337
chr1,39544129,1,64,0,64,606338
chr1,39544135,0.92,56,5,61,606339
chr1,39544787,1,93,0,93,606340
chr1,39544862,0.91,80,8,88,606341
chr1,39545073,0.86,64,10,74,606342
chr1,39545207,0.75,43,14,57,606343
chr1,39545269,0.61,47,30,77,606344
chr1,39545474,0.97,89,3,92,606345
chr1,39545491,0.99,102,1,103,606346
chr1,39545498,0.92,101,9,110,606347
chr1,39545554,0.98,103,2,105,606348
chr1,39545562,0.92,98,8,106,606349
chr1,39545627,0.99,79,1,80,606350
chr1,39545635,0.99,74,1,75,606351
chr1,39545650,0.99,78,1,79,606352
chr1,39545659,0.89,67,8,75,606353
chr1,39545687,0.95,71,4,75,606354
chr1,39545699,0.92,72,6,78,606355
chr1,39545777,0.86,43,7,50,606356
chr1,39545838,0.98,56,1,57,606357
chr1,39546023,1,119,0,119,606358
chr1,39546040,0.75,86,28,114,606359
chr1,39546121,0.89,78,10,88,606360
chr1,39546146,0.97,76,2,78,606361
chr1,39546169,0.97,74,2,76,606362
chr1,39546223,0.81,57,13,70,606363
chr1,39546262,0.6,42,28,70,606364
chr1,39546282,0.81,55,13,68,606365
chr1,39546316,0.82,54,12,66,606366
chr1,39546356,0.99,75,1,76,606367
chr1,39546417,0.86,79,13,92,606368
chr1,39546495,0.23,23,75,98,606369
chr1,39546511,0.27,22,60,82,606370
chr1,39546518,0.28,30,76,106,606371
chr1,39546536,0.76,66,21,87,606372
chr1,39546545,0.8,71,18,89,606373
chr1,39546551,0.38,34,56,90,606374
chr1,39546573,0.15,14,79,93,606375
chr1,39546577,0.37,23,40,63,606376
chr1,39546640,0.05,3,63,66,606377
chr1,39546656,0.22,7,25,32,606378
chr1,39546667,0.25,5,15,20,606379
chr1,39546688,0.07,1,14,15,606380
chr1,39546693,0,0,44,44,606381
chr1,39546720,0,0,48,48,606382
chr1,39546724,0.02,1,48,49,606383
chr1,39546726,0,0,46,46,606384
chr1,39546732,0.03,1,39,40,606385
chr1,39546737,0.12,2,15,17,606386
chr1,39546746,0,0,45,45,606387
chr1,39546760,0.06,1,17,18,606388
chr1,39546788,0.03,1,36,37,606389
chr1,39546798,0,0,40,40,606390
chr1,39546835,0,0,28,28,606391
chr1,39546853,0,0,5,5,606392
chr1,39546864,0.08,1,11,12,606393
chr1,39546866,0,0,15,15,606394
chr1,39546886,0.13,1,7,8,606395
chr1,39546889,0,0,9,9,606396
chr1,39546893,0,0,9,9,606397
chr1,39546896,0,0,8,8,606398
chr1,39546910,0,0,8,8,606399
chr1,39546912,0.11,1,8,9,606400
chr1,39546914,0,0,10,10,606401
chr1,39546919,0,0,8,8,606402
chr1,39546923,0,0,8,8,606403
chr1,39546929,0,0,8,8,606404
chr1,39546949,0,0,8,8,606405
chr1,39546958,0,0,8,8,606406
chr1,39546960,0,0,8,8,606407
chr1,39546965,0,0,10,10,606408
chr1,39546972,0.13,1,7,8,606409
chr1,39546979,0,0,7,7,606410
chr1,39546982,0,0,6,6,606411
chr1,39546985,0,0,6,6,606412
chr1,39546988,0,0,5,5,606413
chr1,39547005,0,0,6,6,606414
chr1,39547014,0,0,8,8,606415
chr1,39547020,0,0,7,7,606416
chr1,39547023,0,0,12,12,606417
chr1,39547038,0.08,1,12,13,606418
chr1,39547044,0.06,1,15,16,606419
chr1,39547052,0,0,10,10,606420
chr1,39547054,0,0,10,10,606421
chr1,39547061,0,0,6,6,606422
chr1,39547070,0,0,19,19,606423
chr1,39547073,0,0,12,12,606424
chr1,39547076,0,0,21,21,606425
chr1,39547078,0,0,18,18,606426
chr1,39547084,0,0,23,23,606427
chr1,39547100,0,0,21,21,606428
chr1,39547109,0,0,31,31,606429
chr1,39547115,0,0,25,25,606430
chr1,39547120,0,0,23,23,606431
chr1,39547129,0,0,30,30,606432
chr1,39547135,0,0,25,25,606433
chr1,39547150,0,0,12,12,606434
chr1,39547152,0,0,16,16,606435
chr1,39547156,0,0,35,35,606436
chr1,39547160,0,0,22,22,606437
chr1,39547163,0,0,24,24,606438
chr1,39547166,0.04,1,23,24,606439
chr1,39547172,0,0,29,29,606440
chr1,39547178,0.03,1,30,31,606441
chr1,39547183,0,0,36,36,606442
chr1,39547189,0,0,33,33,606443
chr1,39547205,0,0,32,32,606444
chr1,39547222,0,0,25,25,606445
chr1,39547224,0.03,1,29,30,606446
chr1,39547229,0,0,20,20,606447
chr1,39547231,0,0,31,31,606448
chr1,39547247,0,0,14,14,606449
chr1,39547256,0,0,36,36,606450
chr1,39547261,0,0,32,32,606451
chr1,39547263,0,0,34,34,606452
chr1,39547270,0,0,35,35,606453
chr1,39547275,0,0,36,36,606454
chr1,39547278,0,0,33,33,606455
chr1,39547289,0,0,30,30,606456
chr1,39547300,0,0,24,24,606457
chr1,39547306,0.02,1,45,46,606458
chr1,39547309,0.06,2,30,32,606459
chr1,39547313,0,0,31,31,606460
chr1,39547315,0,0,23,23,606461
chr1,39547327,0,0,45,45,606462
chr1,39547334,0,0,38,38,606463
chr1,39547337,0,0,29,29,606464
chr1,39547341,0,0,34,34,606465
chr1,39547343,0,0,34,34,606466
chr1,39547351,0,0,22,22,606467
chr1,39547363,0,0,24,24,606468
chr1,39547365,0,0,33,33,606469
chr1,39547374,0,0,32,32,606470
chr1,39547382,0,0,30,30,606471
chr1,39547389,0,0,32,32,606472
chr1,39547404,0,0,31,31,606473
chr1,39547406,0,0,32,32,606474
chr1,39547410,0,0,34,34,606475
chr1,39547413,0,0,22,22,606476
chr1,39547416,0,0,34,34,606477
chr1,39547423,0,0,16,16,606478
chr1,39547426,0,0,23,23,606479
chr1,39547434,0.04,1,27,28,606480
chr1,39547456,0,0,19,19,606481
chr1,39547460,0,0,15,15,606482
chr1,39547482,0,0,17,17,606483
chr1,39547491,0,0,25,25,606484
chr1,39547506,0,0,26,26,606485
chr1,39547523,0,0,28,28,606486
chr1,39547527,0,0,12,12,606487
chr1,39547530,0,0,30,30,606488
chr1,39547544,0.11,2,17,19,606489
chr1,39547558,0,0,18,18,606490
chr1,39547568,0,0,28,28,606491
chr1,39547575,0,0,31,31,606492
chr1,39547588,0,0,34,34,606493
chr1,39547592,0.03,1,32,33,606494
chr1,39547604,0,0,30,30,606495
chr1,39547612,0.03,1,38,39,606496
chr1,39547619,0,0,42,42,606497
chr1,39547623,0,0,41,41,606498
chr1,39547625,0,0,41,41,606499
chr1,39547627,0,0,39,39,606500
chr1,39547633,0,0,35,35,606501
chr1,39547649,0,0,43,43,606502
chr1,39547656,0,0,35,35,606503
chr1,39547660,0,0,27,27,606504
chr1,39547662,0,0,32,32,606505
chr1,39547664,0,0,38,38,606506
chr1,39547674,0,0,40,40,606507
chr1,39547676,0,0,35,35,606508
chr1,39547679,0,0,33,33,606509
chr1,39547690,0,0,39,39,606510
chr1,39547692,0,0,38,38,606511
chr1,39547696,0.04,1,27,28,606512
chr1,39547698,0,0,25,25,606513
chr1,39547709,0,0,33,33,606514
chr1,39547712,0,0,33,33,606515
chr1,39547722,0,0,33,33,606516
chr1,39547747,0,0,20,20,606517
chr1,39547781,0,0,33,33,606518
chr1,39547784,0.06,2,32,34,606519
chr1,39547788,0.05,2,35,37,606520
chr1,39547795,0.03,1,37,38,606521
chr1,39547823,0.25,3,9,12,606522
chr1,39547842,0.07,3,39,42,606523
chr1,39547870,0.04,2,43,45,606524
chr1,39547877,0.08,4,45,49,606525
chr1,39547881,0.22,6,21,27,606526
chr1,39547889,0.02,1,54,55,606527
chr1,39547918,0.23,13,43,56,606528
chr1,39547928,0.12,8,60,68,606529
chr1,39547949,0.17,12,58,70,606530
chr1,39547958,0.21,16,61,77,606531
chr1,39547980,0.07,5,64,69,606532
chr1,39548001,0.43,18,24,42,606533
chr1,39548020,0.9,56,6,62,606534
chr1,39548072,0.26,16,45,61,606535
chr1,39548277,0.41,13,19,32,606536
chr1,39548321,0.5,23,23,46,606537
chr1,39548454,0.71,46,19,65,606538
chr1,39548513,0.96,65,3,68,606539
chr1,39548539,0.99,73,1,74,606540
chr1,39548627,0.98,84,2,86,606541
chr1,39548885,0.91,86,8,94,606542
chr1,39549444,0.94,76,5,81,606543
chr1,39549881,0.96,85,4,89,606544
chr1,39549913,0.95,104,5,109,606545
chr1,39549924,0.98,109,2,111,606546
chr1,39549933,0.99,109,1,110,606547
chr1,39549942,0.97,109,3,112,606548
chr1,39549951,0.97,105,3,108,606549
chr1,39549960,0.98,107,2,109,606550
chr1,39549974,0.96,100,4,104,606551
chr1,39549978,0.97,99,3,102,606552
chr1,39549982,0.97,94,3,97,606553
chr1,39550053,0.99,91,1,92,606554
chr1,39550069,0.91,83,8,91,606555
chr1,39550089,0.96,85,4,89,606556
chr1,39550106,0.89,76,9,85,606557
chr1,39550138,0.92,71,6,77,606558
chr1,39550191,0.92,49,4,53,606559
chr1,39550261,0.67,26,13,39,606560
chr1,39550278,0.8,33,8,41,606561
chr1,39550318,0.91,53,5,58,606562
chr1,39550645,0.98,123,2,125,606563
chr1,39550682,0.89,97,12,109,606564
chr1,39550685,0.9,98,11,109,606565
chr1,39550801,0.87,66,10,76,606566
chr1,39551043,0.91,42,4,46,606567
chr1,39551091,0.98,49,1,50,606568
chr1,39551102,0.92,47,4,51,606569
chr1,39551382,0.99,72,1,73,606570
chr1,39551621,1,73,0,73,606571
chr1,39551670,0.9,72,8,80,606572
chr1,39551796,0.96,110,5,115,606573
chr1,39551807,0.92,107,9,116,606574
chr1,39551929,0.74,80,28,108,606575
chr1,39552063,0.1,7,60,67,606576
chr1,39552305,0.05,4,77,81,606577
chr1,39552350,0.02,2,95,97,606578
chr1,39552485,0.33,29,59,88,606579
chr1,39552630,0.08,4,48,52,606580
chr1,39552668,0.03,2,72,74,606581
chr1,39552673,0.06,3,47,50,606582
chr1,39552681,0.04,3,65,68,606583
chr1,39552879,0.04,2,47,49,606584
chr1,39553001,0.02,1,41,42,606585
chr1,39553027,0.07,2,27,29,606586
chr1,39553094,0.25,11,33,44,606587
chr1,39553294,0.69,81,36,117,606588
chr1,39553365,0.2,18,72,90,606589
chr1,39553505,0.97,76,2,78,606590
chr1,39553537,0.77,69,21,90,606591
chr1,39553569,0.92,85,7,92,606592
chr1,39553589,0.94,81,5,86,606593
chr1,39553666,0.95,40,2,42,606594
chr1,39553672,0.88,35,5,40,606595
chr1,39553730,1,62,0,62,606596
chr1,39553745,0.88,53,7,60,606597
chr1,39553789,0.96,47,2,49,606598
chr1,39553805,0.91,40,4,44,606599
chr1,39553834,1,26,0,26,606600
chr1,39553879,1,21,0,21,606601
chr1,39553886,1,20,0,20,606602
chr1,39553890,1,33,0,33,606603
chr1,39553933,1,55,0,55,606604
chr1,39553935,0.98,54,1,55,606605
chr1,39553944,0.98,60,1,61,606606
chr1,39554003,0.94,51,3,54,606607
chr1,39554040,0.98,53,1,54,606608
chr1,39554050,0.98,51,1,52,606609
chr1,39554056,0.85,51,9,60,606610
chr1,39554174,0.86,50,8,58,606611
chr1,39554327,1,71,0,71,606612
chr1,39554484,0.93,55,4,59,606613
chr1,39554515,0.55,31,25,56,606614
chr1,39554594,0.85,51,9,60,606615
chr1,39554767,0.94,66,4,70,606616
chr1,39554803,0.99,68,1,69,606617
chr1,39554811,0.97,68,2,70,606618
chr1,39554915,0.81,47,11,58,606619
chr1,39555125,0.99,85,1,86,606620
chr1,39555174,0.75,72,24,96,606621
chr1,39555432,0.45,56,68,124,606622
chr1,39555548,0.16,12,64,76,606623
chr1,39555590,0.4,32,48,80,606624
chr1,39555778,0.62,24,15,39,606625
chr1,39555885,0.15,7,39,46,606626
chr1,39556120,0.22,22,77,99,606627
chr1,39556617,0.93,25,2,27,606628
chr1,39556956,0.94,75,5,80,606629
chr1,39557030,0.82,92,20,112,606630
chr1,39557199,0.98,59,1,60,606631
chr1,39557230,0.96,54,2,56,606632
chr1,39557236,0.95,53,3,56,606633
chr1,39557270,0.98,59,1,60,606634
chr1,39557316,0.96,67,3,70,606635
chr1,39557407,0.97,68,2,70,606636
chr1,39557460,0.93,74,6,80,606637
chr1,39557660,0.6,71,48,119,606638
chr1,39557687,0.18,19,87,106,606639
chr1,39557840,0.56,49,39,88,606640
chr1,39557881,0.52,26,24,50,606641
chr1,39557948,0.48,39,42,81,606642
chr1,39558018,0.2,12,49,61,606643
chr1,39558210,0.05,2,41,43,606644
chr1,39558412,0.78,62,17,79,606645
chr1,39558541,0.93,64,5,69,606646
chr1,39558548,0.65,53,29,82,606647
chr1,39558579,0.86,77,13,90,606648
chr1,39558646,0.79,63,17,80,606649
chr1,39558702,0.76,53,17,70,606650
chr1,39558714,0.75,57,19,76,606651
chr1,39558745,0.75,58,19,77,606652
chr1,39558747,0.91,73,7,80,606653
chr1,39558811,0.88,76,10,86,606654
chr1,39558837,0.9,70,8,78,606655
chr1,39558876,0.88,76,10,86,606656
chr1,39559073,0.98,65,1,66,606657
chr1,39559134,1,41,0,41,606658
chr1,39559136,1,35,0,35,606659
chr1,39559144,0.89,31,4,35,606660
chr1,39559181,0.82,14,3,17,606661
chr1,39559220,0.92,36,3,39,606662
chr1,39559226,0.88,38,5,43,606663
chr1,39559282,0.96,45,2,47,606664
chr1,39559300,0,0,45,45,606665
chr1,39559306,0.9,47,5,52,606666
chr1,39559346,0.96,48,2,50,606667
chr1,39559447,0.92,83,7,90,606668
chr1,39559451,0.93,83,6,89,606669
chr1,39559482,0.98,61,1,62,606670
chr1,39559492,0.47,27,31,58,606671
chr1,39559552,0.92,70,6,76,606672
chr1,39559595,0.9,56,6,62,606673
chr1,39559599,0.97,57,2,59,606674
chr1,39559650,1,54,0,54,606675
chr1,39559652,0.98,51,1,52,606676
chr1,39559670,1,45,0,45,606677
chr1,39559696,1,50,0,50,606678
chr1,39559701,0.94,47,3,50,606679
chr1,39559729,0.91,50,5,55,606680
chr1,39559738,0.84,51,10,61,606681
chr1,39559896,0.95,86,5,91,606682
chr1,39559914,0.94,91,6,97,606683
chr1,39559945,0.98,97,2,99,606684
chr1,39559988,1,101,0,101,606685
chr1,39559996,1,97,0,97,606686
chr1,39559998,0.99,94,1,95,606687
chr1,39560030,0.93,71,5,76,606688
chr1,39560110,0.46,28,33,61,606689
chr1,39560115,0.98,52,1,53,606690
chr1,39560117,0.95,54,3,57,606691
chr1,39560131,0.94,62,4,66,606692
chr1,39560164,0.97,72,2,74,606693
chr1,39560191,0.97,68,2,70,606694
chr1,39560208,0.88,60,8,68,606695
chr1,39560246,0.91,39,4,43,606696
chr1,39560250,0.9,35,4,39,606697
chr1,39560282,1,24,0,24,606698
chr1,39560321,0.98,40,1,41,606699
chr1,39560330,0.98,51,1,52,606700
chr1,39560344,1,54,0,54,606701
chr1,39560346,0.98,54,1,55,606702
chr1,39560377,0.97,63,2,65,606703
chr1,39560424,0.88,63,9,72,606704
chr1,39560436,0.93,63,5,68,606705
chr1,39560488,0.95,63,3,66,606706
chr1,39560555,0.87,48,7,55,606707
chr1,39560630,0.99,69,1,70,606708
chr1,39560698,0.85,57,10,67,606709
chr1,39560952,1,41,0,41,606710
chr1,39560962,1,35,0,35,606711
chr1,39560972,0.86,30,5,35,606712
chr1,39561000,0.98,42,1,43,606713
chr1,39561005,1,45,0,45,606714
chr1,39561009,0.91,30,3,33,606715
chr1,39561030,1,42,0,42,606716
chr1,39561105,0.98,56,1,57,606717
chr1,39561107,0.98,60,1,61,606718
chr1,39561189,0.96,51,2,53,606719
chr1,39561191,0.96,47,2,49,606720
chr1,39561318,0.89,40,5,45,606721
chr1,39561518,0.97,90,3,93,606722
chr1,39561701,0.95,105,6,111,606723
chr1,39561795,0.99,75,1,76,606724
chr1,39562051,0.94,49,3,52,606725
chr1,39562111,0.91,49,5,54,606726
chr1,39562154,0.91,63,6,69,606727
chr1,39562185,0.92,58,5,63,606728
chr1,39562199,0.96,48,2,50,606729
chr1,39562209,0.92,46,4,50,606730
chr1,39562217,0.98,46,1,47,606731
chr1,39562290,0.78,43,12,55,606732
chr1,39562316,0.73,51,19,70,606733
chr1,39562571,0.86,38,6,44,606734
chr1,39562593,0.91,58,6,64,606735
chr1,39562617,0.95,72,4,76,606736
chr1,39562705,0.96,49,2,51,606737
chr1,39562709,0.94,44,3,47,606738
chr1,39562737,0.92,11,1,12,606739
chr1,39562795,0.41,12,17,29,606740
chr1,39562838,0.95,69,4,73,606741
chr1,39562840,0.97,72,2,74,606742
chr1,39562910,0.92,78,7,85,606743
chr1,39563072,0.79,83,22,105,606744
chr1,39563108,0.96,67,3,70,606745
chr1,39563197,0.96,79,3,82,606746
chr1,39563214,0.98,80,2,82,606747
chr1,39563485,0.81,69,16,85,606748
chr1,39563538,0.83,58,12,70,606749
chr1,39563919,0.96,70,3,73,606750
chr1,39564158,0.08,7,76,83,606751
chr1,39564202,0.05,5,91,96,606752
chr1,39564207,0.04,4,87,91,606753
chr1,39564222,0.11,8,64,72,606754
chr1,39564310,0,0,72,72,606755
chr1,39564317,0,0,72,72,606756
chr1,39564349,0.02,1,45,46,606757
chr1,39564544,0.08,6,68,74,606758
chr1,39564890,0.58,35,25,60,606759
chr1,39564930,0.99,80,1,81,606760
chr1,39564984,0.89,85,11,96,606761
chr1,39564988,0.89,93,11,104,606762
chr1,39565017,0.86,82,13,95,606763
chr1,39565019,0.8,73,18,91,606764
chr1,39565048,0.92,68,6,74,606765
chr1,39565075,0.97,56,2,58,606766
chr1,39565118,0.88,76,10,86,606767
chr1,39565615,0.96,74,3,77,606768
chr1,39565663,0.92,65,6,71,606769
chr1,39565685,0.95,80,4,84,606770
chr1,39565748,0.93,79,6,85,606771
chr1,39565798,0.98,79,2,81,606772
chr1,39565865,0.9,74,8,82,606773
chr1,39565894,0.75,71,24,95,606774
chr1,39565931,0.71,80,33,113,606775
chr1,39566247,0.9,76,8,84,606776
chr1,39566253,0.94,75,5,80,606777
chr1,39566296,1,78,0,78,606778
chr1,39566362,0.89,88,11,99,606779
chr1,39566382,0.94,93,6,99,606780
chr1,39566398,0.97,90,3,93,606781
chr1,39566418,0.96,82,3,85,606782
chr1,39566482,0.96,48,2,50,606783
chr1,39566520,0.81,44,10,54,606784
chr1,39566581,0.96,75,3,78,606785
chr1,39566583,1,78,0,78,606786
chr1,39566585,0.99,75,1,76,606787
chr1,39566587,0.93,71,5,76,606788
chr1,39566670,0.95,59,3,62,606789
chr1,39566684,0.97,60,2,62,606790
chr1,39566756,0.96,71,3,74,606791
chr1,39566766,0.92,68,6,74,606792
chr1,39566794,0.99,74,1,75,606793
chr1,39566901,0.93,43,3,46,606794
chr1,39566977,0.92,12,1,13,606795
chr1,39567090,1,36,0,36,606796
chr1,39567118,0.97,57,2,59,606797
chr1,39567152,0.85,55,10,65,606798
chr1,39567224,0.98,47,1,48,606799
chr1,39567278,0.89,42,5,47,606800
chr1,39567364,0.89,48,6,54,606801
chr1,39567368,0.98,52,1,53,606802
chr1,39567388,0.83,52,11,63,606803
chr1,39567412,1,68,0,68,606804
chr1,39567420,0.95,70,4,74,606805
chr1,39567444,0.97,66,2,68,606806
chr1,39567452,0.94,58,4,62,606807
chr1,39567485,0.96,46,2,48,606808
chr1,39567574,0.92,49,4,53,606809
chr1,39567576,0.98,49,1,50,606810
chr1,39567584,0.94,44,3,47,606811
chr1,39567586,1,49,0,49,606812
chr1,39567614,0.94,33,2,35,606813
chr1,39567619,0.97,32,1,33,606814
chr1,39567623,1,31,0,31,606815
chr1,39567630,1,30,0,30,606816
chr1,39567644,1,18,0,18,606817
chr1,39567675,0.67,6,3,9,606818
chr1,39567704,0.91,10,1,11,606819
chr1,39567708,0.92,11,1,12,606820
chr1,39567716,0.88,15,2,17,606821
chr1,39567720,1,16,0,16,606822
chr1,39567740,0.53,16,14,30,606823
chr1,39567764,0.89,33,4,37,606824
chr1,39567773,0.89,41,5,46,606825
chr1,39567780,1,48,0,48,606826
chr1,39567797,0.95,54,3,57,606827
chr1,39567803,0.98,58,1,59,606828
chr1,39567805,1,57,0,57,606829
chr1,39567827,0.91,42,4,46,606830
chr1,39567841,0.77,43,13,56,606831
chr1,39567915,0.68,45,21,66,606832
chr1,39567987,0.92,91,8,99,606833
chr1,39568018,0.58,52,38,90,606834
chr1,39568106,0.43,20,27,47,606835
chr1,39568216,0.03,3,86,89,606836
chr1,39568235,0.33,24,49,73,606837
chr1,39568254,0.14,7,43,50,606838
chr1,39568384,0.02,1,48,49,606839
chr1,39568499,0.01,1,66,67,606840
chr1,39568545,0.08,5,60,65,606841
chr1,39568595,0.56,35,27,62,606842
chr1,39568852,0.94,44,3,47,606843
chr1,39568881,0.93,42,3,45,606844
chr1,39568967,0.97,87,3,90,606845
chr1,39568969,0.96,87,4,91,606846
chr1,39569079,0.87,68,10,78,606847
chr1,39569201,0.88,67,9,76,606848
chr1,39569248,0.96,85,4,89,606849
chr1,39569373,0.63,52,30,82,606850
chr1,39569571,0.96,64,3,67,606851
chr1,39569578,0.97,66,2,68,606852
chr1,39569887,1,74,0,74,606853
chr1,39569896,0.91,68,7,75,606854
chr1,39569946,1,55,0,55,606855
chr1,39569983,0.94,51,3,54,606856
chr1,39570175,0.42,39,53,92,606857
chr1,39570323,0.05,5,90,95,606858
chr1,39570329,0.05,5,88,93,606859
chr1,39570403,0.06,6,101,107,606860
chr1,39570451,0.07,7,96,103,606861
chr1,39570479,0.06,5,83,88,606862
chr1,39570521,0.04,4,87,91,606863
chr1,39570530,0.05,4,81,85,606864
chr1,39570532,0.05,4,84,88,606865
chr1,39570557,0.01,1,91,92,606866
chr1,39570613,0.04,2,54,56,606867
chr1,39570624,0.06,3,48,51,606868
chr1,39570666,0.03,1,35,36,606869
chr1,39570672,0,0,64,64,606870
chr1,39570675,0,0,56,56,606871
chr1,39570678,0,0,54,54,606872
chr1,39570688,0,0,59,59,606873
chr1,39570704,0,0,41,41,606874
chr1,39570708,0,0,38,38,606875
chr1,39570721,0,0,55,55,606876
chr1,39570726,0.02,1,59,60,606877
chr1,39570739,0,0,62,62,606878
chr1,39570743,0,0,61,61,606879
chr1,39570747,0,0,54,54,606880
chr1,39570768,0,0,58,58,606881
chr1,39570770,0,0,57,57,606882
chr1,39570772,0.02,1,53,54,606883
chr1,39570789,0.04,2,52,54,606884
chr1,39570798,0,0,54,54,606885
chr1,39570800,0,0,58,58,606886
chr1,39570807,0,0,53,53,606887
chr1,39570815,0,0,42,42,606888
chr1,39570817,0,0,27,27,606889
chr1,39570824,0,0,52,52,606890
chr1,39570829,0,0,49,49,606891
chr1,39570841,0.04,2,49,51,606892
chr1,39570846,0.02,1,46,47,606893
chr1,39570850,0,0,40,40,606894
chr1,39570857,0,0,36,36,606895
chr1,39570876,0,0,44,44,606896
chr1,39570889,0,0,39,39,606897
chr1,39570899,0,0,38,38,606898
chr1,39570903,0,0,34,34,606899
chr1,39570916,0,0,30,30,606900
chr1,39570924,0,0,30,30,606901
chr1,39570927,0,0,38,38,606902
chr1,39570934,0,0,37,37,606903
chr1,39570940,0,0,8,8,606904
chr1,39570943,0,0,18,18,606905
chr1,39570956,0,0,12,12,606906
chr1,39570963,0,0,31,31,606907
chr1,39570968,0,0,28,28,606908
chr1,39570977,0.04,1,23,24,606909
chr1,39570996,0.06,2,29,31,606910
chr1,39571002,0,0,31,31,606911
chr1,39571005,0,0,30,30,606912
chr1,39571009,0,0,37,37,606913
chr1,39571012,0,0,38,38,606914
chr1,39571021,0,0,33,33,606915
chr1,39571023,0,0,35,35,606916
chr1,39571026,0.05,2,41,43,606917
chr1,39571031,0,0,13,13,606918
chr1,39571047,0,0,20,20,606919
chr1,39571053,0.03,1,37,38,606920
chr1,39571066,0.02,1,42,43,606921
chr1,39571068,0,0,41,41,606922
chr1,39571074,0,0,42,42,606923
chr1,39571076,0,0,39,39,606924
chr1,39571081,0,0,41,41,606925
chr1,39571087,0,0,40,40,606926
chr1,39571090,0,0,31,31,606927
chr1,39571095,0,0,25,25,606928
chr1,39571097,0,0,32,32,606929
chr1,39571101,0,0,29,29,606930
chr1,39571106,0.03,1,37,38,606931
chr1,39571112,0,0,29,29,606932
chr1,39571116,0,0,31,31,606933
chr1,39571128,0,0,21,21,606934
chr1,39571133,0.05,1,18,19,606935
chr1,39571135,0,0,27,27,606936
chr1,39571142,0,0,35,35,606937
chr1,39571147,0,0,37,37,606938
chr1,39571151,0,0,25,25,606939
chr1,39571156,0,0,25,25,606940
chr1,39571160,0,0,22,22,606941
chr1,39571164,0,0,31,31,606942
chr1,39571167,0,0,30,30,606943
chr1,39571174,0,0,22,22,606944
chr1,39571180,0,0,15,15,606945
chr1,39571183,0,0,30,30,606946
chr1,39571186,0,0,32,32,606947
chr1,39571189,0,0,38,38,606948
chr1,39571200,0,0,37,37,606949
chr1,39571212,0,0,45,45,606950
chr1,39571224,0.03,1,29,30,606951
chr1,39571227,0,0,37,37,606952
chr1,39571230,0,0,42,42,606953
chr1,39571238,0,0,44,44,606954
chr1,39571240,0,0,44,44,606955
chr1,39571242,0,0,44,44,606956
chr1,39571254,0,0,46,46,606957
chr1,39571264,0,0,44,44,606958
chr1,39571271,0,0,44,44,606959
chr1,39571274,0,0,39,39,606960
chr1,39571282,0,0,32,32,606961
chr1,39571287,0,0,31,31,606962
chr1,39571291,0.04,1,23,24,606963
chr1,39571301,0,0,37,37,606964
chr1,39571307,0,0,37,37,606965
chr1,39571312,0,0,39,39,606966
chr1,39571324,0,0,37,37,606967
chr1,39571332,0,0,32,32,606968
chr1,39571352,0.03,1,33,34,606969
chr1,39571360,0,0,26,26,606970
chr1,39571364,0,0,33,33,606971
chr1,39571380,0,0,24,24,606972
chr1,39571397,0,0,31,31,606973
chr1,39571408,0,0,30,30,606974
chr1,39571411,0,0,22,22,606975
chr1,39571421,0,0,33,33,606976
chr1,39571423,0.03,1,32,33,606977
chr1,39571428,0,0,30,30,606978
chr1,39571431,0,0,22,22,606979
chr1,39571436,0,0,34,34,606980
chr1,39571445,0,0,39,39,606981
chr1,39571451,0,0,36,36,606982
chr1,39571455,0,0,32,32,606983
chr1,39571460,0.03,1,35,36,606984
chr1,39571463,0.03,1,28,29,606985
chr1,39571478,0,0,20,20,606986
chr1,39571482,0.05,2,38,40,606987
chr1,39571486,0,0,31,31,606988
chr1,39571492,0,0,31,31,606989
chr1,39571501,0,0,56,56,606990
chr1,39571503,0,0,50,50,606991
chr1,39571505,0,0,55,55,606992
chr1,39571533,0,0,63,63,606993
chr1,39571569,0,0,68,68,606994
chr1,39571576,0.02,1,42,43,606995
chr1,39571582,0,0,70,70,606996
chr1,39571591,0,0,65,65,606997
chr1,39571594,0.02,1,51,52,606998
chr1,39571596,0,0,54,54,606999
chr1,39571605,0.02,1,42,43,607000
chr1,39571633,0.02,1,65,66,607001
chr1,39571653,0,0,40,40,607002
chr1,39571663,0.05,2,40,42,607003
chr1,39571678,0,0,49,49,607004
chr1,39571682,0,0,43,43,607005
chr1,39571685,0,0,46,46,607006
chr1,39571725,0,0,17,17,607007
chr1,39571727,0,0,20,20,607008
chr1,39571741,0,0,33,33,607009
chr1,39571757,0,0,33,33,607010
chr1,39571779,0.03,1,35,36,607011
chr1,39571795,0,0,32,32,607012
chr1,39571797,0,0,30,30,607013
chr1,39571813,0,0,19,19,607014
chr1,39571838,0,0,30,30,607015
chr1,39571847,0,0,22,22,607016
chr1,39571849,0,0,24,24,607017
chr1,39571858,0.04,1,25,26,607018
chr1,39571885,0.04,1,27,28,607019
chr1,39571902,0,0,24,24,607020
chr1,39571932,0,0,20,20,607021
chr1,39571957,0,0,29,29,607022
chr1,39572026,0,0,48,48,607023
chr1,39572053,0,0,58,58,607024
chr1,39572085,0,0,68,68,607025
chr1,39572184,0,0,71,71,607026
chr1,39572222,0.01,1,73,74,607027
chr1,39572267,0.01,1,79,80,607028
chr1,39572287,0.01,1,70,71,607029
chr1,39572323,0,0,62,62,607030
chr1,39572399,0,0,56,56,607031
chr1,39572455,0,0,24,24,607032
chr1,39572549,0.13,7,46,53,607033
chr1,39572816,0.06,5,84,89,607034
chr1,39572821,0.14,13,78,91,607035
chr1,39572915,0.39,30,46,76,607036
chr1,39573146,0.02,1,53,54,607037
chr1,39573157,0.04,2,46,48,607038
chr1,39573164,0.07,3,42,45,607039
chr1,39573185,0.06,3,49,52,607040
chr1,39573219,0.14,8,49,57,607041
chr1,39573253,0.08,5,61,66,607042
chr1,39573309,0.21,18,68,86,607043
chr1,39573404,0.23,18,61,79,607044
chr1,39574205,0,0,16,16,607045
chr1,39574245,0.13,5,35,40,607046
chr1,39574273,0.35,20,37,57,607047
chr1,39574275,0.42,23,32,55,607048
chr1,39574282,0.43,25,33,58,607049
chr1,39574285,0.54,33,28,61,607050
chr1,39574613,0.56,53,42,95,607051
chr1,39574731,0.76,90,28,118,607052
chr1,39575004,0.85,44,8,52,607053
chr1,39575090,0.96,74,3,77,607054
chr1,39575226,0.81,47,11,58,607055
chr1,39575326,0.6,58,38,96,607056
chr1,39575659,0.97,69,2,71,607057
chr1,39575836,0.96,102,4,106,607058
chr1,39576199,0.04,4,108,112,607059
chr1,39576458,0.06,6,87,93,607060
chr1,39576486,0.03,3,84,87,607061
chr1,39576807,0.03,3,96,99,607062
chr1,39576960,0.89,57,7,64,607063
chr1,39576992,0.97,64,2,66,607064
chr1,39577077,0.91,48,5,53,607065
chr1,39577117,0.93,40,3,43,607066
chr1,39577123,0.98,43,1,44,607067
chr1,39577140,0.97,34,1,35,607068
chr1,39577155,0.92,33,3,36,607069
chr1,39577179,0.97,34,1,35,607070
chr1,39577199,1,49,0,49,607071
chr1,39577214,0.98,53,1,54,607072
chr1,39577254,0.94,32,2,34,607073
chr1,39577274,1,30,0,30,607074
chr1,39577288,1,21,0,21,607075
chr1,39577299,0.89,24,3,27,607076
chr1,39577332,0.95,39,2,41,607077
chr1,39577342,0.98,46,1,47,607078
chr1,39577408,0.97,66,2,68,607079
chr1,39577450,0.95,58,3,61,607080
chr1,39577789,0.86,38,6,44,607081
chr1,39577915,0.97,113,3,116,607082
chr1,39577948,0.94,120,7,127,607083
chr1,39578007,0.96,107,5,112,607084
chr1,39578125,0.97,66,2,68,607085
chr1,39578152,0.84,58,11,69,607086
chr1,39578226,0.61,60,39,99,607087
chr1,39578569,0.98,51,1,52,607088
chr1,39578711,0.97,75,2,77,607089
chr1,39579094,0.85,86,15,101,607090
chr1,39579108,0.89,91,11,102,607091
chr1,39579435,0.92,79,7,86,607092
chr1,39579473,0.95,79,4,83,607093
chr1,39579528,0.97,75,2,77,607094
chr1,39579622,0.98,53,1,54,607095
chr1,39579702,0.96,46,2,48,607096
chr1,39579727,0.7,42,18,60,607097
chr1,39579966,0.92,79,7,86,607098
chr1,39580030,0.98,90,2,92,607099
chr1,39580181,0.94,101,7,108,607100
chr1,39580219,0.96,99,4,103,607101
chr1,39580281,0.96,98,4,102,607102
chr1,39580893,0.9,72,8,80,607103
chr1,39581123,0.45,50,60,110,607104
chr1,39581197,0.52,62,58,120,607105
chr1,39581231,0.99,112,1,113,607106
chr1,39581235,0.95,103,5,108,607107
chr1,39581841,0.9,104,11,115,607108
chr1,39582079,0.34,16,31,47,607109
chr1,39582205,0.96,94,4,98,607110
chr1,39582998,0.95,94,5,99,607111
chr1,39583026,0.74,81,28,109,607112
chr1,39583048,0.82,93,21,114,607113
chr1,39583487,0.99,86,1,87,607114
chr1,39583880,0.07,5,67,72,607115
chr1,39584356,0.73,75,28,103,607116
chr1,39584452,0.95,69,4,73,607117
chr1,39584477,0.84,54,10,64,607118
chr1,39584528,0.96,53,2,55,607119
chr1,39584718,0.84,86,16,102,607120
chr1,39584761,0.98,81,2,83,607121
chr1,39584797,0.98,78,2,80,607122
chr1,39584819,0.97,77,2,79,607123
chr1,39584849,0.9,76,8,84,607124
chr1,39584903,0.98,39,1,40,607125
chr1,39584913,0.97,33,1,34,607126
chr1,39584920,1,26,0,26,607127
chr1,39584929,0.88,15,2,17,607128
chr1,39584937,1,11,0,11,607129
chr1,39584943,1,7,0,7,607130
chr1,39584976,1,1,0,1,607131
chr1,39584984,1,1,0,1,607132
chr1,39585297,0.4,25,38,63,607133
chr1,39585393,0.68,67,32,99,607134
chr1,39585415,0.93,78,6,84,607135
chr1,39585624,0.97,69,2,71,607136
chr1,39585632,0.99,71,1,72,607137
chr1,39585658,0.92,89,8,97,607138
chr1,39585704,0.99,86,1,87,607139
chr1,39585712,0.98,86,2,88,607140
chr1,39585744,0.96,73,3,76,607141
chr1,39585814,0.97,65,2,67,607142
chr1,39585835,0.96,74,3,77,607143
chr1,39585845,0.98,81,2,83,607144
chr1,39586097,1,90,0,90,607145
chr1,39586161,0.97,99,3,102,607146
chr1,39586255,0.99,84,1,85,607147
chr1,39586269,1,91,0,91,607148
chr1,39586280,0.98,91,2,93,607149
chr1,39586329,0.97,106,3,109,607150
chr1,39586631,0.89,80,10,90,607151
chr1,39586912,0.97,93,3,96,607152
chr1,39586962,0.93,100,7,107,607153
chr1,39587096,0.99,67,1,68,607154
chr1,39587176,0.98,62,1,63,607155
chr1,39587190,0.96,65,3,68,607156
chr1,39587206,1,76,0,76,607157
chr1,39587213,1,79,0,79,607158
chr1,39587263,0.99,79,1,80,607159
chr1,39587265,1,79,0,79,607160
chr1,39587308,0.95,78,4,82,607161
chr1,39587316,0.99,87,1,88,607162
chr1,39587362,1,75,0,75,607163
chr1,39587366,1,78,0,78,607164
chr1,39587399,0.97,66,2,68,607165
chr1,39587409,0.97,67,2,69,607166
chr1,39587411,0.98,65,1,66,607167
chr1,39587573,0.97,72,2,74,607168
chr1,39587760,0.99,74,1,75,607169
chr1,39587813,0.94,79,5,84,607170
chr1,39587987,0.98,53,1,54,607171
chr1,39587989,0.98,53,1,54,607172
chr1,39587995,0.98,56,1,57,607173
chr1,39588050,0.97,76,2,78,607174
chr1,39588204,0.92,58,5,63,607175
chr1,39588220,0.97,72,2,74,607176
chr1,39588240,0.98,84,2,86,607177
chr1,39588319,0.98,87,2,89,607178
chr1,39588471,0.95,63,3,66,607179
chr1,39588575,0.9,75,8,83,607180
chr1,39588910,1,16,0,16,607181
chr1,39588942,0.93,28,2,30,607182
chr1,39588982,1,59,0,59,607183
chr1,39588989,0.92,54,5,59,607184
chr1,39589040,0.95,74,4,78,607185
chr1,39589099,0.94,66,4,70,607186
chr1,39589126,0.96,70,3,73,607187
chr1,39589131,0.96,71,3,74,607188
chr1,39589304,0.91,68,7,75,607189
chr1,39589358,0.81,46,11,57,607190
chr1,39589372,0.91,43,4,47,607191
chr1,39589413,0.79,26,7,33,607192
chr1,39589488,0.92,72,6,78,607193
chr1,39589541,0.94,88,6,94,607194
chr1,39589655,0.98,62,1,63,607195
chr1,39589679,0.91,49,5,54,607196
chr1,39589691,0.94,45,3,48,607197
chr1,39589707,0.63,24,14,38,607198
chr1,39589800,0.97,60,2,62,607199
chr1,39589877,0.96,96,4,100,607200
chr1,39589889,0.89,96,12,108,607201
chr1,39590287,0.93,54,4,58,607202
chr1,39590492,0.94,77,5,82,607203
chr1,39590720,0.97,93,3,96,607204
chr1,39590824,0.86,97,16,113,607205
chr1,39591048,0.92,72,6,78,607206
chr1,39591112,0.96,91,4,95,607207
chr1,39591160,0.92,84,7,91,607208
chr1,39591191,0.92,67,6,73,607209
chr1,39591243,0.99,82,1,83,607210
chr1,39591438,0.97,57,2,59,607211
chr1,39591443,0.95,55,3,58,607212
chr1,39591467,0.96,53,2,55,607213
chr1,39591525,0.94,63,4,67,607214
chr1,39591537,0.92,71,6,77,607215
chr1,39591579,0.97,87,3,90,607216
chr1,39591589,0.92,93,8,101,607217
chr1,39591596,0.98,103,2,105,607218
chr1,39591621,0.97,109,3,112,607219
chr1,39591643,0.95,106,5,111,607220
chr1,39591649,0.99,106,1,107,607221
chr1,39591682,0.36,42,74,116,607222
chr1,39591779,0.95,105,6,111,607223
chr1,39591840,0.99,91,1,92,607224
chr1,39591973,0.99,74,1,75,607225
chr1,39592053,0.94,74,5,79,607226
chr1,39592181,0.97,73,2,75,607227
chr1,39592187,0.93,74,6,80,607228
chr1,39592254,1,85,0,85,607229
chr1,39592272,0.89,71,9,80,607230
chr1,39592319,0.98,61,1,62,607231
chr1,39592399,0.9,46,5,51,607232
chr1,39592625,0.9,63,7,70,607233
chr1,39592715,0.91,69,7,76,607234
chr1,39592723,0.75,59,20,79,607235
chr1,39592766,0.82,71,16,87,607236
chr1,39592850,0.82,45,10,55,607237
chr1,39592860,0.82,51,11,62,607238
chr1,39592879,0.75,51,17,68,607239
chr1,39592988,0.8,57,14,71,607240
chr1,39593006,0.64,44,25,69,607241
chr1,39594112,1,94,0,94,607242
chr1,39594184,0.83,69,14,83,607243
chr1,39594195,0.85,60,11,71,607244
chr1,39594231,1,48,0,48,607245
chr1,39594239,1,45,0,45,607246
chr1,39594243,0.98,41,1,42,607247
chr1,39594263,0.93,40,3,43,607248
chr1,39594287,0.96,24,1,25,607249
chr1,39594319,0.81,17,4,21,607250
chr1,39594327,0.96,24,1,25,607251
chr1,39594365,0.95,18,1,19,607252
chr1,39594576,0.89,108,14,122,607253
chr1,39594583,0.92,104,9,113,607254
chr1,39594788,0.8,76,19,95,607255
chr1,39594869,0.74,98,35,133,607256
chr1,39595053,0.82,71,16,87,607257
chr1,39595781,0.64,23,13,36,607258
chr1,39595794,0.71,27,11,38,607259
chr1,39596243,0.68,49,23,72,607260
chr1,39596444,0.18,11,49,60,607261
chr1,39596530,0.34,15,29,44,607262
chr1,39596582,0.58,38,27,65,607263
chr1,39596599,1,75,0,75,607264
chr1,39596606,0.86,70,11,81,607265
chr1,39596616,0.98,84,2,86,607266
chr1,39596638,0.92,83,7,90,607267
chr1,39596667,0.77,72,22,94,607268
chr1,39596712,0.78,59,17,76,607269
chr1,39596815,1,23,0,23,607270
chr1,39596819,0.89,17,2,19,607271
chr1,39596938,0.97,76,2,78,607272
chr1,39597236,0.97,83,3,86,607273
chr1,39597652,0.93,89,7,96,607274
chr1,39597663,0.91,95,9,104,607275
chr1,39598097,0.24,16,51,67,607276
chr1,39598246,0.1,10,88,98,607277
chr1,39598559,0.24,17,53,70,607278
chr1,39598634,0.51,47,45,92,607279
chr1,39598683,0.31,29,64,93,607280
chr1,39598712,0.12,13,93,106,607281
chr1,39598859,0.14,11,68,79,607282
chr1,39598927,0.35,19,36,55,607283
chr1,39598930,0.2,13,51,64,607284
chr1,39598977,0.08,6,70,76,607285
chr1,39599187,0.46,17,20,37,607286
chr1,39599432,0.91,97,10,107,607287
chr1,39599617,0.95,83,4,87,607288
chr1,39599649,0.98,60,1,61,607289
chr1,39599743,0.96,22,1,23,607290
chr1,39599752,0.95,21,1,22,607291
chr1,39599773,0.93,28,2,30,607292
chr1,39599798,1,26,0,26,607293
chr1,39599805,0.92,24,2,26,607294
chr1,39599837,0.83,10,2,12,607295
chr1,39599857,1,9,0,9,607296
chr1,39599861,1,7,0,7,607297
chr1,39599869,1,4,0,4,607298
chr1,39599873,1,1,0,1,607299
chr1,39599939,1,7,0,7,607300
chr1,39599953,0.94,15,1,16,607301
chr1,39599960,0.95,20,1,21,607302
chr1,39599969,0.76,19,6,25,607303
chr1,39600007,0.96,45,2,47,607304
chr1,39600013,0.95,53,3,56,607305
chr1,39600359,0.96,89,4,93,607306
chr1,39600433,0.99,90,1,91,607307
chr1,39600541,0.94,73,5,78,607308
chr1,39600944,0.96,67,3,70,607309
chr1,39600981,0.97,62,2,64,607310
chr1,39600988,0.98,61,1,62,607311
chr1,39601004,0.97,65,2,67,607312
chr1,39601043,0.92,73,6,79,607313
chr1,39601140,0.95,114,6,120,607314
chr1,39601161,0.97,116,4,120,607315
chr1,39601201,0.95,103,5,108,607316
chr1,39601205,0.93,103,8,111,607317
chr1,39601249,0.97,98,3,101,607318
chr1,39601583,0.52,39,36,75,607319
chr1,39601631,0.97,63,2,65,607320
chr1,39601635,0.73,45,17,62,607321
chr1,39601846,0.48,35,38,73,607322
chr1,39602239,0.87,65,10,75,607323
chr1,39602504,0.33,40,82,122,607324
chr1,39602546,0.48,58,64,122,607325
chr1,39602786,0.46,32,38,70,607326
chr1,39602804,0.9,63,7,70,607327
chr1,39602898,0.93,77,6,83,607328
chr1,39602961,0.94,76,5,81,607329
chr1,39602993,0.92,78,7,85,607330
chr1,39603021,0.9,85,9,94,607331
chr1,39603078,0.97,97,3,100,607332
chr1,39603121,0.84,87,17,104,607333
chr1,39603226,0.92,92,8,100,607334
chr1,39603471,0.96,82,3,85,607335
chr1,39603511,0.97,85,3,88,607336
chr1,39603535,0.96,79,3,82,607337
chr1,39603537,0.96,79,3,82,607338
chr1,39603602,0.97,62,2,64,607339
chr1,39603616,0.9,57,6,63,607340
chr1,39603677,1,60,0,60,607341
chr1,39603694,0.9,47,5,52,607342
chr1,39603731,0.93,25,2,27,607343
chr1,39603883,0.89,68,8,76,607344
chr1,39603981,0.99,72,1,73,607345
chr1,39603983,0.97,66,2,68,607346
chr1,39603993,1,66,0,66,607347
chr1,39604021,1,48,0,48,607348
chr1,39604051,1,48,0,48,607349
chr1,39604113,0.98,63,1,64,607350
chr1,39604125,0.95,54,3,57,607351
chr1,39604173,1,57,0,57,607352
chr1,39604188,1,46,0,46,607353
chr1,39604211,1,44,0,44,607354
chr1,39604213,1,42,0,42,607355
chr1,39604235,1,40,0,40,607356
chr1,39604381,1,81,0,81,607357
chr1,39604397,1,79,0,79,607358
chr1,39604422,0.99,71,1,72,607359
chr1,39604497,1,29,0,29,607360
chr1,39604556,0.95,20,1,21,607361
chr1,39604616,0.99,66,1,67,607362
chr1,39604626,0.95,75,4,79,607363
chr1,39604628,0.94,77,5,82,607364
chr1,39604723,0.95,75,4,79,607365
chr1,39604857,0.93,74,6,80,607366
chr1,39604994,1,39,0,39,607367
chr1,39605002,0.95,41,2,43,607368
chr1,39605031,0.95,63,3,66,607369
chr1,39605085,0.84,57,11,68,607370
chr1,39605875,0.97,72,2,74,607371
chr1,39605902,0.97,85,3,88,607372
chr1,39605986,0.86,99,16,115,607373
chr1,39606122,0.88,82,11,93,607374
chr1,39606207,0.96,68,3,71,607375
chr1,39606302,0.97,73,2,75,607376
chr1,39606316,0.92,70,6,76,607377
chr1,39606326,0.92,66,6,72,607378
chr1,39606363,1,87,0,87,607379
chr1,39606370,0.98,85,2,87,607380
chr1,39606415,0.98,102,2,104,607381
chr1,39606432,0.92,107,9,116,607382
chr1,39606459,0.89,95,12,107,607383
chr1,39606518,0.97,64,2,66,607384
chr1,39606535,0.91,43,4,47,607385
chr1,39606834,0.62,75,46,121,607386
chr1,39606932,0.95,117,6,123,607387
chr1,39607243,0.92,105,9,114,607388
chr1,39607461,0.97,99,3,102,607389
chr1,39607710,0.6,33,22,55,607390
chr1,39608626,0.95,55,3,58,607391
chr1,39608675,0.98,56,1,57,607392
chr1,39608683,0.64,38,21,59,607393
chr1,39608921,0.97,104,3,107,607394
chr1,39609485,0.94,47,3,50,607395
chr1,39609507,0.96,51,2,53,607396
chr1,39609509,0.98,52,1,53,607397
chr1,39609532,0.98,63,1,64,607398
chr1,39609695,1,55,0,55,607399
chr1,39609702,1,47,0,47,607400
chr1,39609706,0.98,49,1,50,607401
chr1,39609711,0.98,45,1,46,607402
chr1,39609747,0.93,26,2,28,607403
chr1,39609750,1,23,0,23,607404
chr1,39609775,0.75,9,3,12,607405
chr1,39609815,1,26,0,26,607406
chr1,39609821,1,27,0,27,607407
chr1,39609838,1,30,0,30,607408
chr1,39609855,1,34,0,34,607409
chr1,39609941,0.94,61,4,65,607410
chr1,39609972,0.94,66,4,70,607411
chr1,39610004,0.97,61,2,63,607412
chr1,39610042,1,64,0,64,607413
chr1,39610246,0.79,68,18,86,607414
chr1,39610310,0.93,84,6,90,607415
chr1,39610515,0.98,50,1,51,607416
chr1,39610681,0.94,101,6,107,607417
chr1,39610717,0.99,87,1,88,607418
chr1,39610990,0.9,106,12,118,607419
chr1,39611250,0.93,87,7,94,607420
chr1,39611350,0.93,108,8,116,607421
chr1,39611836,0.94,65,4,69,607422
chr1,39611852,0.97,72,2,74,607423
chr1,39611935,0.94,45,3,48,607424
chr1,39611983,0.97,38,1,39,607425
chr1,39612007,0.93,43,3,46,607426
chr1,39612071,0.95,42,2,44,607427
chr1,39612181,0.97,56,2,58,607428
chr1,39612251,0.94,108,7,115,607429
chr1,39612865,0.96,82,3,85,607430
chr1,39613357,0.89,81,10,91,607431
chr1,39613546,0.09,9,87,96,607432
chr1,39614620,0.84,78,15,93,607433
chr1,39614794,0.93,87,7,94,607434
chr1,39614969,0.98,57,1,58,607435
chr1,39615001,0.98,56,1,57,607436
chr1,39615023,0.89,59,7,66,607437
chr1,39615065,0.99,75,1,76,607438
chr1,39615087,0.89,67,8,75,607439
chr1,39615123,1,73,0,73,607440
chr1,39615131,0.98,62,1,63,607441
chr1,39615138,0.98,51,1,52,607442
chr1,39615148,1,65,0,65,607443
chr1,39615154,0.98,63,1,64,607444
chr1,39615194,0.96,55,2,57,607445
chr1,39615288,0.93,71,5,76,607446
chr1,39615334,0.95,58,3,61,607447
chr1,39615764,0.99,69,1,70,607448
chr1,39615834,0.95,92,5,97,607449
chr1,39615880,0.98,82,2,84,607450
chr1,39615928,0.98,86,2,88,607451
chr1,39615933,0.98,89,2,91,607452
chr1,39615980,0.86,76,12,88,607453
chr1,39616253,0.97,75,2,77,607454
chr1,39616520,0.65,83,45,128,607455
chr1,39616663,0.21,23,87,110,607456
chr1,39616910,0.95,87,5,92,607457
chr1,39616931,0.73,63,23,86,607458
chr1,39617033,0.8,44,11,55,607459
chr1,39617089,0.8,45,11,56,607460
chr1,39617183,0.9,60,7,67,607461
chr1,39617668,0.95,62,3,65,607462
chr1,39617707,0.98,45,1,46,607463
chr1,39617749,0.97,28,1,29,607464
chr1,39617887,0.98,86,2,88,607465
chr1,39617940,0.89,84,10,94,607466
chr1,39617943,0.98,86,2,88,607467
chr1,39618202,0.61,54,34,88,607468
chr1,39618273,0.31,32,70,102,607469
chr1,39618402,0.05,5,104,109,607470
chr1,39618749,0.63,38,22,60,607471
chr1,39619171,0.11,9,72,81,607472
chr1,39619187,0.32,28,59,87,607473
chr1,39619237,0.76,60,19,79,607474
chr1,39619259,0.76,57,18,75,607475
chr1,39619310,0.9,73,8,81,607476
chr1,39619385,0.38,38,62,100,607477
chr1,39619522,0.84,74,14,88,607478
chr1,39619932,0.79,81,22,103,607479
chr1,39619942,0.95,105,5,110,607480
chr1,39619962,0.94,111,7,118,607481
chr1,39619968,0.89,104,13,117,607482
chr1,39619990,0.98,117,2,119,607483
chr1,39620146,0.84,78,15,93,607484
chr1,39620267,0.75,56,19,75,607485
chr1,39620273,0.92,65,6,71,607486
chr1,39620300,0.36,25,44,69,607487
chr1,39620566,0.13,8,53,61,607488
chr1,39620625,0.04,3,67,70,607489
chr1,39621057,0.41,36,52,88,607490
chr1,39621454,0.16,10,53,63,607491
chr1,39621477,0.75,42,14,56,607492
chr1,39621483,0.26,16,45,61,607493
chr1,39621546,0.66,35,18,53,607494
chr1,39621598,0.93,26,2,28,607495
chr1,39621620,0.96,23,1,24,607496
chr1,39621622,0.96,23,1,24,607497
chr1,39621645,0.97,32,1,33,607498
chr1,39621652,0.97,36,1,37,607499
chr1,39621704,1,47,0,47,607500
chr1,39621708,0.98,45,1,46,607501
chr1,39621714,1,45,0,45,607502
chr1,39621760,1,25,0,25,607503
chr1,39621768,0.91,21,2,23,607504
chr1,39621782,1,16,0,16,607505
chr1,39621789,1,14,0,14,607506
chr1,39621793,1,16,0,16,607507
chr1,39621798,0.94,17,1,18,607508
chr1,39621826,1,28,0,28,607509
chr1,39621836,1,32,0,32,607510
chr1,39621900,0.97,29,1,30,607511
chr1,39622029,1,81,0,81,607512
chr1,39622088,0.91,71,7,78,607513
chr1,39622146,0.98,78,2,80,607514
chr1,39622205,0.98,64,1,65,607515
chr1,39622431,0.97,73,2,75,607516
chr1,39622702,0.95,41,2,43,607517
chr1,39622884,1,50,0,50,607518
chr1,39623481,0.98,83,2,85,607519
chr1,39623525,0.84,78,15,93,607520
chr1,39623568,0.92,89,8,97,607521
chr1,39623854,0.95,84,4,88,607522
chr1,39624077,0.04,4,88,92,607523
chr1,39624368,0.55,29,24,53,607524
chr1,39624431,0.67,47,23,70,607525
chr1,39624453,0.67,39,19,58,607526
chr1,39624492,0.06,5,76,81,607527
chr1,39624541,0.11,8,62,70,607528
chr1,39624558,0.12,9,69,78,607529
chr1,39624636,0.16,14,72,86,607530
chr1,39624646,0.18,16,74,90,607531
chr1,39624736,0.56,63,50,113,607532
chr1,39624814,0.67,74,36,110,607533
chr1,39624920,0.68,58,27,85,607534
chr1,39625708,0.95,80,4,84,607535
chr1,39625722,0.94,73,5,78,607536
chr1,39625728,0.99,74,1,75,607537
chr1,39625766,0.94,61,4,65,607538
chr1,39626789,0.16,16,86,102,607539
chr1,39626909,0.09,9,89,98,607540
chr1,39627253,0.75,27,9,36,607541
chr1,39627266,0.89,39,5,44,607542
chr1,39627309,0.96,54,2,56,607543
chr1,39627313,1,48,0,48,607544
chr1,39627323,0.9,47,5,52,607545
chr1,39627365,0.98,51,1,52,607546
chr1,39627399,0.97,28,1,29,607547
chr1,39627407,1,27,0,27,607548
chr1,39627411,0.96,22,1,23,607549
chr1,39627463,1,28,0,28,607550
chr1,39627493,1,43,0,43,607551
chr1,39627517,1,47,0,47,607552
chr1,39627525,0.98,43,1,44,607553
chr1,39627585,0.74,34,12,46,607554
chr1,39627601,0.81,38,9,47,607555
chr1,39627758,1,72,0,72,607556
chr1,39627765,0.89,67,8,75,607557
chr1,39627870,0.98,46,1,47,607558
chr1,39627920,1,37,0,37,607559
chr1,39627953,0.82,32,7,39,607560
chr1,39627969,0.9,43,5,48,607561
chr1,39627979,1,50,0,50,607562
chr1,39628165,0.15,14,80,94,607563
chr1,39628470,0.97,97,3,100,607564
chr1,39628488,0.96,87,4,91,607565
chr1,39628743,0.99,75,1,76,607566
chr1,39628746,0.91,67,7,74,607567
chr1,39628762,0.97,77,2,79,607568
chr1,39628787,0.98,79,2,81,607569
chr1,39628790,1,82,0,82,607570
chr1,39628799,1,89,0,89,607571
chr1,39628806,0.95,81,4,85,607572
chr1,39628879,0.94,87,6,93,607573
chr1,39628893,0.98,80,2,82,607574
chr1,39628937,0.94,68,4,72,607575
chr1,39628954,0.98,63,1,64,607576
chr1,39629591,0.96,81,3,84,607577
chr1,39629817,0.97,114,3,117,607578
chr1,39629856,0.96,108,4,112,607579
chr1,39630439,0.75,90,30,120,607580
chr1,39630691,0.66,80,41,121,607581
chr1,39630850,0.43,30,39,69,607582
chr1,39630927,0.34,19,37,56,607583
chr1,39631213,0.48,37,40,77,607584
chr1,39631853,1,87,0,87,607585
chr1,39631864,0.98,80,2,82,607586
chr1,39631884,0.98,78,2,80,607587
chr1,39631939,0.97,61,2,63,607588
chr1,39632145,0.92,23,2,25,607589
chr1,39632158,0.97,30,1,31,607590
chr1,39632191,0.96,43,2,45,607591
chr1,39632214,0.97,56,2,58,607592
chr1,39632231,0.98,59,1,60,607593
chr1,39632313,0.27,24,64,88,607594
chr1,39632404,0.26,26,73,99,607595
chr1,39632663,0.96,65,3,68,607596
chr1,39632702,0.96,68,3,71,607597
chr1,39632719,0.93,71,5,76,607598
chr1,39632758,0.88,68,9,77,607599
chr1,39632778,0.99,69,1,70,607600
chr1,39632790,0.95,61,3,64,607601
chr1,39632885,0.97,72,2,74,607602
chr1,39632923,0.97,64,2,66,607603
chr1,39633017,0.94,34,2,36,607604
chr1,39633100,1,45,0,45,607605
chr1,39633104,1,43,0,43,607606
chr1,39633106,0.98,40,1,41,607607
chr1,39633144,0.98,57,1,58,607608
chr1,39633153,0.97,58,2,60,607609
chr1,39633238,0.93,74,6,80,607610
chr1,39633292,0.99,88,1,89,607611
chr1,39633460,0.93,65,5,70,607612
chr1,39633500,0.86,44,7,51,607613
chr1,39633502,0.77,36,11,47,607614
chr1,39633532,0.92,24,2,26,607615
chr1,39633540,0.43,10,13,23,607616
chr1,39633796,0.38,24,39,63,607617
chr1,39634176,0.95,81,4,85,607618
chr1,39634191,0.95,78,4,82,607619
chr1,39634197,1,81,0,81,607620
chr1,39634220,1,67,0,67,607621
chr1,39634247,0.99,66,1,67,607622
chr1,39634284,0.97,57,2,59,607623
chr1,39634296,1,64,0,64,607624
chr1,39634472,0.99,93,1,94,607625
chr1,39634480,1,95,0,95,607626
chr1,39634869,0.93,119,9,128,607627
chr1,39634917,0.72,100,39,139,607628
chr1,39635476,0.9,28,3,31,607629
chr1,39635506,0.84,26,5,31,607630
chr1,39635514,0.96,26,1,27,607631
chr1,39635546,0.96,25,1,26,607632
chr1,39635570,0.89,16,2,18,607633
chr1,39635674,0.75,3,1,4,607634
chr1,39635695,1,3,0,3,607635
chr1,39635699,1,16,0,16,607636
chr1,39635732,0.92,34,3,37,607637
chr1,39635742,0.89,39,5,44,607638
chr1,39635874,0.86,83,14,97,607639
chr1,39635979,0.34,32,62,94,607640
chr1,39635987,0.72,71,28,99,607641
chr1,39636067,0.48,57,62,119,607642
chr1,39636280,0.74,57,20,77,607643
chr1,39636619,0.65,26,14,40,607644
chr1,39636648,0.94,49,3,52,607645
chr1,39636756,0.43,33,44,77,607646
chr1,39636810,0.4,28,42,70,607647
chr1,39636826,0.74,51,18,69,607648
chr1,39636923,0.31,11,25,36,607649
chr1,39637289,0.9,72,8,80,607650
chr1,39637328,0.96,66,3,69,607651
chr1,39637336,0.97,63,2,65,607652
chr1,39637364,0.97,65,2,67,607653
chr1,39637366,0.98,64,1,65,607654
chr1,39637390,0.98,60,1,61,607655
chr1,39637398,0.96,54,2,56,607656
chr1,39637422,0.93,39,3,42,607657
chr1,39637446,0.92,23,2,25,607658
chr1,39637454,1,25,0,25,607659
chr1,39637458,0.91,21,2,23,607660
chr1,39637488,1,3,0,3,607661
chr1,39637519,0.86,6,1,7,607662
chr1,39637533,1,11,0,11,607663
chr1,39637540,1,13,0,13,607664
chr1,39637544,0.93,25,2,27,607665
chr1,39637577,0.97,60,2,62,607666
chr1,39637589,0.86,63,10,73,607667
chr1,39637593,0.95,78,4,82,607668
chr1,39637706,0.78,84,24,108,607669
chr1,39638313,0.16,21,111,132,607670
chr1,39638478,0.11,8,67,75,607671
chr1,39638736,0.98,93,2,95,607672
chr1,39638740,0.96,93,4,97,607673
chr1,39638742,0.97,97,3,100,607674
chr1,39638779,1,96,0,96,607675
chr1,39638784,0.96,93,4,97,607676
chr1,39638809,1,97,0,97,607677
chr1,39638840,0.8,72,18,90,607678
chr1,39638880,1,79,0,79,607679
chr1,39638904,0.87,71,11,82,607680
chr1,39638943,0.88,49,7,56,607681
chr1,39638952,0.87,55,8,63,607682
chr1,39639385,0.06,2,30,32,607683
chr1,39639569,0.08,4,48,52,607684
chr1,39639653,0.15,8,46,54,607685
chr1,39639712,0.05,4,76,80,607686
chr1,39639722,0.05,4,74,78,607687
chr1,39640109,0.18,17,75,92,607688
chr1,39640253,0.74,65,23,88,607689
chr1,39640343,0.91,77,8,85,607690
chr1,39640365,0.79,71,19,90,607691
chr1,39640519,0.35,25,47,72,607692
chr1,39641096,0.89,71,9,80,607693
chr1,39641346,0.88,46,6,52,607694
chr1,39641399,0.96,67,3,70,607695
chr1,39641440,0.31,27,59,86,607696
chr1,39641481,0.93,74,6,80,607697
chr1,39641507,0.88,50,7,57,607698
chr1,39641650,0.96,22,1,23,607699
chr1,39641674,0.88,28,4,32,607700
chr1,39641706,0.93,41,3,44,607701
chr1,39641713,0.97,38,1,39,607702
chr1,39641738,1,28,0,28,607703
chr1,39641760,0.83,15,3,18,607704
chr1,39641768,1,16,0,16,607705
chr1,39641818,1,20,0,20,607706
chr1,39641874,0.86,36,6,42,607707
chr1,39641898,1,43,0,43,607708
chr1,39642068,0.86,49,8,57,607709
chr1,39642132,0.96,73,3,76,607710
chr1,39642681,0.96,96,4,100,607711
chr1,39642747,0.95,100,5,105,607712
chr1,39642771,0.97,94,3,97,607713
chr1,39642837,0.97,59,2,61,607714
chr1,39642868,0.98,49,1,50,607715
chr1,39642881,1,57,0,57,607716
chr1,39642893,1,62,0,62,607717
chr1,39642910,0.93,65,5,70,607718
chr1,39642951,0.96,88,4,92,607719
chr1,39642982,0.95,80,4,84,607720
chr1,39642993,0.81,63,15,78,607721
chr1,39643007,0.97,66,2,68,607722
chr1,39643040,0.98,57,1,58,607723
chr1,39643045,0.97,59,2,61,607724
chr1,39643073,0.98,58,1,59,607725
chr1,39643089,1,60,0,60,607726
chr1,39643236,0.93,76,6,82,607727
chr1,39643282,0.98,65,1,66,607728
chr1,39643411,0.96,70,3,73,607729
chr1,39643664,0.96,68,3,71,607730
chr1,39643679,0.97,74,2,76,607731
chr1,39643958,0.83,74,15,89,607732
chr1,39644212,0.09,6,58,64,607733
chr1,39644242,0.06,5,79,84,607734
chr1,39644307,0.07,8,100,108,607735
chr1,39644341,0.09,11,107,118,607736
chr1,39644546,0.7,71,30,101,607737
chr1,39644586,0.91,91,9,100,607738
chr1,39644922,0.4,35,53,88,607739
chr1,39645336,0.99,77,1,78,607740
chr1,39645412,1,66,0,66,607741
chr1,39645414,0.98,64,1,65,607742
chr1,39645452,0.98,40,1,41,607743
chr1,39645484,0.87,20,3,23,607744
chr1,39645515,0.95,35,2,37,607745
chr1,39645581,0.86,86,14,100,607746
chr1,39646023,0.79,42,11,53,607747
chr1,39646148,0.93,57,4,61,607748
chr1,39646179,0.99,66,1,67,607749
chr1,39646202,0.97,64,2,66,607750
chr1,39646236,0.98,61,1,62,607751
chr1,39646244,0.97,63,2,65,607752
chr1,39646274,0.98,61,1,62,607753
chr1,39646291,0.98,64,1,65,607754
chr1,39646347,0.98,45,1,46,607755
chr1,39646434,0.95,42,2,44,607756
chr1,39646627,0.33,27,54,81,607757
chr1,39646670,0.97,106,3,109,607758
chr1,39646722,0.99,88,1,89,607759
chr1,39646724,0.92,84,7,91,607760
chr1,39646799,0.99,73,1,74,607761
chr1,39646817,1,80,0,80,607762
chr1,39646826,1,79,0,79,607763
chr1,39646859,0.97,77,2,79,607764
chr1,39646871,0.99,73,1,74,607765
chr1,39646994,0.97,57,2,59,607766
chr1,39647181,0.69,53,24,77,607767
chr1,39647550,1,55,0,55,607768
chr1,39647562,1,55,0,55,607769
chr1,39647606,0.98,62,1,63,607770
chr1,39647620,1,67,0,67,607771
chr1,39647691,0.97,32,1,33,607772
chr1,39647715,0.94,15,1,16,607773
chr1,39647737,0.93,26,2,28,607774
chr1,39647747,0.94,29,2,31,607775
chr1,39647779,0.91,31,3,34,607776
chr1,39648568,0.98,65,1,66,607777
chr1,39648871,0.97,62,2,64,607778
chr1,39649273,0.97,70,2,72,607779
chr1,39649503,0.54,30,26,56,607780
chr1,39649937,0.96,75,3,78,607781
chr1,39649940,0.94,76,5,81,607782
chr1,39650267,1,63,0,63,607783
chr1,39650280,0.99,70,1,71,607784
chr1,39650327,0.99,78,1,79,607785
chr1,39650580,0.93,62,5,67,607786
chr1,39650689,1,61,0,61,607787
chr1,39650701,0.92,55,5,60,607788
chr1,39650729,0.95,40,2,42,607789
chr1,39650745,0.9,27,3,30,607790
chr1,39650759,1,22,0,22,607791
chr1,39650779,0.81,21,5,26,607792
chr1,39650824,1,42,0,42,607793
chr1,39650832,0.96,47,2,49,607794
chr1,39650856,0.94,58,4,62,607795
chr1,39650912,0.94,51,3,54,607796
chr1,39650942,0.96,46,2,48,607797
chr1,39650950,0.96,47,2,49,607798
chr1,39650958,0.98,41,1,42,607799
chr1,39651055,0.96,82,3,85,607800
chr1,39651311,0.65,72,38,110,607801
chr1,39651449,0.46,34,40,74,607802
chr1,39651680,0.8,44,11,55,607803
chr1,39651996,0.97,37,1,38,607804
chr1,39652007,0.98,39,1,40,607805
chr1,39652063,0.95,59,3,62,607806
chr1,39652085,0.96,71,3,74,607807
chr1,39652087,0.99,75,1,76,607808
chr1,39652095,0.98,79,2,81,607809
chr1,39652099,0.99,82,1,83,607810
chr1,39652436,0.97,65,2,67,607811
chr1,39652747,1,72,0,72,607812
chr1,39652786,0.92,70,6,76,607813
chr1,39652795,0.92,71,6,77,607814
chr1,39653141,0.82,84,18,102,607815
chr1,39653199,0.86,101,17,118,607816
chr1,39653419,0.99,80,1,81,607817
chr1,39653875,0.97,69,2,71,607818
chr1,39653969,0.99,72,1,73,607819
chr1,39654005,0.99,78,1,79,607820
chr1,39654036,1,71,0,71,607821
chr1,39654131,1,82,0,82,607822
chr1,39654278,0.82,53,12,65,607823
chr1,39654323,0.93,54,4,58,607824
chr1,39654464,0.94,51,3,54,607825
chr1,39654495,0.96,48,2,50,607826
chr1,39654557,0.97,74,2,76,607827
chr1,39654598,0.98,52,1,53,607828
chr1,39654629,0.97,35,1,36,607829
chr1,39654661,0.93,38,3,41,607830
chr1,39654689,0.96,53,2,55,607831
chr1,39654705,0.95,55,3,58,607832
chr1,39654771,0.82,68,15,83,607833
chr1,39654971,0.26,25,70,95,607834
chr1,39655700,0.08,9,104,113,607835
chr1,39655748,0.18,21,93,114,607836
chr1,39655937,0.89,25,3,28,607837
chr1,39655980,0.77,27,8,35,607838
chr1,39656094,0.78,14,4,18,607839
chr1,39656132,0.89,34,4,38,607840
chr1,39656231,0.97,67,2,69,607841
chr1,39656262,0.99,72,1,73,607842
chr1,39656280,0.95,76,4,80,607843
chr1,39656290,0.77,60,18,78,607844
chr1,39656300,0.94,67,4,71,607845
chr1,39656432,0.92,66,6,72,607846
chr1,39656487,0.96,69,3,72,607847
chr1,39656495,0.88,73,10,83,607848
chr1,39656523,0.89,72,9,81,607849
chr1,39656527,0.97,75,2,77,607850
chr1,39656572,0.99,70,1,71,607851
chr1,39656579,1,69,0,69,607852
chr1,39656619,0.94,67,4,71,607853
chr1,39657194,0.73,59,22,81,607854
chr1,39657562,0.06,4,65,69,607855
chr1,39657588,0.32,20,43,63,607856
chr1,39657620,0.6,32,21,53,607857
chr1,39657651,0.02,1,57,58,607858
chr1,39657771,0.02,1,44,45,607859
chr1,39657801,0,0,31,31,607860
chr1,39657910,0,0,96,96,607861
chr1,39657996,0,0,59,59,607862
chr1,39658110,0.03,2,76,78,607863
chr1,39658128,0.02,2,86,88,607864
chr1,39658489,0.75,61,20,81,607865
chr1,39658517,0.93,66,5,71,607866
chr1,39658522,0.94,65,4,69,607867
chr1,39658545,0.88,46,6,52,607868
chr1,39658550,0.96,46,2,48,607869
chr1,39658579,0.91,43,4,47,607870
chr1,39658610,0.64,36,20,56,607871
chr1,39658640,0.62,47,29,76,607872
chr1,39658652,0.91,62,6,68,607873
chr1,39658708,0.07,5,65,70,607874
chr1,39658732,0.02,1,54,55,607875
chr1,39658877,0.06,5,79,84,607876
chr1,39659067,0.4,23,35,58,607877
chr1,39659545,0.43,15,20,35,607878
chr1,39659724,0.95,58,3,61,607879
chr1,39659756,0.89,59,7,66,607880
chr1,39659788,0.99,75,1,76,607881
chr1,39659967,0.57,39,30,69,607882
chr1,39660086,1,37,0,37,607883
chr1,39660088,0.93,39,3,42,607884
chr1,39660118,0.68,42,20,62,607885
chr1,39660186,0.79,56,15,71,607886
chr1,39660214,0.83,43,9,52,607887
chr1,39660261,0.98,46,1,47,607888
chr1,39660294,0.64,30,17,47,607889
chr1,39660804,0.92,80,7,87,607890
chr1,39660903,0.03,3,92,95,607891
chr1,39661012,0.07,3,39,42,607892
chr1,39661363,0.03,3,95,98,607893
chr1,39661531,0.1,8,76,84,607894
chr1,39661614,0.25,20,59,79,607895
chr1,39661937,0.92,78,7,85,607896
chr1,39662198,0.78,54,15,69,607897
chr1,39662235,0.9,71,8,79,607898
chr1,39662349,0.91,83,8,91,607899
chr1,39662357,0.92,84,7,91,607900
chr1,39662661,0.03,2,67,69,607901
chr1,39663237,0.61,74,47,121,607902
chr1,39663276,0.88,84,12,96,607903
chr1,39663325,0.95,55,3,58,607904
chr1,39663536,0.95,93,5,98,607905
chr1,39663544,0.95,88,5,93,607906
chr1,39663557,0.93,82,6,88,607907
chr1,39663667,0.92,47,4,51,607908
chr1,39663730,0.91,71,7,78,607909
chr1,39663762,0.98,81,2,83,607910
chr1,39663794,0.94,78,5,83,607911
chr1,39663813,0.98,88,2,90,607912
chr1,39663906,0.98,79,2,81,607913
chr1,39663908,0.96,77,3,80,607914
chr1,39663951,1,76,0,76,607915
chr1,39664041,0.94,50,3,53,607916
chr1,39664046,0.96,52,2,54,607917
chr1,39664050,0.96,52,2,54,607918
chr1,39664052,0.96,50,2,52,607919
chr1,39664095,0.91,29,3,32,607920
chr1,39664120,0.96,25,1,26,607921
chr1,39664151,0.89,17,2,19,607922
chr1,39664179,1,15,0,15,607923
chr1,39664247,0.96,27,1,28,607924
chr1,39664254,0.91,30,3,33,607925
chr1,39664279,1,49,0,49,607926
chr1,39664315,1,48,0,48,607927
chr1,39664323,0.93,39,3,42,607928
chr1,39664357,0.97,28,1,29,607929
chr1,39664444,1,72,0,72,607930
chr1,39664601,0.98,62,1,63,607931
chr1,39664688,1,29,0,29,607932
chr1,39664696,1,26,0,26,607933
chr1,39664718,1,17,0,17,607934
chr1,39664720,0.95,18,1,19,607935
chr1,39664726,1,15,0,15,607936
chr1,39664802,0.97,28,1,29,607937
chr1,39664814,0.89,33,4,37,607938
chr1,39664858,0.17,3,15,18,607939
chr1,39664878,1,15,0,15,607940
chr1,39664899,0.95,20,1,21,607941
chr1,39664903,0.97,29,1,30,607942
chr1,39664908,1,31,0,31,607943
chr1,39664936,0.95,53,3,56,607944
chr1,39665051,0.95,97,5,102,607945
chr1,39665382,0.97,63,2,65,607946
chr1,39665729,0.93,99,8,107,607947
chr1,39665881,0.94,102,6,108,607948
chr1,39666136,0.96,93,4,97,607949
chr1,39666168,0.97,99,3,102,607950
chr1,39666197,0.91,101,10,111,607951
chr1,39666227,0.95,102,5,107,607952
chr1,39666231,0.98,106,2,108,607953
chr1,39666295,0.99,82,1,83,607954
chr1,39666567,0.96,85,4,89,607955
chr1,39666574,0.97,89,3,92,607956
chr1,39667060,0.59,41,29,70,607957
chr1,39667085,0.9,66,7,73,607958
chr1,39667087,0.96,64,3,67,607959
chr1,39667110,0.99,74,1,75,607960
chr1,39667127,0.98,83,2,85,607961
chr1,39667169,0.99,71,1,72,607962
chr1,39667171,0.99,71,1,72,607963
chr1,39667181,0.94,67,4,71,607964
chr1,39667185,0.93,68,5,73,607965
chr1,39667214,0.88,56,8,64,607966
chr1,39667245,0.96,53,2,55,607967
chr1,39667275,0.96,51,2,53,607968
chr1,39667303,1,58,0,58,607969
chr1,39667313,1,60,0,60,607970
chr1,39667315,0.98,54,1,55,607971
chr1,39667353,0.96,68,3,71,607972
chr1,39667391,0.95,76,4,80,607973
chr1,39667456,0.92,69,6,75,607974
chr1,39667545,0.9,72,8,80,607975
chr1,39667699,1,60,0,60,607976
chr1,39667707,0.98,62,1,63,607977
chr1,39667731,0.9,64,7,71,607978
chr1,39667783,0.96,65,3,68,607979
chr1,39667795,1,73,0,73,607980
chr1,39667838,0.91,51,5,56,607981
chr1,39667884,0.95,40,2,42,607982
chr1,39667890,0.96,45,2,47,607983
chr1,39667917,0.98,53,1,54,607984
chr1,39667929,1,58,0,58,607985
chr1,39667933,0.98,62,1,63,607986
chr1,39667975,0.93,81,6,87,607987
chr1,39668007,0.93,79,6,85,607988
chr1,39668030,0.99,90,1,91,607989
chr1,39668034,0.98,88,2,90,607990
chr1,39668090,0.89,79,10,89,607991
chr1,39668104,0.93,80,6,86,607992
chr1,39668124,0.84,61,12,73,607993
chr1,39668177,0.83,50,10,60,607994
chr1,39668221,0.93,50,4,54,607995
chr1,39668231,0.79,41,11,52,607996
chr1,39668361,0.94,68,4,72,607997
chr1,39668623,0.84,71,14,85,607998
chr1,39669430,0.91,105,11,116,607999
chr1,39669433,0.87,103,15,118,608000
chr1,39669605,0.38,23,38,61,608001
chr1,39669667,1,38,0,38,608002
chr1,39669716,0.9,37,4,41,608003
chr1,39669743,0.9,35,4,39,608004
chr1,39669808,0.74,43,15,58,608005
chr1,39669877,0.13,9,58,67,608006
chr1,39669900,0.05,4,72,76,608007
chr1,39669941,0.03,2,60,62,608008
chr1,39669953,0.05,4,81,85,608009
chr1,39670006,0.5,46,46,92,608010
chr1,39670106,0.09,4,42,46,608011
chr1,39670192,0.02,1,59,60,608012
chr1,39670291,0.02,1,54,55,608013
chr1,39670399,0.03,1,28,29,608014
chr1,39670444,0,0,48,48,608015
chr1,39670510,0.03,2,57,59,608016
chr1,39670581,0.06,4,64,68,608017
chr1,39670647,0.03,1,33,34,608018
chr1,39670684,0.04,2,48,50,608019
chr1,39670748,0.09,6,62,68,608020
chr1,39670907,0,0,79,79,608021
chr1,39671298,0.06,3,46,49,608022
chr1,39671302,0.1,5,44,49,608023
chr1,39671314,0.04,2,51,53,608024
chr1,39671786,0.01,1,82,83,608025
chr1,39671894,0.07,8,104,112,608026
chr1,39672347,0.1,9,85,94,608027
chr1,39672360,0.1,9,84,93,608028
chr1,39672440,0.06,6,102,108,608029
chr1,39672633,0.31,16,36,52,608030
chr1,39672972,0.08,3,35,38,608031
chr1,39673029,0.89,67,8,75,608032
chr1,39673038,0.94,76,5,81,608033
chr1,39673045,0.75,69,23,92,608034
chr1,39673113,0.25,24,72,96,608035
chr1,39673140,0.38,25,41,66,608036
chr1,39673171,0.85,34,6,40,608037
chr1,39673203,0.88,43,6,49,608038
chr1,39673241,0.64,58,32,90,608039
chr1,39673327,0.17,15,75,90,608040
chr1,39673439,0.81,70,16,86,608041
chr1,39673531,0.97,71,2,73,608042
chr1,39673603,0.92,56,5,61,608043
chr1,39673697,0.83,66,14,80,608044
chr1,39673755,0.82,42,9,51,608045
chr1,39673799,0.23,6,20,26,608046
chr1,39673865,0.28,11,28,39,608047
chr1,39674016,0.22,17,62,79,608048
chr1,39674149,0.7,58,25,83,608049
chr1,39674188,0.88,72,10,82,608050
chr1,39674218,0.82,83,18,101,608051
chr1,39674228,0.96,91,4,95,608052
chr1,39674250,0.93,79,6,85,608053
chr1,39674270,0.95,69,4,73,608054
chr1,39674282,0.91,69,7,76,608055
chr1,39674335,0.89,56,7,63,608056
chr1,39674347,0.92,59,5,64,608057
chr1,39674382,0.97,56,2,58,608058
chr1,39674389,0.91,50,5,55,608059
chr1,39674399,0.98,45,1,46,608060
chr1,39674441,0.97,38,1,39,608061
chr1,39674445,1,34,0,34,608062
chr1,39674485,0.98,40,1,41,608063
chr1,39674516,0.95,55,3,58,608064
chr1,39674574,0.97,72,2,74,608065
chr1,39674645,0.97,93,3,96,608066
chr1,39674649,1,96,0,96,608067
chr1,39674694,0.96,71,3,74,608068
chr1,39674721,0.93,51,4,55,608069
chr1,39674823,0.99,73,1,74,608070
chr1,39674840,0.93,67,5,72,608071
chr1,39675210,0.88,51,7,58,608072
chr1,39675423,0.99,87,1,88,608073
chr1,39675498,0.96,90,4,94,608074
chr1,39675634,0.97,70,2,72,608075
chr1,39676068,0.74,28,10,38,608076
chr1,39676386,0.95,100,5,105,608077
chr1,39676646,0.8,32,8,40,608078
chr1,39676677,0.94,32,2,34,608079
chr1,39676763,0.88,61,8,69,608080
chr1,39676882,0.78,59,17,76,608081
chr1,39676931,0.97,57,2,59,608082
chr1,39677129,0.78,64,18,82,608083
chr1,39677159,0.96,76,3,79,608084
chr1,39677187,0.94,74,5,79,608085
chr1,39677190,0.97,71,2,73,608086
chr1,39677228,0.99,68,1,69,608087
chr1,39677235,0.97,62,2,64,608088
chr1,39677276,0.97,63,2,65,608089
chr1,39677292,0.95,52,3,55,608090
chr1,39677425,0.98,58,1,59,608091
chr1,39677467,0.96,77,3,80,608092
chr1,39677477,0.91,78,8,86,608093
chr1,39677496,0.93,68,5,73,608094
chr1,39677501,0.89,65,8,73,608095
chr1,39677629,0.81,78,18,96,608096
chr1,39677908,0.75,41,14,55,608097
chr1,39678106,0.15,12,67,79,608098
chr1,39678333,0.4,31,46,77,608099
chr1,39678338,0.26,21,59,80,608100
chr1,39678355,0.82,65,14,79,608101
chr1,39678363,0.65,55,29,84,608102
chr1,39678404,0.44,37,48,85,608103
chr1,39678446,0.92,68,6,74,608104
chr1,39678455,0.71,52,21,73,608105
chr1,39678493,0.92,49,4,53,608106
chr1,39678577,0.76,56,18,74,608107
chr1,39678597,0.3,25,57,82,608108
chr1,39679034,0.96,66,3,69,608109
chr1,39679072,0.69,41,18,59,608110
chr1,39679096,0.52,33,30,63,608111
chr1,39679160,0.86,60,10,70,608112
chr1,39679195,0.25,23,70,93,608113
chr1,39679206,0.27,23,63,86,608114
chr1,39679228,0.64,47,27,74,608115
chr1,39679255,0.7,47,20,67,608116
chr1,39679288,0.08,4,47,51,608117
chr1,39679421,0,0,47,47,608118
chr1,39679535,0.28,30,78,108,608119
chr1,39679717,0.02,1,47,48,608120
chr1,39679817,0.05,3,63,66,608121
chr1,39679871,0.07,6,77,83,608122
chr1,39680060,0.06,7,113,120,608123
chr1,39680237,0.02,2,81,83,608124
chr1,39680296,0.22,15,53,68,608125
chr1,39680382,0.52,13,12,25,608126
chr1,39680430,0.02,1,41,42,608127
chr1,39680738,0.96,101,4,105,608128
chr1,39680956,0.83,49,10,59,608129
chr1,39681031,0.94,64,4,68,608130
chr1,39681042,0.68,50,24,74,608131
chr1,39681061,0.58,38,27,65,608132
chr1,39681070,0.82,53,12,65,608133
chr1,39681086,0.74,46,16,62,608134
chr1,39681196,0.24,18,57,75,608135
chr1,39681449,0.06,5,85,90,608136
chr1,39681474,0.07,5,70,75,608137
chr1,39681740,0.18,18,81,99,608138
chr1,39682442,0.66,40,21,61,608139
chr1,39682525,0.7,48,21,69,608140
chr1,39682620,0.3,33,78,111,608141
chr1,39682686,0.76,86,27,113,608142
chr1,39682725,0.64,51,29,80,608143
chr1,39682969,0.9,73,8,81,608144
chr1,39683049,0.63,55,33,88,608145
chr1,39683093,0.95,83,4,87,608146
chr1,39683143,1,70,0,70,608147
chr1,39683272,0.86,67,11,78,608148
chr1,39683298,0.93,75,6,81,608149
chr1,39683325,0.95,73,4,77,608150
chr1,39683417,0.95,57,3,60,608151
chr1,39683421,0.98,58,1,59,608152
chr1,39683458,0.98,55,1,56,608153
chr1,39683460,0.98,56,1,57,608154
chr1,39683478,0.98,50,1,51,608155
chr1,39683512,0.96,47,2,49,608156
chr1,39683577,1,18,0,18,608157
chr1,39683621,1,20,0,20,608158
chr1,39683626,0.94,16,1,17,608159
chr1,39683630,1,11,0,11,608160
chr1,39683637,0.92,12,1,13,608161
chr1,39683651,0.93,13,1,14,608162
chr1,39683671,0.93,13,1,14,608163
chr1,39683723,0.97,37,1,38,608164
chr1,39683747,0.94,49,3,52,608165
chr1,39683771,0.95,61,3,64,608166
chr1,39683803,0.8,47,12,59,608167
chr1,39683833,0.88,38,5,43,608168
chr1,39683841,0.83,34,7,41,608169
chr1,39683849,0.64,21,12,33,608170
chr1,39684223,0.7,54,23,77,608171
chr1,39684246,0.91,73,7,80,608172
chr1,39684334,0.74,52,18,70,608173
chr1,39684515,0.97,73,2,75,608174
chr1,39684521,1,67,0,67,608175
chr1,39684597,0.91,32,3,35,608176
chr1,39684641,1,54,0,54,608177
chr1,39684672,0.92,61,5,66,608178
chr1,39684748,0.92,72,6,78,608179
chr1,39685019,0.95,116,6,122,608180
chr1,39685169,0.81,69,16,85,608181
chr1,39685305,1,80,0,80,608182
chr1,39685511,1,76,0,76,608183
chr1,39685515,0.99,78,1,79,608184
chr1,39685547,0.84,58,11,69,608185
chr1,39685611,0.92,55,5,60,608186
chr1,39685642,0.95,63,3,66,608187
chr1,39685702,0.99,83,1,84,608188
chr1,39685921,0.98,61,1,62,608189
chr1,39685991,1,45,0,45,608190
chr1,39686064,0.97,36,1,37,608191
chr1,39686201,1,40,0,40,608192
chr1,39686215,0.96,50,2,52,608193
chr1,39686247,0.93,78,6,84,608194
chr1,39686257,0.96,85,4,89,608195
chr1,39686268,0.98,93,2,95,608196
chr1,39686279,0.94,80,5,85,608197
chr1,39686299,0.96,85,4,89,608198
chr1,39686346,0.94,78,5,83,608199
chr1,39686383,0.95,72,4,76,608200
chr1,39686408,0.98,85,2,87,608201
chr1,39686625,0.97,112,3,115,608202
chr1,39686755,0.97,96,3,99,608203
chr1,39686786,0.93,100,8,108,608204
chr1,39686884,0.95,89,5,94,608205
chr1,39686890,0.92,88,8,96,608206
chr1,39686967,0.82,50,11,61,608207
chr1,39687029,0.93,42,3,45,608208
chr1,39687206,0.86,81,13,94,608209
chr1,39687307,0.94,72,5,77,608210
chr1,39687388,0.82,49,11,60,608211
chr1,39687616,0.8,74,18,92,608212
chr1,39687941,0.93,67,5,72,608213
chr1,39688159,0.56,59,47,106,608214
chr1,39688185,0.96,100,4,104,608215
chr1,39688194,0.97,101,3,104,608216
chr1,39688231,0.99,95,1,96,608217
chr1,39688391,0.97,66,2,68,608218
chr1,39688562,0.92,84,7,91,608219
chr1,39688644,0.65,56,30,86,608220
chr1,39689272,0.98,84,2,86,608221
chr1,39689296,0.93,92,7,99,608222
chr1,39689345,0.89,92,11,103,608223
chr1,39689397,1,91,0,91,608224
chr1,39689435,1,81,0,81,608225
chr1,39690530,0.98,91,2,93,608226
chr1,39690578,0.94,73,5,78,608227
chr1,39690609,0.93,63,5,68,608228
chr1,39691109,1,1,0,1,608229
chr1,39691134,1,12,0,12,608230
chr1,39691139,1,19,0,19,608231
chr1,39691167,0.94,34,2,36,608232
chr1,39691179,0.98,44,1,45,608233
chr1,39691183,0.93,42,3,45,608234
chr1,39691404,0.85,56,10,66,608235
chr1,39691883,0.76,71,23,94,608236
chr1,39691968,0.4,38,57,95,608237
chr1,39692045,0.84,31,6,37,608238
chr1,39692055,0.78,35,10,45,608239
chr1,39692075,0.7,44,19,63,608240
chr1,39692098,0.95,70,4,74,608241
chr1,39692126,0.54,42,36,78,608242
chr1,39692137,0.92,73,6,79,608243
chr1,39692157,0.93,55,4,59,608244
chr1,39692169,0.91,51,5,56,608245
chr1,39692201,0.9,37,4,41,608246
chr1,39692232,0.88,28,4,32,608247
chr1,39692236,1,30,0,30,608248
chr1,39692246,0.91,31,3,34,608249
chr1,39692257,0.95,37,2,39,608250
chr1,39692300,0.94,48,3,51,608251
chr1,39692302,0.96,50,2,52,608252
chr1,39692392,0.67,56,27,83,608253
chr1,39692634,0.16,14,71,85,608254
chr1,39692718,0.29,22,55,77,608255
chr1,39692837,0.92,76,7,83,608256
chr1,39692997,0.96,74,3,77,608257
chr1,39693004,0.95,77,4,81,608258
chr1,39693340,0.92,82,7,89,608259
chr1,39693395,1,107,0,107,608260
chr1,39693751,0.93,77,6,83,608261
chr1,39693753,0.96,80,3,83,608262
chr1,39693838,0.83,85,17,102,608263
chr1,39693842,0.89,92,11,103,608264
chr1,39693865,0.96,94,4,98,608265
chr1,39693897,0.95,101,5,106,608266
chr1,39693930,0.97,91,3,94,608267
chr1,39693936,0.98,94,2,96,608268
chr1,39693969,1,95,0,95,608269
chr1,39694009,0.76,83,26,109,608270
chr1,39694114,0.96,106,4,110,608271
chr1,39694163,0.92,88,8,96,608272
chr1,39694388,0.51,25,24,49,608273
chr1,39694411,0.92,33,3,36,608274
chr1,39694428,0.96,26,1,27,608275
chr1,39694450,0.95,20,1,21,608276
chr1,39694474,1,27,0,27,608277
chr1,39694514,1,55,0,55,608278
chr1,39694605,0.99,74,1,75,608279
chr1,39694959,0.94,87,6,93,608280
chr1,39695219,0.93,104,8,112,608281
chr1,39695263,0.98,104,2,106,608282
chr1,39695477,1,33,0,33,608283
chr1,39695490,0.87,34,5,39,608284
chr1,39695660,0.96,107,4,111,608285
chr1,39695959,0.73,78,29,107,608286
chr1,39695993,0.96,104,4,108,608287
chr1,39696038,0.9,94,10,104,608288
chr1,39696172,0.48,48,52,100,608289
chr1,39696531,0.17,15,72,87,608290
chr1,39696643,0.08,7,78,85,608291
chr1,39696676,0.03,3,86,89,608292
chr1,39696794,0.88,64,9,73,608293
chr1,39696859,0.31,16,35,51,608294
chr1,39696865,0.54,29,25,54,608295
chr1,39696881,0.28,19,49,68,608296
chr1,39697316,0.91,69,7,76,608297
chr1,39697454,0.96,78,3,81,608298
chr1,39697496,0.93,78,6,84,608299
chr1,39698057,0.88,73,10,83,608300
chr1,39698615,0.97,64,2,66,608301
chr1,39698769,1,31,0,31,608302
chr1,39698775,1,33,0,33,608303
chr1,39698792,1,46,0,46,608304
chr1,39698831,0.98,45,1,46,608305
chr1,39698863,0.98,39,1,40,608306
chr1,39698867,0.96,43,2,45,608307
chr1,39698907,0.69,25,11,36,608308
chr1,39698925,0.98,43,1,44,608309
chr1,39698985,0.98,58,1,59,608310
chr1,39699088,0.76,74,24,98,608311
chr1,39699100,0.78,82,23,105,608312
chr1,39699135,0.99,105,1,106,608313
chr1,39699876,0.93,26,2,28,608314
chr1,39699887,0.87,33,5,38,608315
chr1,39699937,0.95,39,2,41,608316
chr1,39699956,0.86,24,4,28,608317
chr1,39699990,0.75,15,5,20,608318
chr1,39700002,0.6,9,6,15,608319
chr1,39700035,1,17,0,17,608320
chr1,39700039,0.65,11,6,17,608321
chr1,39700049,1,21,0,21,608322
chr1,39700063,0.96,22,1,23,608323
chr1,39700067,1,20,0,20,608324
chr1,39700072,1,15,0,15,608325
chr1,39700080,0.86,12,2,14,608326
chr1,39700112,0.94,15,1,16,608327
chr1,39700116,0.94,15,1,16,608328
chr1,39700121,1,19,0,19,608329
chr1,39700166,1,7,0,7,608330
chr1,39700190,0.88,7,1,8,608331
chr1,39700194,1,6,0,6,608332
chr1,39700199,1,5,0,5,608333
chr1,39700211,1,7,0,7,608334
chr1,39700239,0.8,4,1,5,608335
chr1,39700243,0.89,8,1,9,608336
chr1,39700248,1,8,0,8,608337
chr1,39700260,1,11,0,11,608338
chr1,39700272,0.92,11,1,12,608339
chr1,39700288,1,13,0,13,608340
chr1,39700292,1,12,0,12,608341
chr1,39700297,0.9,9,1,10,608342
chr1,39700305,0.88,7,1,8,608343
chr1,39700309,0.5,4,4,8,608344
chr1,39700337,0.44,4,5,9,608345
chr1,39700341,0.6,6,4,10,608346
chr1,39700353,0.88,7,1,8,608347
chr1,39700357,0.8,8,2,10,608348
chr1,39700363,0.78,7,2,9,608349
chr1,39700386,0.38,3,5,8,608350
chr1,39700393,0.75,6,2,8,608351
chr1,39700397,1,9,0,9,608352
chr1,39700421,1,5,0,5,608353
chr1,39700426,0.67,2,1,3,608354
chr1,39700538,1,2,0,2,608355
chr1,39700543,1,3,0,3,608356
chr1,39700546,1,4,0,4,608357
chr1,39700557,1,9,0,9,608358
chr1,39700575,0.96,24,1,25,608359
chr1,39700586,1,30,0,30,608360
chr1,39700596,1,36,0,36,608361
chr1,39700622,1,52,0,52,608362
chr1,39700662,0.97,36,1,37,608363
chr1,39700666,0.97,28,1,29,608364
chr1,39700670,1,30,0,30,608365
chr1,39700676,1,23,0,23,608366
chr1,39700905,1,7,0,7,608367
chr1,39700913,1,11,0,11,608368
chr1,39700925,1,20,0,20,608369
chr1,39700941,1,30,0,30,608370
chr1,39700961,0.98,43,1,44,608371
chr1,39700996,0.97,57,2,59,608372
chr1,39701004,1,61,0,61,608373
chr1,39701027,1,58,0,58,608374
chr1,39701035,0.98,55,1,56,608375
chr1,39701037,1,56,0,56,608376
chr1,39701049,0.98,57,1,58,608377
chr1,39701059,1,57,0,57,608378
chr1,39701288,0.98,89,2,91,608379
chr1,39701407,0.59,40,28,68,608380
chr1,39701461,0.87,53,8,61,608381
chr1,39701499,0.94,59,4,63,608382
chr1,39701907,0.83,66,14,80,608383
chr1,39702377,0.75,33,11,44,608384
chr1,39702394,1,46,0,46,608385
chr1,39702436,0.81,58,14,72,608386
chr1,39702578,0.6,45,30,75,608387
chr1,39702616,0.76,61,19,80,608388
chr1,39702618,0.66,50,26,76,608389
chr1,39702626,0.48,38,41,79,608390
chr1,39702719,0.84,78,15,93,608391
chr1,39702775,0.99,93,1,94,608392
chr1,39702864,0.56,53,42,95,608393
chr1,39703024,0.79,99,26,125,608394
chr1,39703164,0.83,82,17,99,608395
chr1,39703292,0.78,60,17,77,608396
chr1,39703427,0.91,79,8,87,608397
chr1,39703449,0.93,92,7,99,608398
chr1,39703518,0.68,75,36,111,608399
chr1,39703555,0.62,66,41,107,608400
chr1,39703685,0.91,95,9,104,608401
chr1,39703721,0.84,96,18,114,608402
chr1,39703736,0.64,74,42,116,608403
chr1,39703785,0.89,99,12,111,608404
chr1,39703846,0.91,90,9,99,608405
chr1,39703869,0.98,86,2,88,608406
chr1,39704193,0.47,44,49,93,608407
chr1,39704578,0.96,67,3,70,608408
chr1,39704649,0.9,66,7,73,608409
chr1,39704719,0.89,63,8,71,608410
chr1,39704750,0.9,57,6,63,608411
chr1,39704825,0.98,51,1,52,608412
chr1,39704867,0.97,59,2,61,608413
chr1,39704877,0.98,62,1,63,608414
chr1,39704907,1,59,0,59,608415
chr1,39704915,0.98,59,1,60,608416
chr1,39704925,0.95,56,3,59,608417
chr1,39704939,1,54,0,54,608418
chr1,39705583,0.94,84,5,89,608419
chr1,39705587,0.93,85,6,91,608420
chr1,39705591,0.98,88,2,90,608421
chr1,39705684,0.88,106,14,120,608422
chr1,39705875,0.9,114,12,126,608423
chr1,39705909,0.66,80,41,121,608424
chr1,39706233,0.95,78,4,82,608425
chr1,39706256,0.96,80,3,83,608426
chr1,39706263,0.88,70,10,80,608427
chr1,39706273,0.91,73,7,80,608428
chr1,39706295,0.66,42,22,64,608429
chr1,39706327,0.92,59,5,64,608430
chr1,39706390,0.98,59,1,60,608431
chr1,39706450,0.95,78,4,82,608432
chr1,39706515,0.95,86,5,91,608433
chr1,39706524,0.96,82,3,85,608434
chr1,39706628,0.98,101,2,103,608435
chr1,39706787,0.8,56,14,70,608436
chr1,39706983,0.97,96,3,99,608437
chr1,39707029,0.98,99,2,101,608438
chr1,39707047,0.97,88,3,91,608439
chr1,39707069,0.99,66,1,67,608440
chr1,39707125,0.97,58,2,60,608441
chr1,39707129,0.97,59,2,61,608442
chr1,39707160,0.97,60,2,62,608443
chr1,39707188,0.94,58,4,62,608444
chr1,39707246,0.94,59,4,63,608445
chr1,39707301,0.88,38,5,43,608446
chr1,39707318,0.91,31,3,34,608447
chr1,39707363,0.87,26,4,30,608448
chr1,39707398,0.97,38,1,39,608449
chr1,39707644,0.89,103,13,116,608450
chr1,39707742,0.95,82,4,86,608451
chr1,39707757,0.94,77,5,82,608452
chr1,39707790,0.96,68,3,71,608453
chr1,39707840,0.99,73,1,74,608454
chr1,39707882,0.97,90,3,93,608455
chr1,39707890,0.96,88,4,92,608456
chr1,39707914,0.91,90,9,99,608457
chr1,39707953,0.97,76,2,78,608458
chr1,39707970,0.97,67,2,69,608459
chr1,39707988,1,60,0,60,608460
chr1,39708218,0.84,47,9,56,608461
chr1,39708294,0.98,50,1,51,608462
chr1,39708339,0.87,47,7,54,608463
chr1,39708361,1,47,0,47,608464
chr1,39708363,0.95,42,2,44,608465
chr1,39708556,0.97,61,2,63,608466
chr1,39708603,0.47,36,40,76,608467
chr1,39708655,0.44,36,45,81,608468
chr1,39708702,0.88,77,11,88,608469
chr1,39708813,0.98,91,2,93,608470
chr1,39708825,0.96,97,4,101,608471
chr1,39709162,0.72,42,16,58,608472
chr1,39709364,0.95,124,7,131,608473
chr1,39709554,0.9,60,7,67,608474
chr1,39709845,0.97,65,2,67,608475
chr1,39709858,0.97,64,2,66,608476
chr1,39709921,1,58,0,58,608477
chr1,39709923,1,56,0,56,608478
chr1,39709933,0.98,57,1,58,608479
chr1,39709938,0.97,64,2,66,608480
chr1,39709982,0.95,63,3,66,608481
chr1,39710014,0.98,60,1,61,608482
chr1,39710022,0.98,64,1,65,608483
chr1,39710045,0.98,55,1,56,608484
chr1,39710143,0.91,39,4,43,608485
chr1,39710174,1,40,0,40,608486
chr1,39710199,0.98,42,1,43,608487
chr1,39710280,0.98,53,1,54,608488
chr1,39710310,0.94,62,4,66,608489
chr1,39710395,0.93,78,6,84,608490
chr1,39710502,0.96,86,4,90,608491
chr1,39710530,0.98,81,2,83,608492
chr1,39710572,1,74,0,74,608493
chr1,39710636,0.97,60,2,62,608494
chr1,39710674,0.85,53,9,62,608495
chr1,39711024,0.85,63,11,74,608496
chr1,39711053,0.7,48,21,69,608497
chr1,39711055,0.6,41,27,68,608498
chr1,39711062,0.42,27,38,65,608499
chr1,39711104,0.95,55,3,58,608500
chr1,39711242,0.98,57,1,58,608501
chr1,39711357,1,58,0,58,608502
chr1,39711714,0.99,76,1,77,608503
chr1,39712223,0.92,90,8,98,608504
chr1,39712273,0.96,87,4,91,608505
chr1,39712283,0.99,86,1,87,608506
chr1,39712325,0.95,80,4,84,608507
chr1,39712331,0.92,77,7,84,608508
chr1,39712341,0.98,78,2,80,608509
chr1,39712370,0.76,69,22,91,608510
chr1,39712401,0.98,83,2,85,608511
chr1,39712698,0.92,54,5,59,608512
chr1,39712734,1,25,0,25,608513
chr1,39712767,0.67,2,1,3,608514
chr1,39712775,1,5,0,5,608515
chr1,39712805,1,14,0,14,608516
chr1,39712807,1,15,0,15,608517
chr1,39712813,1,19,0,19,608518
chr1,39712830,0.96,22,1,23,608519
chr1,39712837,0.96,27,1,28,608520
chr1,39712845,0.96,25,1,26,608521
chr1,39712869,1,30,0,30,608522
chr1,39712889,0.95,18,1,19,608523
chr1,39712891,0.8,16,4,20,608524
chr1,39712893,0.95,21,1,22,608525
chr1,39712905,0.95,20,1,21,608526
chr1,39712933,0.86,6,1,7,608527
chr1,39712964,1,7,0,7,608528
chr1,39712978,1,17,0,17,608529
chr1,39712985,1,23,0,23,608530
chr1,39712989,0.92,24,2,26,608531
chr1,39712994,0.97,30,1,31,608532
chr1,39713034,0.98,61,1,62,608533
chr1,39713426,0.98,82,2,84,608534
chr1,39713442,0.96,65,3,68,608535
chr1,39713475,1,50,0,50,608536
chr1,39713492,1,47,0,47,608537
chr1,39713522,0.97,58,2,60,608538
chr1,39713564,1,77,0,77,608539
chr1,39713586,0.95,62,3,65,608540
chr1,39713618,0.94,62,4,66,608541
chr1,39713635,0.95,55,3,58,608542
chr1,39713768,0.98,91,2,93,608543
chr1,39713859,0.97,136,4,140,608544
chr1,39713900,0.61,92,59,151,608545
chr1,39713908,0.87,131,20,151,608546
chr1,39713922,0.94,136,9,145,608547
chr1,39714325,0.69,49,22,71,608548
chr1,39714417,0.97,90,3,93,608549
chr1,39714438,0.99,85,1,86,608550
chr1,39714619,0.91,74,7,81,608551
chr1,39714740,0.9,102,11,113,608552
chr1,39714964,0.87,73,11,84,608553
chr1,39715205,0.98,88,2,90,608554
chr1,39715345,1,95,0,95,608555
chr1,39715435,0.56,55,44,99,608556
chr1,39715494,0.42,41,57,98,608557
chr1,39715689,0.98,93,2,95,608558
chr1,39715722,0.96,103,4,107,608559
chr1,39716152,0.95,83,4,87,608560
chr1,39716839,0.71,55,22,77,608561
chr1,39716923,0.87,89,13,102,608562
chr1,39716958,0.82,84,19,103,608563
chr1,39717120,0.97,83,3,86,608564
chr1,39717255,0.95,80,4,84,608565
chr1,39717390,0.95,71,4,75,608566
chr1,39717542,0.69,50,22,72,608567
chr1,39717566,0.97,58,2,60,608568
chr1,39717580,0.79,53,14,67,608569
chr1,39717591,0.97,62,2,64,608570
chr1,39717696,0.8,51,13,64,608571
chr1,39718053,0.67,61,30,91,608572
chr1,39718648,0.95,77,4,81,608573
chr1,39718771,0.49,45,47,92,608574
chr1,39718883,0.98,82,2,84,608575
chr1,39719240,0.43,22,29,51,608576
chr1,39719342,0.95,95,5,100,608577
chr1,39719376,0.96,99,4,103,608578
chr1,39719439,0.85,72,13,85,608579
chr1,39719467,0.78,62,18,80,608580
chr1,39719588,0.37,25,42,67,608581
chr1,39719715,0.97,121,4,125,608582
chr1,39719748,1,136,0,136,608583
chr1,39719755,0.96,131,5,136,608584
chr1,39719798,0.97,114,4,118,608585
chr1,39719805,0.97,111,4,115,608586
chr1,39719973,0.66,38,20,58,608587
chr1,39719991,0.88,37,5,42,608588
chr1,39720042,0.93,70,5,75,608589
chr1,39720267,0.87,105,16,121,608590
chr1,39720685,0.61,43,28,71,608591
chr1,39720693,0.84,61,12,73,608592
chr1,39721144,0.04,2,54,56,608593
chr1,39721316,0.58,60,44,104,608594
chr1,39721324,0.82,85,19,104,608595
chr1,39721607,0.7,85,37,122,608596
chr1,39721660,0.93,107,8,115,608597
chr1,39721672,0.96,110,5,115,608598
chr1,39721720,0.84,100,19,119,608599
chr1,39722019,0.9,43,5,48,608600
chr1,39722060,0.79,42,11,53,608601
chr1,39722232,0.96,65,3,68,608602
chr1,39722324,0.8,59,15,74,608603
chr1,39722342,0.81,69,16,85,608604
chr1,39722441,0.96,69,3,72,608605
chr1,39722645,0.97,71,2,73,608606
chr1,39722678,0.99,80,1,81,608607
chr1,39722838,0.97,97,3,100,608608
chr1,39722895,0.99,91,1,92,608609
chr1,39722960,0.93,74,6,80,608610
chr1,39722998,0.84,26,5,31,608611
chr1,39723010,0,0,12,12,608612
chr1,39723123,0.89,31,4,35,608613
chr1,39723135,0.8,33,8,41,608614
chr1,39723164,0.89,32,4,36,608615
chr1,39723175,0.9,35,4,39,608616
chr1,39723195,0.91,42,4,46,608617
chr1,39723209,0.96,51,2,53,608618
chr1,39723216,1,62,0,62,608619
chr1,39723253,0.96,77,3,80,608620
chr1,39723263,0.96,90,4,94,608621
chr1,39723265,0.77,75,22,97,608622
chr1,39723273,0.83,86,17,103,608623
chr1,39723586,0.84,90,17,107,608624
chr1,39723626,0.92,105,9,114,608625
chr1,39723873,0.94,98,6,104,608626
chr1,39723879,0.88,88,12,100,608627
chr1,39724134,0.58,44,32,76,608628
chr1,39724195,0.5,44,44,88,608629
chr1,39724457,0.02,2,90,92,608630
chr1,39724503,0.06,5,73,78,608631
chr1,39724541,0.03,3,110,113,608632
chr1,39724968,0.58,23,17,40,608633
chr1,39725019,0.99,72,1,73,608634
chr1,39725153,0.7,57,24,81,608635
chr1,39725185,0.89,54,7,61,608636
chr1,39725213,0.9,52,6,58,608637
chr1,39725223,0.97,56,2,58,608638
chr1,39725316,0.89,32,4,36,608639
chr1,39725324,1,40,0,40,608640
chr1,39725337,0.94,45,3,48,608641
chr1,39725364,0.94,65,4,69,608642
chr1,39725371,1,77,0,77,608643
chr1,39725387,0.98,92,2,94,608644
chr1,39725419,0.85,84,15,99,608645
chr1,39725455,0.38,38,61,99,608646
chr1,39725568,1,59,0,59,608647
chr1,39725578,1,61,0,61,608648
chr1,39725584,0.89,55,7,62,608649
chr1,39725665,0.91,62,6,68,608650
chr1,39725899,0.5,40,40,80,608651
chr1,39726066,0.84,56,11,67,608652
chr1,39726105,0.92,80,7,87,608653
chr1,39726139,0.96,89,4,93,608654
chr1,39726193,0.91,74,7,81,608655
chr1,39726249,0.96,67,3,70,608656
chr1,39726309,1,72,0,72,608657
chr1,39726323,0.82,60,13,73,608658
chr1,39726325,0.9,66,7,73,608659
chr1,39727308,0.94,91,6,97,608660
chr1,39727791,0.93,81,6,87,608661
chr1,39727831,0.91,58,6,64,608662
chr1,39727942,0.98,63,1,64,608663
chr1,39727997,0.89,72,9,81,608664
chr1,39728056,0.51,21,20,41,608665
chr1,39728483,0.73,62,23,85,608666
chr1,39728532,0.23,18,62,80,608667
chr1,39728654,0.88,53,7,60,608668
chr1,39728659,0.24,16,50,66,608669
chr1,39729118,0.99,79,1,80,608670
chr1,39729468,0.33,2,4,6,608671
chr1,39729506,1,7,0,7,608672
chr1,39729508,1,12,0,12,608673
chr1,39729570,0.79,11,3,14,608674
chr1,39729590,0.88,14,2,16,608675
chr1,39729594,0.85,11,2,13,608676
chr1,39729606,0,0,5,5,608677
chr1,39729646,0.73,8,3,11,608678
chr1,39729687,0.96,27,1,28,608679
chr1,39729818,0.97,95,3,98,608680
chr1,39730296,0.95,59,3,62,608681
chr1,39730361,0,0,1,1,608682
chr1,39730386,0,0,1,1,608683
chr1,39730393,0,0,1,1,608684
chr1,39730567,1,2,0,2,608685
chr1,39730592,1,20,0,20,608686
chr1,39730597,1,25,0,25,608687
chr1,39730625,1,45,0,45,608688
chr1,39730635,0.93,51,4,55,608689
chr1,39730637,0.96,53,2,55,608690
chr1,39730641,0.95,56,3,59,608691
chr1,39731130,0.96,68,3,71,608692
chr1,39731210,0.95,93,5,98,608693
chr1,39731231,0.5,56,57,113,608694
chr1,39731332,0.45,52,64,116,608695
chr1,39731403,0.96,89,4,93,608696
chr1,39731459,0.87,59,9,68,608697
chr1,39732222,0.59,33,23,56,608698
chr1,39732557,0.84,71,14,85,608699
chr1,39733047,0.32,29,62,91,608700
chr1,39733091,0.23,19,64,83,608701
chr1,39733145,0.64,47,27,74,608702
chr1,39733185,0.9,70,8,78,608703
chr1,39733197,0.94,74,5,79,608704
chr1,39733224,0.75,64,21,85,608705
chr1,39733498,0.13,10,65,75,608706
chr1,39733810,0.11,7,54,61,608707
chr1,39733845,0.1,6,52,58,608708
chr1,39733898,0.05,3,59,62,608709
chr1,39733913,0.02,1,60,61,608710
chr1,39734090,0.02,2,106,108,608711
chr1,39734191,0.01,1,76,77,608712
chr1,39734197,0.02,1,64,65,608713
chr1,39734220,0.03,1,28,29,608714
chr1,39734254,0.06,5,84,89,608715
chr1,39734283,0.11,10,79,89,608716
chr1,39734289,0.09,8,81,89,608717
chr1,39734340,0.08,6,69,75,608718
chr1,39734401,0.05,3,53,56,608719
chr1,39734457,0.15,7,41,48,608720
chr1,39734563,0.06,3,49,52,608721
chr1,39734594,0.06,4,62,66,608722
chr1,39734661,0.04,3,73,76,608723
chr1,39734669,0.1,7,63,70,608724
chr1,39734673,0.16,12,64,76,608725
chr1,39734723,0.64,51,29,80,608726
chr1,39734837,0.13,11,76,87,608727
chr1,39734949,0.11,8,65,73,608728
chr1,39734958,0.2,15,59,74,608729
chr1,39735138,0.1,6,52,58,608730
chr1,39735142,0.12,7,53,60,608731
chr1,39735624,0.61,65,42,107,608732
chr1,39735720,0.19,21,88,109,608733
chr1,39735747,0.25,28,85,113,608734
chr1,39735903,0.15,16,93,109,608735
chr1,39736783,0.97,103,3,106,608736
chr1,39736999,0.87,48,7,55,608737
chr1,39737041,0.9,54,6,60,608738
chr1,39737070,0.92,59,5,64,608739
chr1,39737140,0.76,56,18,74,608740
chr1,39737767,0.09,8,80,88,608741
chr1,39738033,0.12,9,66,75,608742
chr1,39738046,0.11,8,64,72,608743
chr1,39738581,0.49,33,34,67,608744
chr1,39738767,0.98,58,1,59,608745
chr1,39738831,0.68,36,17,53,608746
chr1,39738850,0.59,41,28,69,608747
chr1,39738871,0.82,63,14,77,608748
chr1,39738877,0.79,59,16,75,608749
chr1,39738901,0.78,56,16,72,608750
chr1,39738916,0.99,71,1,72,608751
chr1,39738933,0.85,61,11,72,608752
chr1,39738953,1,56,0,56,608753
chr1,39738957,0.97,66,2,68,608754
chr1,39738968,0.99,71,1,72,608755
chr1,39739005,0.87,67,10,77,608756
chr1,39739293,0.78,29,8,37,608757
chr1,39739325,0.82,42,9,51,608758
chr1,39739362,0.82,56,12,68,608759
chr1,39739370,0.91,72,7,79,608760
chr1,39739407,0.96,64,3,67,608761
chr1,39739423,0.87,52,8,60,608762
chr1,39739463,0.86,38,6,44,608763
chr1,39739483,0.97,36,1,37,608764
chr1,39739497,0.97,37,1,38,608765
chr1,39739504,0.97,38,1,39,608766
chr1,39739508,1,55,0,55,608767
chr1,39739513,0.95,57,3,60,608768
chr1,39739541,0.95,56,3,59,608769
chr1,39739551,0.97,63,2,65,608770
chr1,39739553,0.98,65,1,66,608771
chr1,39740040,0.97,83,3,86,608772
chr1,39740062,0.87,78,12,90,608773
chr1,39740288,0.91,105,11,116,608774
chr1,39740781,0.94,33,2,35,608775
chr1,39740789,0.95,35,2,37,608776
chr1,39740811,0.81,35,8,43,608777
chr1,39740813,0.72,36,14,50,608778
chr1,39740819,0.88,45,6,51,608779
chr1,39740824,0.75,36,12,48,608780
chr1,39740851,0.98,52,1,53,608781
chr1,39740862,0.98,44,1,45,608782
chr1,39740875,0.98,39,1,40,608783
chr1,39740895,0.95,38,2,40,608784
chr1,39740899,0.94,44,3,47,608785
chr1,39740902,0.96,49,2,51,608786
chr1,39740911,0.95,56,3,59,608787
chr1,39740944,0.89,59,7,66,608788
chr1,39740989,0.97,62,2,64,608789
chr1,39740996,0.95,60,3,63,608790
chr1,39741000,1,70,0,70,608791
chr1,39741029,0.91,74,7,81,608792
chr1,39741044,0.97,85,3,88,608793
chr1,39741107,0.98,84,2,86,608794
chr1,39741129,0.98,85,2,87,608795
chr1,39741263,0.97,86,3,89,608796
chr1,39741694,0.84,81,15,96,608797
chr1,39741701,0.83,85,18,103,608798
chr1,39741806,0.87,111,16,127,608799
chr1,39742005,0.46,33,38,71,608800
chr1,39742071,0.37,29,50,79,608801
chr1,39742142,0.35,32,60,92,608802
chr1,39742237,0.56,59,46,105,608803
chr1,39742383,0.62,66,41,107,608804
chr1,39742446,0.76,91,29,120,608805
chr1,39742868,0.23,21,69,90,608806
chr1,39744332,0.49,51,53,104,608807
chr1,39744462,0.57,46,35,81,608808
chr1,39744518,0.98,47,1,48,608809
chr1,39744606,0.61,56,36,92,608810
chr1,39744988,0.44,34,44,78,608811
chr1,39745226,0.64,60,34,94,608812
chr1,39745258,0.96,90,4,94,608813
chr1,39745344,0.74,71,25,96,608814
chr1,39745583,0.09,7,74,81,608815
chr1,39745761,0.83,39,8,47,608816
chr1,39745777,0.95,40,2,42,608817
chr1,39745789,0.9,45,5,50,608818
chr1,39745821,0.98,64,1,65,608819
chr1,39746053,0.98,108,2,110,608820
chr1,39746083,0.88,95,13,108,608821
chr1,39746093,0.99,100,1,101,608822
chr1,39746177,0.83,64,13,77,608823
chr1,39746288,0.98,65,1,66,608824
chr1,39746352,1,67,0,67,608825
chr1,39746359,0.96,72,3,75,608826
chr1,39746396,0.95,62,3,65,608827
chr1,39746454,0.98,48,1,49,608828
chr1,39746529,0.96,67,3,70,608829
chr1,39746616,0.89,85,11,96,608830
chr1,39746713,0.98,80,2,82,608831
chr1,39746967,0.85,86,15,101,608832
chr1,39747003,0.86,92,15,107,608833
chr1,39747255,0.62,58,35,93,608834
chr1,39747601,0.98,103,2,105,608835
chr1,39747641,0.75,76,26,102,608836
chr1,39747787,0.86,62,10,72,608837
chr1,39748039,0.96,65,3,68,608838
chr1,39748045,0.91,63,6,69,608839
chr1,39748234,0.95,110,6,116,608840
chr1,39748390,0.1,10,91,101,608841
chr1,39748453,0.09,10,98,108,608842
chr1,39748619,0.76,57,18,75,608843
chr1,39748622,0.79,55,15,70,608844
chr1,39748831,0.92,88,8,96,608845
chr1,39748864,0.84,88,17,105,608846
chr1,39748904,0.8,83,21,104,608847
chr1,39748955,0.87,80,12,92,608848
chr1,39749009,0.85,51,9,60,608849
chr1,39749132,0.98,102,2,104,608850
chr1,39749186,0.85,84,15,99,608851
chr1,39749771,0.69,52,23,75,608852
chr1,39750773,0.8,84,21,105,608853
chr1,39750851,0.75,80,26,106,608854
chr1,39750866,0.86,90,15,105,608855
chr1,39750870,0.65,69,37,106,608856
chr1,39751147,0.16,11,58,69,608857
chr1,39751304,0.86,88,14,102,608858
chr1,39751390,0.98,110,2,112,608859
chr1,39751721,0.84,57,11,68,608860
chr1,39751770,0.97,88,3,91,608861
chr1,39751788,0.99,97,1,98,608862
chr1,39751874,0.93,74,6,80,608863
chr1,39751923,0.96,81,3,84,608864
chr1,39751965,0.95,87,5,92,608865
chr1,39752006,0.82,71,16,87,608866
chr1,39752201,0.81,54,13,67,608867
chr1,39752207,0.87,62,9,71,608868
chr1,39752262,0.86,79,13,92,608869
chr1,39752327,0.85,44,8,52,608870
chr1,39752685,0.96,72,3,75,608871
chr1,39752701,0.91,64,6,70,608872
chr1,39752718,1,59,0,59,608873
chr1,39752793,0.84,41,8,49,608874
chr1,39752821,0.92,65,6,71,608875
chr1,39752965,0.94,46,3,49,608876
chr1,39752992,0.97,60,2,62,608877
chr1,39753016,0.95,79,4,83,608878
chr1,39753130,0.97,105,3,108,608879
chr1,39753145,0.95,105,6,111,608880
chr1,39753193,0.97,93,3,96,608881
chr1,39753570,0.97,99,3,102,608882
chr1,39753741,0.98,85,2,87,608883
chr1,39753808,0.94,80,5,85,608884
chr1,39753892,0.97,62,2,64,608885
chr1,39753908,1,60,0,60,608886
chr1,39753941,1,62,0,62,608887
chr1,39753966,1,46,0,46,608888
chr1,39753997,0.96,26,1,27,608889
chr1,39754042,1,45,0,45,608890
chr1,39754086,0.96,67,3,70,608891
chr1,39754197,0.94,30,2,32,608892
chr1,39754237,0.98,58,1,59,608893
chr1,39754246,0.98,60,1,61,608894
chr1,39754291,0.97,69,2,71,608895
chr1,39754319,0.99,69,1,70,608896
chr1,39754331,0.98,57,1,58,608897
chr1,39754333,0.98,57,1,58,608898
chr1,39754338,0.96,52,2,54,608899
chr1,39754418,0.96,53,2,55,608900
chr1,39754428,1,59,0,59,608901
chr1,39754601,0.64,50,28,78,608902
chr1,39755035,0.94,78,5,83,608903
chr1,39755044,0.94,77,5,82,608904
chr1,39755166,0.83,84,17,101,608905
chr1,39755183,0.98,94,2,96,608906
chr1,39755440,0.99,67,1,68,608907
chr1,39755448,0.93,65,5,70,608908
chr1,39755520,0.97,66,2,68,608909
chr1,39755522,0.95,62,3,65,608910
chr1,39755591,0.97,59,2,61,608911
chr1,39755618,0.92,48,4,52,608912
chr1,39755623,0.96,47,2,49,608913
chr1,39755651,0.94,47,3,50,608914
chr1,39756402,0.95,37,2,39,608915
chr1,39756408,1,44,0,44,608916
chr1,39756432,0.96,65,3,68,608917
chr1,39756442,0.97,69,2,71,608918
chr1,39756484,0.99,70,1,71,608919
chr1,39756488,0.96,79,3,82,608920
chr1,39756496,0.99,84,1,85,608921
chr1,39756589,1,55,0,55,608922
chr1,39756679,0.97,93,3,96,608923
chr1,39756704,1,97,0,97,608924
chr1,39756793,1,43,0,43,608925
chr1,39756868,0.89,8,1,9,608926
chr1,39756928,0.84,38,7,45,608927
chr1,39756940,1,54,0,54,608928
chr1,39756944,0.91,52,5,57,608929
chr1,39756951,0.97,66,2,68,608930
chr1,39756986,0.96,81,3,84,608931
chr1,39757411,0.94,66,4,70,608932
chr1,39757423,0.96,65,3,68,608933
chr1,39757594,0.86,70,11,81,608934
chr1,39757661,0.66,76,39,115,608935
chr1,39757714,0.93,100,8,108,608936
chr1,39757746,0.89,90,11,101,608937
chr1,39757757,0.9,89,10,99,608938
chr1,39757836,0.96,80,3,83,608939
chr1,39758055,0.97,71,2,73,608940
chr1,39758383,0.61,68,44,112,608941
chr1,39758528,0.95,70,4,74,608942
chr1,39758582,0.91,70,7,77,608943
chr1,39758719,0.8,94,24,118,608944
chr1,39758765,0.7,79,34,113,608945
chr1,39759145,0.66,64,33,97,608946
chr1,39759722,0.89,85,11,96,608947
chr1,39759734,0.74,73,26,99,608948
chr1,39759879,0.69,68,31,99,608949
chr1,39760418,0.05,3,53,56,608950
chr1,39760666,0.92,88,8,96,608951
chr1,39760757,0.73,66,25,91,608952
chr1,39761303,0.74,71,25,96,608953
chr1,39761399,0.99,101,1,102,608954
chr1,39761626,0.96,64,3,67,608955
chr1,39761922,0.96,104,4,108,608956
chr1,39762123,0.95,54,3,57,608957
chr1,39762634,1,49,0,49,608958
chr1,39762658,0.77,40,12,52,608959
chr1,39762681,0.98,56,1,57,608960
chr1,39762720,0.89,62,8,70,608961
chr1,39762740,0.97,65,2,67,608962
chr1,39762752,0.97,61,2,63,608963
chr1,39762756,0.95,62,3,65,608964
chr1,39762788,0.75,52,17,69,608965
chr1,39762819,0.98,60,1,61,608966
chr1,39762833,1,69,0,69,608967
chr1,39762844,1,77,0,77,608968
chr1,39762856,0.97,75,2,77,608969
chr1,39762877,0.9,61,7,68,608970
chr1,39762887,0.94,62,4,66,608971
chr1,39762889,0.94,59,4,63,608972
chr1,39762923,0.82,64,14,78,608973
chr1,39763071,0.9,94,10,104,608974
chr1,39763133,0.94,96,6,102,608975
chr1,39763307,0.11,8,63,71,608976
chr1,39763352,0.1,7,62,69,608977
chr1,39763388,0.26,21,59,80,608978
chr1,39763560,0.14,9,56,65,608979
chr1,39764209,0.95,100,5,105,608980
chr1,39764274,0.96,96,4,100,608981
chr1,39764572,0.78,49,14,63,608982
chr1,39764579,0.79,46,12,58,608983
chr1,39764615,0.91,69,7,76,608984
chr1,39764623,0.97,74,2,76,608985
chr1,39764626,0.97,75,2,77,608986
chr1,39764632,0.93,82,6,88,608987
chr1,39764671,0.91,108,11,119,608988
chr1,39764680,0.83,97,20,117,608989
chr1,39764726,0.73,69,26,95,608990
chr1,39764915,0.29,20,50,70,608991
chr1,39765019,0.99,93,1,94,608992
chr1,39765091,0.79,99,26,125,608993
chr1,39765680,0.91,62,6,68,608994
chr1,39765917,0.9,114,13,127,608995
chr1,39765929,0.73,96,36,132,608996
chr1,39765950,0.81,112,26,138,608997
chr1,39765966,0.92,122,10,132,608998
chr1,39766031,0.75,62,21,83,608999
chr1,39766132,0.85,52,9,61,609000
chr1,39766391,0.8,71,18,89,609001
chr1,39766527,0.96,102,4,106,609002
chr1,39766586,0.97,106,3,109,609003
chr1,39766608,1,105,0,105,609004
chr1,39766617,0.98,93,2,95,609005
chr1,39766829,0.98,48,1,49,609006
chr1,39766837,1,51,0,51,609007
chr1,39766861,0.92,45,4,49,609008
chr1,39766884,0.98,46,1,47,609009
chr1,39766891,0.98,51,1,52,609010
chr1,39766930,1,44,0,44,609011
chr1,39766947,1,46,0,46,609012
chr1,39766959,1,43,0,43,609013
chr1,39767019,0.97,38,1,39,609014
chr1,39767077,0.93,41,3,44,609015
chr1,39767087,1,52,0,52,609016
chr1,39767089,1,57,0,57,609017
chr1,39767120,0.98,65,1,66,609018
chr1,39767128,1,65,0,65,609019
chr1,39767158,0.99,77,1,78,609020
chr1,39767254,0.96,92,4,96,609021
chr1,39767287,0.87,76,11,87,609022
chr1,39767318,0.96,69,3,72,609023
chr1,39767388,0.92,61,5,66,609024
chr1,39767395,0.67,49,24,73,609025
chr1,39767478,0.95,91,5,96,609026
chr1,39767793,0.81,65,15,80,609027
chr1,39767829,0.8,72,18,90,609028
chr1,39768100,0.92,97,8,105,609029
chr1,39768301,0.97,76,2,78,609030
chr1,39768644,0.96,69,3,72,609031
chr1,39768679,0.94,58,4,62,609032
chr1,39768693,1,65,0,65,609033
chr1,39768799,0.93,66,5,71,609034
chr1,39769095,0.98,79,2,81,609035
chr1,39769153,0.99,86,1,87,609036
chr1,39769178,0.98,62,1,63,609037
chr1,39769211,0.93,56,4,60,609038
chr1,39769289,0.87,52,8,60,609039
chr1,39769298,0.93,51,4,55,609040
chr1,39769341,0.76,29,9,38,609041
chr1,39769392,0.89,32,4,36,609042
chr1,39769396,0.9,36,4,40,609043
chr1,39769428,0.89,64,8,72,609044
chr1,39769458,1,83,0,83,609045
chr1,39769476,0.95,72,4,76,609046
chr1,39769492,0.99,68,1,69,609047
chr1,39769497,0.99,66,1,67,609048
chr1,39769527,0.94,48,3,51,609049
chr1,39769543,0.87,40,6,46,609050
chr1,39769671,0.54,28,24,52,609051
chr1,39769798,0.93,13,1,14,609052
chr1,39769878,0.83,15,3,18,609053
chr1,39769974,0.94,72,5,77,609054
chr1,39769995,0.95,75,4,79,609055
chr1,39770133,0.88,67,9,76,609056
chr1,39770274,0.8,63,16,79,609057
chr1,39770321,0.99,90,1,91,609058
chr1,39770336,0.91,92,9,101,609059
chr1,39770380,1,100,0,100,609060
chr1,39770384,0.93,100,7,107,609061
chr1,39770424,0.95,98,5,103,609062
chr1,39770455,0.98,81,2,83,609063
chr1,39770513,0.94,68,4,72,609064
chr1,39770529,0.89,81,10,91,609065
chr1,39770556,0.62,65,40,105,609066
chr1,39770654,0.91,74,7,81,609067
chr1,39770670,0.95,81,4,85,609068
chr1,39770730,0.95,94,5,99,609069
chr1,39770761,0.94,88,6,94,609070
chr1,39770793,1,86,0,86,609071
chr1,39771248,0.59,70,48,118,609072
chr1,39771362,0.86,57,9,66,609073
chr1,39771854,0.97,36,1,37,609074
chr1,39771870,1,47,0,47,609075
chr1,39771924,0.93,70,5,75,609076
chr1,39771956,0.88,57,8,65,609077
chr1,39771988,0.93,41,3,44,609078
chr1,39772019,0.94,31,2,33,609079
chr1,39772051,0.92,35,3,38,609080
chr1,39772079,0.98,57,1,58,609081
chr1,39772352,0.63,55,33,88,609082
chr1,39772707,0.91,63,6,69,609083
chr1,39772793,1,61,0,61,609084
chr1,39772798,0.94,61,4,65,609085
chr1,39772842,0.93,66,5,71,609086
chr1,39773037,0.92,99,9,108,609087
chr1,39773057,0.93,107,8,115,609088
chr1,39773207,0.81,77,18,95,609089
chr1,39773275,1,58,0,58,609090
chr1,39773283,0.86,43,7,50,609091
chr1,39773305,0.98,42,1,43,609092
chr1,39773307,0.98,45,1,46,609093
chr1,39773369,0.9,55,6,61,609094
chr1,39773434,0.96,47,2,49,609095
chr1,39773479,0.98,62,1,63,609096
chr1,39773607,0.92,36,3,39,609097
chr1,39773610,0.89,39,5,44,609098
chr1,39773615,0.95,38,2,40,609099
chr1,39773637,0.93,50,4,54,609100
chr1,39773645,0.96,48,2,50,609101
chr1,39773653,0.98,47,1,48,609102
chr1,39773688,0.99,74,1,75,609103
chr1,39773701,1,60,0,60,609104
chr1,39773733,0.97,64,2,66,609105
chr1,39773766,0.94,46,3,49,609106
chr1,39773811,1,49,0,49,609107
chr1,39773827,0.98,52,1,53,609108
chr1,39773855,0.94,68,4,72,609109
chr1,39773867,1,79,0,79,609110
chr1,39774103,0.86,84,14,98,609111
chr1,39774205,0.96,78,3,81,609112
chr1,39774390,0.94,29,2,31,609113
chr1,39774420,0.92,49,4,53,609114
chr1,39774430,0.96,50,2,52,609115
chr1,39774555,0.94,34,2,36,609116
chr1,39774574,0.98,49,1,50,609117
chr1,39774870,0.84,88,17,105,609118
chr1,39774974,1,48,0,48,609119
chr1,39775061,0.94,77,5,82,609120
chr1,39775245,0.81,81,19,100,609121
chr1,39775327,0.97,94,3,97,609122
chr1,39775502,0.94,107,7,114,609123
chr1,39775805,0.91,89,9,98,609124
chr1,39775920,0.89,74,9,83,609125
chr1,39775998,0.85,92,16,108,609126
chr1,39776028,0.97,99,3,102,609127
chr1,39776034,0.98,98,2,100,609128
chr1,39776067,0.99,82,1,83,609129
chr1,39776221,0.81,61,14,75,609130
chr1,39776467,0.57,71,54,125,609131
chr1,39776556,0.87,118,17,135,609132
chr1,39776562,0.91,116,12,128,609133
chr1,39776595,0.72,96,38,134,609134
chr1,39776825,0.71,73,30,103,609135
chr1,39777158,0.86,107,17,124,609136
chr1,39777366,0.59,85,58,143,609137
chr1,39777796,0.88,57,8,65,609138
chr1,39777810,0.94,63,4,67,609139
chr1,39778213,0.56,48,38,86,609140
chr1,39778234,0.47,35,39,74,609141
chr1,39778271,0.94,61,4,65,609142
chr1,39778294,0.97,65,2,67,609143
chr1,39778309,0.94,59,4,63,609144
chr1,39778421,0.96,51,2,53,609145
chr1,39778445,0.89,54,7,61,609146
chr1,39778551,0.95,71,4,75,609147
chr1,39779129,0.64,50,28,78,609148
chr1,39779818,0.97,60,2,62,609149
chr1,39779909,0.94,61,4,65,609150
chr1,39779949,0.98,59,1,60,609151
chr1,39780005,1,42,0,42,609152
chr1,39780012,1,40,0,40,609153
chr1,39780035,0.97,32,1,33,609154
chr1,39780068,1,35,0,35,609155
chr1,39780140,0.96,66,3,69,609156
chr1,39780169,0.88,59,8,67,609157
chr1,39780550,0.92,100,9,109,609158
chr1,39781036,0.49,57,59,116,609159
chr1,39781293,0.82,89,20,109,609160
chr1,39781769,0.98,58,1,59,609161
chr1,39782088,0.84,111,21,132,609162
chr1,39782191,0.92,93,8,101,609163
chr1,39782199,0.94,96,6,102,609164
chr1,39782804,0.88,83,11,94,609165
chr1,39782979,0.76,70,22,92,609166
chr1,39782994,0.9,80,9,89,609167
chr1,39783012,0.98,80,2,82,609168
chr1,39783045,0.79,75,20,95,609169
chr1,39783054,0.81,90,21,111,609170
chr1,39783071,0.36,39,69,108,609171
chr1,39783078,0.47,49,55,104,609172
chr1,39783248,0.98,88,2,90,609173
chr1,39783988,0.96,81,3,84,609174
chr1,39783998,0.85,74,13,87,609175
chr1,39784015,0.8,59,15,74,609176
chr1,39784168,0.38,42,69,111,609177
chr1,39784265,0.89,81,10,91,609178
chr1,39784286,0.68,58,27,85,609179
chr1,39784310,0.97,73,2,75,609180
chr1,39784431,0.83,45,9,54,609181
chr1,39784879,0.66,67,35,102,609182
chr1,39784962,0.79,93,25,118,609183
chr1,39785047,0.79,68,18,86,609184
chr1,39785102,1,64,0,64,609185
chr1,39785609,0.62,56,34,90,609186
chr1,39785646,0.84,64,12,76,609187
chr1,39785824,0.97,86,3,89,609188
chr1,39785868,0.85,85,15,100,609189
chr1,39786260,0.97,85,3,88,609190
chr1,39786298,0.96,87,4,91,609191
chr1,39786588,0.74,52,18,70,609192
chr1,39787162,0.23,23,76,99,609193
chr1,39787290,0.94,98,6,104,609194
chr1,39787390,0.92,114,10,124,609195
chr1,39787643,0.96,88,4,92,609196
chr1,39787893,0.99,68,1,69,609197
chr1,39788189,0.66,61,31,92,609198
chr1,39788260,0.98,84,2,86,609199
chr1,39788323,0.71,55,22,77,609200
chr1,39788346,0.95,54,3,57,609201
chr1,39788349,0.95,56,3,59,609202
chr1,39788352,0.88,53,7,60,609203
chr1,39788550,0.83,104,21,125,609204
chr1,39788600,0.97,130,4,134,609205
chr1,39788607,0.92,123,11,134,609206
chr1,39788635,0.91,94,9,103,609207
chr1,39788660,0.96,75,3,78,609208
chr1,39788663,0.95,73,4,77,609209
chr1,39788739,0.96,77,3,80,609210
chr1,39789035,0.88,77,11,88,609211
chr1,39789276,0.83,85,17,102,609212
chr1,39789808,0.96,93,4,97,609213
chr1,39789938,0.95,104,5,109,609214
chr1,39789969,0.93,96,7,103,609215
chr1,39790542,0.76,110,34,144,609216
chr1,39790713,0.98,117,3,120,609217
chr1,39790795,0.93,125,9,134,609218
chr1,39791102,0.94,87,6,93,609219
chr1,39791236,0.88,103,14,117,609220
chr1,39791426,0.94,103,6,109,609221
chr1,39791512,0.96,67,3,70,609222
chr1,39791721,0.96,93,4,97,609223
chr1,39791944,0.97,77,2,79,609224
chr1,39792070,0.95,70,4,74,609225
chr1,39792080,0.99,69,1,70,609226
chr1,39792090,0.99,66,1,67,609227
chr1,39792123,0.98,56,1,57,609228
chr1,39792150,0.96,49,2,51,609229
chr1,39792221,0.99,83,1,84,609230
chr1,39792227,0.96,66,3,69,609231
chr1,39792245,0.99,77,1,78,609232
chr1,39792307,1,63,0,63,609233
chr1,39792339,1,33,0,33,609234
chr1,39792769,0.92,80,7,87,609235
chr1,39793492,0.96,75,3,78,609236
chr1,39793626,0.89,92,11,103,609237
chr1,39793750,0.71,92,37,129,609238
chr1,39794020,0.07,5,68,73,609239
chr1,39794236,0.08,6,66,72,609240
chr1,39794274,0.5,44,44,88,609241
chr1,39794285,0.28,25,63,88,609242
chr1,39794318,0.18,16,72,88,609243
chr1,39794362,0.36,31,55,86,609244
chr1,39795026,0.9,91,10,101,609245
chr1,39795506,0.97,108,3,111,609246
chr1,39795531,0.9,90,10,100,609247
chr1,39796165,0.95,102,5,107,609248
chr1,39796195,0.97,88,3,91,609249
chr1,39796385,0.5,57,56,113,609250
chr1,39796504,0.86,18,3,21,609251
chr1,39796566,0.83,55,11,66,609252
chr1,39796620,0.95,78,4,82,609253
chr1,39796660,0.89,78,10,88,609254
chr1,39796737,0.78,59,17,76,609255
chr1,39797026,0.63,59,35,94,609256
chr1,39797097,0.74,68,24,92,609257
chr1,39797406,0.95,105,5,110,609258
chr1,39797490,0.9,91,10,101,609259
chr1,39797508,0.84,81,15,96,609260
chr1,39797550,0.94,93,6,99,609261
chr1,39797713,0.88,75,10,85,609262
chr1,39797771,0.92,57,5,62,609263
chr1,39797907,0.9,97,11,108,609264
chr1,39798016,0.92,80,7,87,609265
chr1,39798100,0.43,46,62,108,609266
chr1,39798416,0.98,93,2,95,609267
chr1,39798420,0.86,85,14,99,609268
chr1,39798676,0.98,64,1,65,609269
chr1,39798688,0.77,56,17,73,609270
chr1,39799007,0.98,93,2,95,609271
chr1,39799040,0.91,74,7,81,609272
chr1,39799200,0.45,52,64,116,609273
chr1,39799226,0.29,39,94,133,609274
chr1,39799389,0.97,103,3,106,609275
chr1,39799506,0.82,78,17,95,609276
chr1,39799556,0.89,87,11,98,609277
chr1,39799742,0.94,90,6,96,609278
chr1,39799746,0.93,91,7,98,609279
chr1,39799856,0.94,84,5,89,609280
chr1,39799912,0.94,93,6,99,609281
chr1,39800123,0.86,72,12,84,609282
chr1,39800240,0.99,91,1,92,609283
chr1,39800299,0.99,129,1,130,609284
chr1,39800561,0.97,135,4,139,609285
chr1,39800817,0.66,60,31,91,609286
chr1,39801118,0.46,66,78,144,609287
chr1,39801133,0.86,115,18,133,609288
chr1,39801168,0.64,76,43,119,609289
chr1,39801531,0.73,84,31,115,609290
chr1,39801718,0.94,105,7,112,609291
chr1,39802564,0.72,108,41,149,609292
chr1,39802817,0.3,40,93,133,609293
chr1,39802866,0.69,93,42,135,609294
chr1,39802920,0.89,101,13,114,609295
chr1,39803168,0.9,56,6,62,609296
chr1,39803298,0.85,47,8,55,609297
chr1,39803307,0.96,49,2,51,609298
chr1,39803324,1,65,0,65,609299
chr1,39803331,0.95,69,4,73,609300
chr1,39803363,0.99,75,1,76,609301
chr1,39803373,0.99,73,1,74,609302
chr1,39803390,0.99,68,1,69,609303
chr1,39803395,0.97,66,2,68,609304
chr1,39803502,0.96,26,1,27,609305
chr1,39803510,0.91,21,2,23,609306
chr1,39803534,0.91,30,3,33,609307
chr1,39803542,1,35,0,35,609308
chr1,39803586,1,51,0,51,609309
chr1,39803593,0.93,55,4,59,609310
chr1,39803598,0.93,54,4,58,609311
chr1,39803631,0.9,71,8,79,609312
chr1,39803642,0.95,73,4,77,609313
chr1,39803676,0.96,95,4,99,609314
chr1,39803692,0.98,87,2,89,609315
chr1,39803732,0.98,83,2,85,609316
chr1,39803736,0.93,83,6,89,609317
chr1,39803758,0.96,81,3,84,609318
chr1,39804023,0.97,68,2,70,609319
chr1,39804167,0.92,82,7,89,609320
chr1,39804267,0.93,69,5,74,609321
chr1,39804424,0.99,68,1,69,609322
chr1,39804908,0.63,31,18,49,609323
chr1,39805051,0.58,51,37,88,609324
chr1,39805183,0.86,106,17,123,609325
chr1,39805302,0.76,79,25,104,609326
chr1,39805430,0.7,68,29,97,609327
chr1,39805587,0.93,77,6,83,609328
chr1,39805643,0.9,78,9,87,609329
chr1,39805758,0.73,74,27,101,609330
chr1,39805762,0.84,83,16,99,609331
chr1,39806512,0.79,67,18,85,609332
chr1,39806728,0.95,35,2,37,609333
chr1,39806791,0.97,63,2,65,609334
chr1,39806808,1,87,0,87,609335
chr1,39806850,1,89,0,89,609336
chr1,39806862,0.96,89,4,93,609337
chr1,39806866,0.96,90,4,94,609338
chr1,39806894,1,71,0,71,609339
chr1,39806925,1,52,0,52,609340
chr1,39806948,0.98,44,1,45,609341
chr1,39806957,0.98,44,1,45,609342
chr1,39807001,0.91,63,6,69,609343
chr1,39807089,0.95,70,4,74,609344
chr1,39807133,0.97,65,2,67,609345
chr1,39807138,0.97,61,2,63,609346
chr1,39807196,0.84,56,11,67,609347
chr1,39807226,0.94,80,5,85,609348
chr1,39807230,0.93,77,6,83,609349
chr1,39807246,0.99,85,1,86,609350
chr1,39807284,0.95,83,4,87,609351
chr1,39807324,0.99,83,1,84,609352
chr1,39807326,0.95,77,4,81,609353
chr1,39807357,0.93,80,6,86,609354
chr1,39807365,0.91,86,8,94,609355
chr1,39807508,0.89,94,12,106,609356
chr1,39807545,0.94,87,6,93,609357
chr1,39807902,0.94,87,6,93,609358
chr1,39808092,0.94,103,6,109,609359
chr1,39808135,0.97,92,3,95,609360
chr1,39808138,0.99,97,1,98,609361
chr1,39808271,0.98,50,1,51,609362
chr1,39808305,1,56,0,56,609363
chr1,39808398,0.98,50,1,51,609364
chr1,39808411,0.96,53,2,55,609365
chr1,39808481,0.93,76,6,82,609366
chr1,39808483,0.9,75,8,83,609367
chr1,39808659,0.62,74,45,119,609368
chr1,39808931,0.96,73,3,76,609369
chr1,39809051,0.91,96,9,105,609370
chr1,39809399,0.97,97,3,100,609371
chr1,39809418,0.94,92,6,98,609372
chr1,39809515,0.94,46,3,49,609373
chr1,39809525,0.95,38,2,40,609374
chr1,39809553,1,23,0,23,609375
chr1,39809558,0.96,23,1,24,609376
chr1,39809562,0.92,12,1,13,609377
chr1,39809577,0.94,17,1,18,609378
chr1,39809616,0.94,32,2,34,609379
chr1,39809647,0.93,50,4,54,609380
chr1,39809679,0.97,58,2,60,609381
chr1,39809711,0.95,57,3,60,609382
chr1,39809735,1,45,0,45,609383
chr1,39809743,0.98,46,1,47,609384
chr1,39809823,0.98,50,1,51,609385
chr1,39809863,0.97,68,2,70,609386
chr1,39809869,0.96,66,3,69,609387
chr1,39810018,0.54,44,38,82,609388
chr1,39810028,0.48,40,44,84,609389
chr1,39810058,0.63,46,27,73,609390
chr1,39810090,0.8,45,11,56,609391
chr1,39810092,0.69,37,17,54,609392
chr1,39810170,0.39,25,39,64,609393
chr1,39810248,0.5,26,26,52,609394
chr1,39810324,0.73,33,12,45,609395
chr1,39810371,0.67,41,20,61,609396
chr1,39810389,0.77,49,15,64,609397
chr1,39810393,0.78,49,14,63,609398
chr1,39810449,0.95,78,4,82,609399
chr1,39810467,0.88,84,12,96,609400
chr1,39810555,0.93,80,6,86,609401
chr1,39810604,0.91,71,7,78,609402
chr1,39811071,0.95,109,6,115,609403
chr1,39811157,0.87,97,14,111,609404
chr1,39811300,0.96,87,4,91,609405
chr1,39811462,0.95,81,4,85,609406
chr1,39811466,0.87,71,11,82,609407
chr1,39811477,0.96,75,3,78,609408
chr1,39811529,0.99,67,1,68,609409
chr1,39811537,0.96,65,3,68,609410
chr1,39811689,0.97,74,2,76,609411
chr1,39811773,0.96,48,2,50,609412
chr1,39811806,0.96,53,2,55,609413
chr1,39811831,0.96,69,3,72,609414
chr1,39811890,0.92,66,6,72,609415
chr1,39811902,0.96,71,3,74,609416
chr1,39811906,0.96,66,3,69,609417
chr1,39811926,0.95,61,3,64,609418
chr1,39811982,0.98,55,1,56,609419
chr1,39811990,1,54,0,54,609420
chr1,39812020,1,65,0,65,609421
chr1,39812222,0.97,34,1,35,609422
chr1,39812260,0.91,49,5,54,609423
chr1,39812268,0.98,51,1,52,609424
chr1,39812284,0.98,51,1,52,609425
chr1,39812292,1,46,0,46,609426
chr1,39812336,0.96,24,1,25,609427
chr1,39812348,1,21,0,21,609428
chr1,39812381,0.92,11,1,12,609429
chr1,39812392,1,14,0,14,609430
chr1,39812480,0.97,69,2,71,609431
chr1,39812757,0.83,105,22,127,609432
chr1,39813157,0.99,71,1,72,609433
chr1,39813250,0.91,60,6,66,609434
chr1,39813390,0.95,90,5,95,609435
chr1,39813468,0.96,82,3,85,609436
chr1,39813911,0.94,84,5,89,609437
chr1,39814338,0.96,74,3,77,609438
chr1,39814607,0.64,58,32,90,609439
chr1,39814686,0.96,76,3,79,609440
chr1,39814997,0.97,114,3,117,609441
chr1,39815115,0.91,77,8,85,609442
chr1,39815335,0.97,66,2,68,609443
chr1,39815343,0.99,68,1,69,609444
chr1,39815389,0.97,67,2,69,609445
chr1,39815521,0.98,85,2,87,609446
chr1,39815550,0.78,78,22,100,609447
chr1,39815622,0.96,109,5,114,609448
chr1,39815882,0.91,99,10,109,609449
chr1,39815986,0.93,100,7,107,609450
chr1,39816002,0.84,91,17,108,609451
chr1,39816084,0.94,87,6,93,609452
chr1,39816144,0.78,69,19,88,609453
chr1,39816422,0.9,84,9,93,609454
chr1,39816481,0.88,100,13,113,609455
chr1,39816556,0.8,88,22,110,609456
chr1,39816574,0.93,103,8,111,609457
chr1,39816611,0.97,90,3,93,609458
chr1,39816628,0.84,78,15,93,609459
chr1,39816666,0.97,83,3,86,609460
chr1,39816708,0.9,70,8,78,609461
chr1,39816845,0.95,62,3,65,609462
chr1,39816887,0.92,68,6,74,609463
chr1,39817368,0.59,34,24,58,609464
chr1,39817511,0.77,72,22,94,609465
chr1,39817651,0.72,60,23,83,609466
chr1,39817670,0.72,56,22,78,609467
chr1,39817680,0.71,54,22,76,609468
chr1,39817689,0.83,71,15,86,609469
chr1,39817786,0.87,66,10,76,609470
chr1,39818056,0.95,58,3,61,609471
chr1,39818103,0.89,58,7,65,609472
chr1,39818223,0.72,47,18,65,609473
chr1,39818231,0.97,66,2,68,609474
chr1,39818252,0.93,65,5,70,609475
chr1,39818292,0.97,70,2,72,609476
chr1,39818299,0.79,54,14,68,609477
chr1,39818390,0.65,49,26,75,609478
chr1,39818666,0.9,84,9,93,609479
chr1,39818720,0.92,93,8,101,609480
chr1,39818803,0.81,64,15,79,609481
chr1,39819287,0.85,99,18,117,609482
chr1,39819299,0.66,79,40,119,609483
chr1,39819927,0.94,94,6,100,609484
chr1,39820139,0.98,60,1,61,609485
chr1,39820153,0.97,66,2,68,609486
chr1,39820310,0.73,47,17,64,609487
chr1,39820405,0.79,66,18,84,609488
chr1,39820454,0.65,68,37,105,609489
chr1,39820836,0.91,86,8,94,609490
chr1,39820843,0.93,90,7,97,609491
chr1,39821066,0.98,49,1,50,609492
chr1,39821162,0.94,15,1,16,609493
chr1,39821207,0.79,42,11,53,609494
chr1,39821231,0.84,68,13,81,609495
chr1,39821286,0.95,82,4,86,609496
chr1,39821326,0.96,88,4,92,609497
chr1,39821357,0.98,85,2,87,609498
chr1,39821371,0.93,83,6,89,609499
chr1,39821382,0.93,82,6,88,609500
chr1,39821415,0.9,81,9,90,609501
chr1,39821427,0.97,89,3,92,609502
chr1,39821497,0.98,107,2,109,609503
chr1,39821705,0.78,64,18,82,609504
chr1,39822294,0.97,77,2,79,609505
chr1,39822437,1,80,0,80,609506
chr1,39822470,0.93,82,6,88,609507
chr1,39822507,0.79,77,20,97,609508
chr1,39822569,0.9,90,10,100,609509
chr1,39822631,0.82,78,17,95,609510
chr1,39823050,0.78,62,18,80,609511
chr1,39823305,0.86,74,12,86,609512
chr1,39823310,0.94,81,5,86,609513
chr1,39823352,0.89,57,7,64,609514
chr1,39823377,0.91,41,4,45,609515
chr1,39823982,1,76,0,76,609516
chr1,39824375,0.42,37,51,88,609517
chr1,39824473,0.4,49,74,123,609518
chr1,39824597,0.65,50,27,77,609519
chr1,39824748,0.25,28,84,112,609520
chr1,39824873,0.08,6,66,72,609521
chr1,39825278,0.76,93,30,123,609522
chr1,39825353,0.98,79,2,81,609523
chr1,39825364,0.99,68,1,69,609524
chr1,39825368,0.98,64,1,65,609525
chr1,39825408,0.98,51,1,52,609526
chr1,39825413,0.9,44,5,49,609527
chr1,39825424,0.92,44,4,48,609528
chr1,39825438,1,46,0,46,609529
chr1,39825469,0.92,49,4,53,609530
chr1,39825531,0.98,54,1,55,609531
chr1,39825590,0.98,54,1,55,609532
chr1,39825613,0.08,3,34,37,609533
chr1,39825637,0.52,14,13,27,609534
chr1,39825653,0.56,10,8,18,609535
chr1,39825785,0.63,27,16,43,609536
chr1,39825908,0.55,47,39,86,609537
chr1,39825940,0.61,51,32,83,609538
chr1,39826512,0.97,96,3,99,609539
chr1,39826921,0.77,74,22,96,609540
chr1,39827015,0.65,64,35,99,609541
chr1,39827053,0.82,78,17,95,609542
chr1,39827080,0.68,68,32,100,609543
chr1,39827095,0.8,74,19,93,609544
chr1,39827164,0.89,56,7,63,609545
chr1,39827169,0.84,53,10,63,609546
chr1,39827287,0.28,26,66,92,609547
chr1,39827422,0.95,70,4,74,609548
chr1,39827489,0.77,73,22,95,609549
chr1,39827881,0.81,55,13,68,609550
chr1,39827980,0.9,69,8,77,609551
chr1,39828232,0.71,53,22,75,609552
chr1,39828250,0.68,52,25,77,609553
chr1,39828551,0.94,80,5,85,609554
chr1,39829137,0.89,81,10,91,609555
chr1,39829312,0.94,49,3,52,609556
chr1,39829344,0.85,61,11,72,609557
chr1,39829438,0.68,68,32,100,609558
chr1,39829530,0.95,75,4,79,609559
chr1,39829535,0.8,63,16,79,609560
chr1,39829597,0.68,65,31,96,609561
chr1,39829624,0.95,88,5,93,609562
chr1,39829937,0.99,119,1,120,609563
chr1,39830161,0.71,53,22,75,609564
chr1,39830208,0,0,15,15,609565
chr1,39830225,1,12,0,12,609566
chr1,39830227,0.83,10,2,12,609567
chr1,39830233,0.94,17,1,18,609568
chr1,39830257,0.96,24,1,25,609569
chr1,39830265,0.96,27,1,28,609570
chr1,39830319,1,26,0,26,609571
chr1,39830321,0.96,22,1,23,609572
chr1,39830354,1,4,0,4,609573
chr1,39830365,1,2,0,2,609574
chr1,39830385,1,6,0,6,609575
chr1,39830399,1,10,0,10,609576
chr1,39830406,1,16,0,16,609577
chr1,39830410,1,24,0,24,609578
chr1,39830443,0.98,40,1,41,609579
chr1,39830453,0.98,42,1,43,609580
chr1,39830455,0.95,40,2,42,609581
chr1,39830459,0.98,44,1,45,609582
chr1,39830463,0.96,48,2,50,609583
chr1,39830771,0.95,62,3,65,609584
chr1,39830790,0.84,53,10,63,609585
chr1,39830811,0.96,67,3,70,609586
chr1,39830892,0.94,49,3,52,609587
chr1,39830896,0.96,51,2,53,609588
chr1,39830904,0.98,47,1,48,609589
chr1,39830969,1,43,0,43,609590
chr1,39830983,1,51,0,51,609591
chr1,39831450,0.97,97,3,100,609592
chr1,39831504,0.86,71,12,83,609593
chr1,39831536,0.94,68,4,72,609594
chr1,39831567,0.96,66,3,69,609595
chr1,39831593,0.9,66,7,73,609596
chr1,39831898,0.97,74,2,76,609597
chr1,39831932,0.96,85,4,89,609598
chr1,39832318,0.92,82,7,89,609599
chr1,39832331,0.89,71,9,80,609600
chr1,39832435,0.97,61,2,63,609601
chr1,39832452,0.97,66,2,68,609602
chr1,39832567,0.95,52,3,55,609603
chr1,39832642,0.91,31,3,34,609604
chr1,39832710,0.53,47,41,88,609605
chr1,39832767,0.98,91,2,93,609606
chr1,39832807,0.93,88,7,95,609607
chr1,39832898,0.85,71,13,84,609608
chr1,39832908,0.95,79,4,83,609609
chr1,39833128,0.98,89,2,91,609610
chr1,39833150,0.97,86,3,89,609611
chr1,39833346,0.86,72,12,84,609612
chr1,39833378,0.93,67,5,72,609613
chr1,39833534,0.93,95,7,102,609614
chr1,39833556,0.98,107,2,109,609615
chr1,39833573,0.98,93,2,95,609616
chr1,39833598,0.99,72,1,73,609617
chr1,39833905,0.83,92,19,111,609618
chr1,39834318,0.98,79,2,81,609619
chr1,39834362,0.91,75,7,82,609620
chr1,39834393,0.93,84,6,90,609621
chr1,39834415,0.98,87,2,89,609622
chr1,39834426,0.97,89,3,92,609623
chr1,39834747,0.97,58,2,60,609624
chr1,39834997,0.58,47,34,81,609625
chr1,39835295,0.12,11,78,89,609626
chr1,39835371,0.07,7,99,106,609627
chr1,39835532,0.15,14,81,95,609628
chr1,39835549,0.12,12,86,98,609629
chr1,39835745,0.06,8,117,125,609630
chr1,39835806,0.09,10,99,109,609631
chr1,39835992,0.13,11,76,87,609632
chr1,39836246,0.16,12,63,75,609633
chr1,39836390,0.06,6,100,106,609634
chr1,39836717,0.07,5,63,68,609635
chr1,39836730,0.03,2,73,75,609636
chr1,39836758,0.01,1,67,68,609637
chr1,39836763,0.05,3,54,57,609638
chr1,39836780,0.05,3,61,64,609639
chr1,39836827,0.04,3,72,75,609640
chr1,39836851,0.11,9,75,84,609641
chr1,39837238,0.38,30,50,80,609642
chr1,39837284,0.64,51,29,80,609643
chr1,39837508,0.09,4,43,47,609644
chr1,39837541,0.13,9,62,71,609645
chr1,39837554,0.11,9,76,85,609646
chr1,39837597,0.35,39,74,113,609647
chr1,39837605,0.99,98,1,99,609648
chr1,39837615,0.96,90,4,94,609649
chr1,39837626,0.93,75,6,81,609650
chr1,39837642,0.89,56,7,63,609651
chr1,39837646,0.9,61,7,68,609652
chr1,39837679,0.86,30,5,35,609653
chr1,39837695,0.66,19,10,29,609654
chr1,39837737,0.98,46,1,47,609655
chr1,39838626,0.97,56,2,58,609656
chr1,39838706,0.97,67,2,69,609657
chr1,39838753,0.97,35,1,36,609658
chr1,39838760,1,30,0,30,609659
chr1,39838794,0.93,13,1,14,609660
chr1,39838846,0.89,16,2,18,609661
chr1,39838896,0.98,52,1,53,609662
chr1,39838913,0.93,51,4,55,609663
chr1,39838921,0.98,54,1,55,609664
chr1,39838955,0.96,52,2,54,609665
chr1,39838997,0.9,46,5,51,609666
chr1,39839011,0.97,56,2,58,609667
chr1,39839033,0.96,65,3,68,609668
chr1,39839091,0.85,71,13,84,609669
chr1,39839314,0.93,50,4,54,609670
chr1,39839449,0.98,65,1,66,609671
chr1,39839479,0.96,52,2,54,609672
chr1,39839503,0.95,42,2,44,609673
chr1,39839506,1,46,0,46,609674
chr1,39839510,0.96,44,2,46,609675
chr1,39839651,0.92,77,7,84,609676
chr1,39839786,1,73,0,73,609677
chr1,39839838,0.94,76,5,81,609678
chr1,39839870,0.99,85,1,86,609679
chr1,39839892,0.85,73,13,86,609680
chr1,39839900,0.96,85,4,89,609681
chr1,39839966,0.83,75,15,90,609682
chr1,39840033,0.96,87,4,91,609683
chr1,39840159,0.94,100,6,106,609684
chr1,39840175,0.79,85,22,107,609685
chr1,39840477,1,83,0,83,609686
chr1,39840504,0.94,83,5,88,609687
chr1,39840508,0.99,84,1,85,609688
chr1,39840520,0.98,85,2,87,609689
chr1,39840548,0.99,88,1,89,609690
chr1,39840553,0.98,84,2,86,609691
chr1,39840578,0.99,80,1,81,609692
chr1,39840609,0.92,65,6,71,609693
chr1,39840650,1,37,0,37,609694
chr1,39840674,1,19,0,19,609695
chr1,39840706,1,9,0,9,609696
chr1,39840736,1,16,0,16,609697
chr1,39840768,1,29,0,29,609698
chr1,39840913,0.99,68,1,69,609699
chr1,39840996,0.91,39,4,43,609700
chr1,39841004,0.89,42,5,47,609701
chr1,39841036,0.95,38,2,40,609702
chr1,39841042,0.9,36,4,40,609703
chr1,39841130,0.85,17,3,20,609704
chr1,39841616,0.57,60,46,106,609705
chr1,39841633,0.57,59,44,103,609706
chr1,39841967,0.45,41,51,92,609707
chr1,39842082,0.97,86,3,89,609708
chr1,39842110,0.89,80,10,90,609709
chr1,39842242,0.65,64,34,98,609710
chr1,39842329,0.67,64,31,95,609711
chr1,39842418,0.98,59,1,60,609712
chr1,39842442,0.96,66,3,69,609713
chr1,39842488,0.98,85,2,87,609714
chr1,39842595,0.85,40,7,47,609715
chr1,39842651,0.98,61,1,62,609716
chr1,39842721,0.96,74,3,77,609717
chr1,39842737,1,74,0,74,609718
chr1,39842775,0.97,69,2,71,609719
chr1,39842785,0.97,65,2,67,609720
chr1,39842827,0.95,57,3,60,609721
chr1,39842831,1,61,0,61,609722
chr1,39842882,0.99,66,1,67,609723
chr1,39842902,0.97,59,2,61,609724
chr1,39842973,0.99,70,1,71,609725
chr1,39842975,0.96,67,3,70,609726
chr1,39842979,0.97,67,2,69,609727
chr1,39843403,0.93,56,4,60,609728
chr1,39843441,0.97,36,1,37,609729
chr1,39843465,0.89,24,3,27,609730
chr1,39843504,0.85,33,6,39,609731
chr1,39843532,0.74,48,17,65,609732
chr1,39843548,0.96,69,3,72,609733
chr1,39843624,0.93,63,5,68,609734
chr1,39843638,0.9,54,6,60,609735
chr1,39843859,0.96,99,4,103,609736
chr1,39843904,0.79,97,26,123,609737
chr1,39843957,0.61,65,42,107,609738
chr1,39844092,0.11,10,79,89,609739
chr1,39844176,0.45,57,69,126,609740
chr1,39844832,0.94,109,7,116,609741
chr1,39844881,0.91,99,10,109,609742
chr1,39844949,0.62,52,32,84,609743
chr1,39845376,0.89,92,11,103,609744
chr1,39845599,0.88,80,11,91,609745
chr1,39846489,0.92,84,7,91,609746
chr1,39846494,0.7,62,27,89,609747
chr1,39846593,0.76,61,19,80,609748
chr1,39846798,0.98,47,1,48,609749
chr1,39846806,0.98,46,1,47,609750
chr1,39846815,1,42,0,42,609751
chr1,39846832,0.98,46,1,47,609752
chr1,39846854,0.98,45,1,46,609753
chr1,39846878,1,49,0,49,609754
chr1,39846890,0.92,55,5,60,609755
chr1,39846948,0.98,45,1,46,609756
chr1,39846956,0.95,36,2,38,609757
chr1,39846980,0.91,29,3,32,609758
chr1,39847123,0.98,50,1,51,609759
chr1,39847331,0.96,77,3,80,609760
chr1,39847374,0.92,90,8,98,609761
chr1,39847399,0.95,100,5,105,609762
chr1,39847456,0.67,56,28,84,609763
chr1,39847522,0.5,31,31,62,609764
chr1,39847630,0.1,7,64,71,609765
chr1,39847663,0.08,7,78,85,609766
chr1,39847729,0.08,8,93,101,609767
chr1,39847733,0.04,4,94,98,609768
chr1,39848102,0.95,61,3,64,609769
chr1,39848142,0.91,39,4,43,609770
chr1,39848151,0.98,39,1,40,609771
chr1,39848236,0.95,58,3,61,609772
chr1,39848328,0.9,43,5,48,609773
chr1,39848340,0.96,43,2,45,609774
chr1,39848348,1,41,0,41,609775
chr1,39848429,0.98,101,2,103,609776
chr1,39848514,0.94,89,6,95,609777
chr1,39848649,0.93,57,4,61,609778
chr1,39848653,0.94,58,4,62,609779
chr1,39848685,0.93,78,6,84,609780
chr1,39848719,0.87,71,11,82,609781
chr1,39848878,0.99,84,1,85,609782
chr1,39849024,0.89,96,12,108,609783
chr1,39849196,0.95,100,5,105,609784
chr1,39849234,0.97,101,3,104,609785
chr1,39849271,0.99,89,1,90,609786
chr1,39849277,0.96,82,3,85,609787
chr1,39849331,0.98,82,2,84,609788
chr1,39849345,0.97,72,2,74,609789
chr1,39849405,0.97,58,2,60,609790
chr1,39849417,0.95,53,3,56,609791
chr1,39849441,1,63,0,63,609792
chr1,39849473,0.96,66,3,69,609793
chr1,39849480,1,67,0,67,609794
chr1,39849497,0.97,65,2,67,609795
chr1,39849503,0.97,64,2,66,609796
chr1,39849535,1,63,0,63,609797
chr1,39849543,0.89,49,6,55,609798
chr1,39849640,0.73,74,27,101,609799
chr1,39849687,1,75,0,75,609800
chr1,39849825,0.71,58,24,82,609801
chr1,39849891,0.86,100,16,116,609802
chr1,39849934,0.97,110,3,113,609803
chr1,39850011,0.61,70,45,115,609804
chr1,39850359,0.33,37,75,112,609805
chr1,39850521,0.1,12,106,118,609806
chr1,39850824,0.8,72,18,90,609807
chr1,39850849,0.76,78,24,102,609808
chr1,39850864,0.93,95,7,102,609809
chr1,39850896,0.92,70,6,76,609810
chr1,39850928,0.83,50,10,60,609811
chr1,39850936,0.95,54,3,57,609812
chr1,39850941,0.63,40,23,63,609813
chr1,39850991,0.89,63,8,71,609814
chr1,39851009,0.84,71,14,85,609815
chr1,39851130,0.69,55,25,80,609816
chr1,39851277,0.43,41,55,96,609817
chr1,39851370,0.36,48,87,135,609818
chr1,39851445,0.49,61,64,125,609819
chr1,39851471,0.19,23,101,124,609820
chr1,39851498,0.89,123,15,138,609821
chr1,39851553,0.86,107,17,124,609822
chr1,39851698,0.9,78,9,87,609823
chr1,39851957,0.6,32,21,53,609824
chr1,39851963,1,57,0,57,609825
chr1,39851995,0.97,68,2,70,609826
chr1,39852081,0.94,58,4,62,609827
chr1,39852166,0.91,69,7,76,609828
chr1,39852189,1,85,0,85,609829
chr1,39852197,0.96,90,4,94,609830
chr1,39852250,0.97,103,3,106,609831
chr1,39852292,0.99,80,1,81,609832
chr1,39852323,0.97,66,2,68,609833
chr1,39852337,0.92,58,5,63,609834
chr1,39852348,1,59,0,59,609835
chr1,39852381,0.97,59,2,61,609836
chr1,39852391,1,64,0,64,609837
chr1,39852425,0.9,56,6,62,609838
chr1,39852532,0.93,65,5,70,609839
chr1,39852625,0.65,50,27,77,609840
chr1,39852686,0.87,75,11,86,609841
chr1,39852785,0.8,76,19,95,609842
chr1,39852860,0.91,105,10,115,609843
chr1,39852864,0.96,108,5,113,609844
chr1,39852996,0.96,91,4,95,609845
chr1,39853302,0.81,83,19,102,609846
chr1,39853377,0.95,94,5,99,609847
chr1,39853380,0.93,93,7,100,609848
chr1,39853455,0.74,80,28,108,609849
chr1,39853529,0.11,10,78,88,609850
chr1,39853799,0.95,93,5,98,609851
chr1,39853817,0.91,83,8,91,609852
chr1,39853893,0.89,82,10,92,609853
chr1,39853899,0.83,74,15,89,609854
chr1,39853991,0.93,83,6,89,609855
chr1,39854001,0.94,81,5,86,609856
chr1,39854024,0.94,79,5,84,609857
chr1,39854064,0.95,75,4,79,609858
chr1,39854169,0.7,53,23,76,609859
chr1,39854199,0.47,35,40,75,609860
chr1,39854240,0.91,69,7,76,609861
chr1,39854242,0.97,74,2,76,609862
chr1,39854291,0.92,59,5,64,609863
chr1,39854487,0.93,76,6,82,609864
chr1,39854613,0.85,63,11,74,609865
chr1,39854619,0.78,63,18,81,609866
chr1,39854635,0.84,67,13,80,609867
chr1,39854653,1,87,0,87,609868
chr1,39854695,0.94,75,5,80,609869
chr1,39854707,0.74,59,21,80,609870
chr1,39854736,0.18,11,51,62,609871
chr1,39854790,0.5,27,27,54,609872
chr1,39854839,0.11,9,73,82,609873
chr1,39855094,0.93,41,3,44,609874
chr1,39855123,0.96,48,2,50,609875
chr1,39855176,1,49,0,49,609876
chr1,39855188,0.96,52,2,54,609877
chr1,39855251,0.89,58,7,65,609878
chr1,39855278,0.97,67,2,69,609879
chr1,39855321,0.96,77,3,80,609880
chr1,39855362,0.87,76,11,87,609881
chr1,39855799,0.39,30,47,77,609882
chr1,39855956,0.21,27,101,128,609883
chr1,39856013,0.11,16,128,144,609884
chr1,39856027,0.12,17,124,141,609885
chr1,39856185,0.06,5,78,83,609886
chr1,39856237,0.09,7,67,74,609887
chr1,39856245,0.1,7,66,73,609888
chr1,39856501,0.94,87,6,93,609889
chr1,39856507,0.99,85,1,86,609890
chr1,39856517,0.98,79,2,81,609891
chr1,39856545,0.95,42,2,44,609892
chr1,39856550,0.98,41,1,42,609893
chr1,39856561,0.92,23,2,25,609894
chr1,39856575,1,22,0,22,609895
chr1,39856595,0.88,15,2,17,609896
chr1,39856655,0.93,38,3,41,609897
chr1,39856675,0.03,1,39,40,609898
chr1,39856739,0.9,28,3,31,609899
chr1,39857502,0.05,5,88,93,609900
chr1,39857576,0.08,7,84,91,609901
chr1,39857888,0.02,2,100,102,609902
chr1,39857950,0,0,80,80,609903
chr1,39858259,0.24,22,71,93,609904
chr1,39858712,0.27,28,77,105,609905
chr1,39858793,0.05,3,56,59,609906
chr1,39858947,0.62,37,23,60,609907
chr1,39859014,0.86,55,9,64,609908
chr1,39859278,0.79,68,18,86,609909
chr1,39859306,0.94,78,5,83,609910
chr1,39859346,0.68,76,36,112,609911
chr1,39859384,0.88,107,14,121,609912
chr1,39859410,0.84,112,21,133,609913
chr1,39859416,0.98,126,2,128,609914
chr1,39859431,0.89,97,12,109,609915
chr1,39859443,0.97,94,3,97,609916
chr1,39859453,0.92,87,8,95,609917
chr1,39859601,0.92,80,7,87,609918
chr1,39859605,0.91,77,8,85,609919
chr1,39859609,0.87,77,12,89,609920
chr1,39859652,0.93,83,6,89,609921
chr1,39859852,0.46,58,69,127,609922
chr1,39859903,0.52,57,52,109,609923
chr1,39860021,0.97,59,2,61,609924
chr1,39860031,0.63,38,22,60,609925
chr1,39860091,0.83,39,8,47,609926
chr1,39860096,0.26,12,35,47,609927
chr1,39860243,0.07,4,55,59,609928
chr1,39860249,0.05,3,55,58,609929
chr1,39860289,0.03,1,29,30,609930
chr1,39860405,0,0,68,68,609931
chr1,39860470,0.59,30,21,51,609932
chr1,39860719,0.37,21,36,57,609933
chr1,39860773,0.32,11,23,34,609934
chr1,39861185,0.01,1,92,93,609935
chr1,39861738,0.84,81,15,96,609936
chr1,39861794,0.94,88,6,94,609937
chr1,39861808,0.98,89,2,91,609938
chr1,39861848,0.72,75,29,104,609939
chr1,39861864,0.88,89,12,101,609940
chr1,39861906,0.9,69,8,77,609941
chr1,39861940,0.93,50,4,54,609942
chr1,39861946,0.98,50,1,51,609943
chr1,39861948,0.96,47,2,49,609944
chr1,39861978,1,33,0,33,609945
chr1,39862195,0.72,92,36,128,609946
chr1,39862346,0.89,105,13,118,609947
chr1,39862376,0.86,89,14,103,609948
chr1,39862397,0.45,40,48,88,609949
chr1,39862605,0.69,66,30,96,609950
chr1,39862659,0.22,21,74,95,609951
chr1,39862908,0.87,65,10,75,609952
chr1,39862955,0.85,66,12,78,609953
chr1,39862999,0.95,75,4,79,609954
chr1,39863061,0.99,91,1,92,609955
chr1,39863090,0.97,68,2,70,609956
chr1,39863094,0.98,64,1,65,609957
chr1,39863102,0.97,58,2,60,609958
chr1,39863106,0.98,55,1,56,609959
chr1,39863158,0.84,31,6,37,609960
chr1,39863198,0.97,32,1,33,609961
chr1,39863215,0.51,20,19,39,609962
chr1,39863219,0.92,34,3,37,609963
chr1,39863227,0.74,23,8,31,609964
chr1,39863367,0.97,98,3,101,609965
chr1,39863686,0.04,3,77,80,609966
chr1,39863803,0.53,9,8,17,609967
chr1,39863895,0.26,21,59,80,609968
chr1,39864024,0.14,12,71,83,609969
chr1,39864170,0.06,5,78,83,609970
chr1,39864197,0.04,3,73,76,609971
chr1,39864312,0,0,80,80,609972
chr1,39864378,0.02,1,55,56,609973
chr1,39864432,0.02,1,55,56,609974
chr1,39864835,0.66,71,37,108,609975
chr1,39865109,0.8,39,10,49,609976
chr1,39865115,0.66,37,19,56,609977
chr1,39865149,0.95,76,4,80,609978
chr1,39865193,0.97,73,2,75,609979
chr1,39865245,0.91,40,4,44,609980
chr1,39865250,0.63,27,16,43,609981
chr1,39865268,0.97,35,1,36,609982
chr1,39865300,0.82,23,5,28,609983
chr1,39865328,0.94,46,3,49,609984
chr1,39865344,0.97,59,2,61,609985
chr1,39866281,1,57,0,57,609986
chr1,39866381,0.45,24,29,53,609987
chr1,39866422,1,70,0,70,609988
chr1,39867051,0.9,112,12,124,609989
chr1,39867149,0.67,92,45,137,609990
chr1,39867521,0.93,90,7,97,609991
chr1,39867609,1,49,0,49,609992
chr1,39867621,1,46,0,46,609993
chr1,39867625,0.96,47,2,49,609994
chr1,39867712,0.95,56,3,59,609995
chr1,39867798,0.99,77,1,78,609996
chr1,39867838,0.97,65,2,67,609997
chr1,39868081,0.96,111,5,116,609998
chr1,39868171,0.94,75,5,80,609999
chr1,39868534,0.95,88,5,93,610000
chr1,39868800,0.98,61,1,62,610001
chr1,39868833,0.98,55,1,56,610002
chr1,39868959,0.95,42,2,44,610003
chr1,39868967,1,40,0,40,610004
chr1,39869022,1,29,0,29,610005
chr1,39869062,0.97,58,2,60,610006
chr1,39869141,0.96,77,3,80,610007
chr1,39869481,0.92,72,6,78,610008
chr1,39869513,0.98,63,1,64,610009
chr1,39869522,0.95,39,2,41,610010
chr1,39869529,0.96,50,2,52,610011
chr1,39869566,0.94,33,2,35,610012
chr1,39869571,1,36,0,36,610013
chr1,39869598,0.97,37,1,38,610014
chr1,39869621,0.91,43,4,47,610015
chr1,39869715,0.97,74,2,76,610016
chr1,39869748,0.98,63,1,64,610017
chr1,39869754,0.94,60,4,64,610018
chr1,39869874,0.79,50,13,63,610019
chr1,39870091,0.96,52,2,54,610020
chr1,39870097,0.98,51,1,52,610021
chr1,39870202,0.99,73,1,74,610022
chr1,39870264,0.39,38,59,97,610023
chr1,39870344,0.72,84,32,116,610024
chr1,39870366,0.97,103,3,106,610025
chr1,39870787,0.19,15,65,80,610026
chr1,39870846,0.74,64,22,86,610027
chr1,39870878,0.53,46,41,87,610028
chr1,39871262,0.07,5,64,69,610029
chr1,39871416,0.67,65,32,97,610030
chr1,39871818,0.61,47,30,77,610031
chr1,39871925,0.81,100,24,124,610032
chr1,39871944,0.75,97,33,130,610033
chr1,39872148,0.94,68,4,72,610034
chr1,39872269,0.66,51,26,77,610035
chr1,39872275,0.85,64,11,75,610036
chr1,39872321,0.13,9,62,71,610037
chr1,39872363,0.4,17,25,42,610038
chr1,39872385,0.13,4,27,31,610039
chr1,39872953,0.06,4,65,69,610040
chr1,39873077,0.12,10,75,85,610041
chr1,39873172,0.28,18,47,65,610042
chr1,39873246,0.26,23,64,87,610043
chr1,39873313,0.12,13,92,105,610044
chr1,39873329,0.54,54,46,100,610045
chr1,39873479,0.57,55,42,97,610046
chr1,39873502,0.54,45,38,83,610047
chr1,39873514,0.36,31,54,85,610048
chr1,39873588,0.13,13,88,101,610049
chr1,39873697,0.36,42,76,118,610050
chr1,39873703,0.11,12,102,114,610051
chr1,39873706,0.19,21,89,110,610052
chr1,39873718,0.54,54,46,100,610053
chr1,39873805,0.44,30,38,68,610054
chr1,39873834,0.06,4,60,64,610055
chr1,39873886,0.26,19,53,72,610056
chr1,39874019,0,0,83,83,610057
chr1,39874025,0.01,1,88,89,610058
chr1,39874043,0,0,79,79,610059
chr1,39874054,0,0,81,81,610060
chr1,39874078,0,0,66,66,610061
chr1,39874083,0,0,64,64,610062
chr1,39874093,0.03,1,31,32,610063
chr1,39874095,0,0,49,49,610064
chr1,39874135,0,0,54,54,610065
chr1,39874150,0,0,56,56,610066
chr1,39874156,0,0,39,39,610067
chr1,39874165,0,0,40,40,610068
chr1,39874179,0,0,60,60,610069
chr1,39874182,0,0,52,52,610070
chr1,39874184,0,0,51,51,610071
chr1,39874192,0,0,58,58,610072
chr1,39874199,0,0,59,59,610073
chr1,39874207,0,0,54,54,610074
chr1,39874215,0,0,52,52,610075
chr1,39874218,0,0,54,54,610076
chr1,39874227,0,0,57,57,610077
chr1,39874243,0,0,32,32,610078
chr1,39874245,0,0,46,46,610079
chr1,39874249,0.05,1,18,19,610080
chr1,39874264,0,0,48,48,610081
chr1,39874268,0,0,43,43,610082
chr1,39874285,0,0,49,49,610083
chr1,39874291,0,0,45,45,610084
chr1,39874296,0,0,40,40,610085
chr1,39874305,0,0,32,32,610086
chr1,39874316,0,0,25,25,610087
chr1,39874326,0,0,29,29,610088
chr1,39874334,0,0,37,37,610089
chr1,39874345,0,0,28,28,610090
chr1,39874372,0,0,26,26,610091
chr1,39874375,0,0,35,35,610092
chr1,39874377,0,0,34,34,610093
chr1,39874390,0,0,34,34,610094
chr1,39874392,0,0,31,31,610095
chr1,39874394,0,0,32,32,610096
chr1,39874401,0,0,32,32,610097
chr1,39874415,0,0,10,10,610098
chr1,39874424,0,0,31,31,610099
chr1,39874430,0,0,24,24,610100
chr1,39874435,0,0,19,19,610101
chr1,39874451,0,0,23,23,610102
chr1,39874456,0,0,21,21,610103
chr1,39874458,0,0,21,21,610104
chr1,39874465,0,0,23,23,610105
chr1,39874474,0,0,21,21,610106
chr1,39874481,0,0,21,21,610107
chr1,39874485,0,0,21,21,610108
chr1,39874492,0,0,20,20,610109
chr1,39874497,0,0,21,21,610110
chr1,39874506,0,0,5,5,610111
chr1,39874511,0,0,17,17,610112
chr1,39874518,0,0,11,11,610113
chr1,39874535,0,0,15,15,610114
chr1,39874538,0,0,3,3,610115
chr1,39874563,0,0,7,7,610116
chr1,39874578,0,0,9,9,610117
chr1,39874584,0,0,2,2,610118
chr1,39874596,0,0,6,6,610119
chr1,39874602,0,0,3,3,610120
chr1,39874608,0,0,4,4,610121
chr1,39874611,0,0,6,6,610122
chr1,39874618,0,0,3,3,610123
chr1,39874624,0,0,3,3,610124
chr1,39874630,0,0,7,7,610125
chr1,39874651,0,0,14,14,610126
chr1,39874653,0,0,11,11,610127
chr1,39874656,0,0,12,12,610128
chr1,39874658,0,0,11,11,610129
chr1,39874660,0,0,12,12,610130
chr1,39874686,0,0,19,19,610131
chr1,39874690,0,0,16,16,610132
chr1,39874695,0.13,1,7,8,610133
chr1,39874698,0.17,1,5,6,610134
chr1,39874703,0,0,17,17,610135
chr1,39874705,0,0,16,16,610136
chr1,39874708,0,0,9,9,610137
chr1,39874711,0,0,11,11,610138
chr1,39874713,0.08,1,12,13,610139
chr1,39874733,0.05,1,18,19,610140
chr1,39874737,0,0,26,26,610141
chr1,39874744,0,0,25,25,610142
chr1,39874757,0,0,23,23,610143
chr1,39874765,0,0,25,25,610144
chr1,39874773,0,0,30,30,610145
chr1,39874778,0,0,28,28,610146
chr1,39874780,0,0,25,25,610147
chr1,39874785,0,0,28,28,610148
chr1,39874787,0.05,2,36,38,610149
chr1,39874802,0,0,35,35,610150
chr1,39874809,0,0,42,42,610151
chr1,39874813,0,0,52,52,610152
chr1,39874822,0.02,1,52,53,610153
chr1,39874857,0,0,60,60,610154
chr1,39874863,0,0,60,60,610155
chr1,39874874,0,0,56,56,610156
chr1,39874878,0,0,33,33,610157
chr1,39874887,0,0,48,48,610158
chr1,39874890,0,0,35,35,610159
chr1,39874896,0,0,39,39,610160
chr1,39874898,0,0,38,38,610161
chr1,39874907,0,0,43,43,610162
chr1,39874910,0,0,34,34,610163
chr1,39874928,0,0,32,32,610164
chr1,39874950,0,0,48,48,610165
chr1,39874953,0,0,37,37,610166
chr1,39874958,0,0,34,34,610167
chr1,39874964,0,0,42,42,610168
chr1,39874969,0.02,1,45,46,610169
chr1,39874979,0,0,38,38,610170
chr1,39874982,0,0,26,26,610171
chr1,39874985,0,0,29,29,610172
chr1,39874989,0,0,24,24,610173
chr1,39874994,0.04,1,25,26,610174
chr1,39874997,0.05,1,21,22,610175
chr1,39875010,0.03,1,38,39,610176
chr1,39875024,0,0,43,43,610177
chr1,39875049,0,0,35,35,610178
chr1,39875051,0,0,38,38,610179
chr1,39875067,0.03,1,30,31,610180
chr1,39875069,0,0,37,37,610181
chr1,39875073,0,0,42,42,610182
chr1,39875093,0,0,39,39,610183
chr1,39875101,0,0,20,20,610184
chr1,39875114,0,0,40,40,610185
chr1,39875119,0.06,1,17,18,610186
chr1,39875121,0,0,30,30,610187
chr1,39875123,0,0,35,35,610188
chr1,39875131,0,0,28,28,610189
chr1,39875133,0,0,36,36,610190
chr1,39875141,0,0,36,36,610191
chr1,39875146,0,0,40,40,610192
chr1,39875155,0,0,32,32,610193
chr1,39875165,0,0,47,47,610194
chr1,39875174,0.02,1,40,41,610195
chr1,39875176,0.03,1,37,38,610196
chr1,39875180,0.03,1,39,40,610197
chr1,39875193,0.03,1,34,35,610198
chr1,39875197,0.03,1,35,36,610199
chr1,39875201,0,0,44,44,610200
chr1,39875213,0,0,56,56,610201
chr1,39875224,0.02,1,50,51,610202
chr1,39875226,0.02,1,50,51,610203
chr1,39875234,0,0,57,57,610204
chr1,39875238,0.02,1,60,61,610205
chr1,39875259,0.01,1,66,67,610206
chr1,39875327,0,0,100,100,610207
chr1,39875367,0.03,3,98,101,610208
chr1,39875370,0.01,1,106,107,610209
chr1,39875412,0,0,112,112,610210
chr1,39875541,0,0,105,105,610211
chr1,39875572,0.02,2,97,99,610212
chr1,39875599,0.01,1,83,84,610213
chr1,39875610,0.01,1,81,82,610214
chr1,39875709,0.03,3,98,101,610215
chr1,39875787,0.03,3,116,119,610216
chr1,39875974,0.46,35,41,76,610217
chr1,39876043,0.08,8,95,103,610218
chr1,39876059,0.05,5,97,102,610219
chr1,39876292,0.34,24,47,71,610220
chr1,39876307,0.15,12,66,78,610221
chr1,39876332,0.11,8,65,73,610222
chr1,39876716,0.02,2,90,92,610223
chr1,39876913,0.09,7,69,76,610224
chr1,39877065,0.05,4,83,87,610225
chr1,39877191,0.2,20,79,99,610226
chr1,39877221,0.12,14,99,113,610227
chr1,39877452,0.06,7,107,114,610228
chr1,39877608,0.06,6,95,101,610229
chr1,39878424,0.15,14,80,94,610230
chr1,39878443,0.24,23,73,96,610231
chr1,39878781,0.44,31,40,71,610232
chr1,39878937,0.93,27,2,29,610233
chr1,39879288,0.82,9,2,11,610234
chr1,39879327,0.96,27,1,28,610235
chr1,39879405,0.75,21,7,28,610236
chr1,39879411,0.54,19,16,35,610237
chr1,39879435,0.26,14,40,54,610238
chr1,39879530,0.31,17,37,54,610239
chr1,39879590,0.13,7,45,52,610240
chr1,39879768,0.03,2,61,63,610241
chr1,39879816,0.44,14,18,32,610242
chr1,39880128,0.08,9,100,109,610243
chr1,39880265,0.13,12,77,89,610244
chr1,39880354,0.07,6,82,88,610245
chr1,39880382,0.07,7,99,106,610246
chr1,39880680,0.84,82,16,98,610247
chr1,39881070,0.28,11,29,40,610248
chr1,39881100,0.78,28,8,36,610249
chr1,39881108,0.37,11,19,30,610250
chr1,39881132,0.31,5,11,16,610251
chr1,39881152,0.92,12,1,13,610252
chr1,39881156,0.91,10,1,11,610253
chr1,39881164,0.75,9,3,12,610254
chr1,39881168,0.81,13,3,16,610255
chr1,39881224,0.42,8,11,19,610256
chr1,39881279,0.95,41,2,43,610257
chr1,39881284,0.83,38,8,46,610258
chr1,39881312,0.91,58,6,64,610259
chr1,39881322,0.94,60,4,64,610260
chr1,39881324,0.96,64,3,67,610261
chr1,39881332,0.78,62,17,79,610262
chr1,39881361,0.22,22,78,100,610263
chr1,39881387,0.21,21,79,100,610264
chr1,39881554,0.74,68,24,92,610265
chr1,39881932,0.42,39,54,93,610266
chr1,39881959,0.97,83,3,86,610267
chr1,39882114,0.93,65,5,70,610268
chr1,39882903,0.43,38,50,88,610269
chr1,39883128,0.98,91,2,93,610270
chr1,39883140,0.83,80,16,96,610271
chr1,39883178,0.57,50,38,88,610272
chr1,39883311,0.37,27,46,73,610273
chr1,39883342,0.49,26,27,53,610274
chr1,39883469,0.63,22,13,35,610275
chr1,39883492,0.72,33,13,46,610276
chr1,39883501,0.18,12,53,65,610277
chr1,39883504,0.21,14,53,67,610278
chr1,39883545,0.61,55,35,90,610279
chr1,39884010,0.24,27,87,114,610280
chr1,39884137,0.33,14,29,43,610281
chr1,39884140,0.81,34,8,42,610282
chr1,39884263,0.19,15,63,78,610283
chr1,39884403,0.87,85,13,98,610284
chr1,39884420,0.52,57,52,109,610285
chr1,39884824,0.4,39,58,97,610286
chr1,39884834,0.27,28,74,102,610287
chr1,39885164,0.86,88,14,102,610288
chr1,39885373,1,42,0,42,610289
chr1,39885397,0.94,48,3,51,610290
chr1,39885449,0.93,43,3,46,610291
chr1,39885453,0.96,44,2,46,610292
chr1,39885529,0.24,8,25,33,610293
chr1,39885537,0.43,18,24,42,610294
chr1,39885762,0.68,81,38,119,610295
chr1,39886606,0.86,38,6,44,610296
chr1,39886630,0.98,55,1,56,610297
chr1,39886662,0.94,45,3,48,610298
chr1,39886686,1,44,0,44,610299
chr1,39886698,0.89,47,6,53,610300
chr1,39886783,1,44,0,44,610301
chr1,39886788,0.95,40,2,42,610302
chr1,39886816,0.95,60,3,63,610303
chr1,39886832,0.97,75,2,77,610304
chr1,39886908,0.94,76,5,81,610305
chr1,39886945,0.87,81,12,93,610306
chr1,39887000,0.76,83,26,109,610307
chr1,39887096,0.2,25,100,125,610308
chr1,39887390,0.98,55,1,56,610309
chr1,39887410,0.87,62,9,71,610310
chr1,39887468,0.97,91,3,94,610311
chr1,39887472,0.98,83,2,85,610312
chr1,39887474,0.99,84,1,85,610313
chr1,39887484,0.94,83,5,88,610314
chr1,39887499,0.94,91,6,97,610315
chr1,39887512,0.98,85,2,87,610316
chr1,39887521,0.94,85,5,90,610317
chr1,39887528,0.91,89,9,98,610318
chr1,39887542,0.91,87,9,96,610319
chr1,39887562,0.56,57,44,101,610320
chr1,39887615,0.38,25,40,65,610321
chr1,39887619,0.19,11,47,58,610322
chr1,39887671,0.52,28,26,54,610323
chr1,39887678,0.72,26,10,36,610324
chr1,39887695,0.1,5,46,51,610325
chr1,39887703,0.15,8,45,53,610326
chr1,39887725,0.18,8,36,44,610327
chr1,39887733,0.18,9,42,51,610328
chr1,39887906,0.15,14,78,92,610329
chr1,39887941,0.18,17,79,96,610330
chr1,39887986,0.66,77,39,116,610331
chr1,39888184,0.92,94,8,102,610332
chr1,39888242,0.97,67,2,69,610333
chr1,39888282,0.97,62,2,64,610334
chr1,39888367,0.97,88,3,91,610335
chr1,39888404,0.82,81,18,99,610336
chr1,39888497,0.69,80,36,116,610337
chr1,39888609,0.85,88,15,103,610338
chr1,39888692,0.89,78,10,88,610339
chr1,39889045,0.98,50,1,51,610340
chr1,39889073,1,30,0,30,610341
chr1,39889082,0.96,22,1,23,610342
chr1,39889103,0.91,10,1,11,610343
chr1,39889123,1,2,0,2,610344
chr1,39889163,1,5,0,5,610345
chr1,39889179,0.82,9,2,11,610346
chr1,39889199,1,19,0,19,610347
chr1,39889238,0.91,41,4,45,610348
chr1,39889255,0.94,46,3,49,610349
chr1,39889261,0.89,47,6,53,610350
chr1,39889293,1,52,0,52,610351
chr1,39889364,0.65,43,23,66,610352
chr1,39889381,0.94,72,5,77,610353
chr1,39889433,0.97,88,3,91,610354
chr1,39889526,0.76,56,18,74,610355
chr1,39889611,0.91,60,6,66,610356
chr1,39889709,0.91,89,9,98,610357
chr1,39889724,0.89,98,12,110,610358
chr1,39889920,0.98,85,2,87,610359
chr1,39890072,0.95,76,4,80,610360
chr1,39890163,0.65,55,29,84,610361
chr1,39890809,0.65,59,32,91,610362
chr1,39890858,0.89,96,12,108,610363
chr1,39890953,0.84,88,17,105,610364
chr1,39891155,0.32,32,69,101,610365
chr1,39892039,0.88,78,11,89,610366
chr1,39892487,0.45,35,43,78,610367
chr1,39892983,0.92,97,9,106,610368
chr1,39892998,0.27,28,74,102,610369
chr1,39893278,0.02,3,124,127,610370
chr1,39893471,0.49,45,46,91,610371
chr1,39893522,0.11,9,71,80,610372
chr1,39893765,0.55,60,49,109,610373
chr1,39893786,0.95,107,6,113,610374
chr1,39893795,0.88,100,14,114,610375
chr1,39893908,0.75,52,17,69,610376
chr1,39894380,0.86,113,18,131,610377
chr1,39894494,0.98,93,2,95,610378
chr1,39894704,0.98,103,2,105,610379
chr1,39894854,0.97,96,3,99,610380
chr1,39895280,0.93,85,6,91,610381
chr1,39895546,0.95,74,4,78,610382
chr1,39895551,0.96,82,3,85,610383
chr1,39895603,0.94,77,5,82,610384
chr1,39895647,0.71,55,22,77,610385
chr1,39895893,0.8,55,14,69,610386
chr1,39896434,0.88,65,9,74,610387
chr1,39896493,0.92,70,6,76,610388
chr1,39896502,0.87,72,11,83,610389
chr1,39897123,0.97,98,3,101,610390
chr1,39897296,0.95,106,5,111,610391
chr1,39897502,0.69,56,25,81,610392
chr1,39897566,0.8,61,15,76,610393
chr1,39897568,0.8,59,15,74,610394
chr1,39897702,0.14,7,44,51,610395
chr1,39897724,0.43,23,31,54,610396
chr1,39897787,0.37,34,59,93,610397
chr1,39897797,0.18,17,79,96,610398
chr1,39897816,0.17,16,80,96,610399
chr1,39898197,0.13,13,86,99,610400
chr1,39898221,0.2,22,86,108,610401
chr1,39898255,0.26,30,84,114,610402
chr1,39898282,0.82,89,20,109,610403
chr1,39898330,0.87,80,12,92,610404
chr1,39898741,0.97,86,3,89,610405
chr1,39898777,0.87,79,12,91,610406
chr1,39899191,0.91,94,9,103,610407
chr1,39899247,0.87,91,14,105,610408
chr1,39899419,0.89,84,10,94,610409
chr1,39899479,0.85,62,11,73,610410
chr1,39899489,0.94,68,4,72,610411
chr1,39899549,0.95,69,4,73,610412
chr1,39899683,1,59,0,59,610413
chr1,39899706,0.98,56,1,57,610414
chr1,39899708,0.95,58,3,61,610415
chr1,39900143,0.9,92,10,102,610416
chr1,39900152,0.96,98,4,102,610417
chr1,39900161,0.98,104,2,106,610418
chr1,39900230,0.62,67,41,108,610419
chr1,39900406,0.81,85,20,105,610420
chr1,39900512,0.2,21,83,104,610421
chr1,39900579,0.64,83,47,130,610422
chr1,39900779,0.09,11,107,118,610423
chr1,39901386,0.96,82,3,85,610424
chr1,39901392,0.97,87,3,90,610425
chr1,39901415,0.93,88,7,95,610426
chr1,39901545,0.9,76,8,84,610427
chr1,39901551,0.93,83,6,89,610428
chr1,39902039,0.9,57,6,63,610429
chr1,39902112,0.92,70,6,76,610430
chr1,39902137,0.99,79,1,80,610431
chr1,39902139,0.95,78,4,82,610432
chr1,39902605,0.57,51,38,89,610433
chr1,39902639,0.96,70,3,73,610434
chr1,39902677,0.88,79,11,90,610435
chr1,39903021,0.88,49,7,56,610436
chr1,39903075,1,81,0,81,610437
chr1,39903123,0.97,73,2,75,610438
chr1,39903127,0.99,67,1,68,610439
chr1,39903131,0.99,69,1,70,610440
chr1,39903143,0.99,69,1,70,610441
chr1,39903172,0.96,65,3,68,610442
chr1,39903175,0.87,58,9,67,610443
chr1,39903500,0.97,96,3,99,610444
chr1,39903506,0.96,95,4,99,610445
chr1,39903577,0.97,88,3,91,610446
chr1,39903620,0.98,81,2,83,610447
chr1,39903623,1,91,0,91,610448
chr1,39903644,0.93,89,7,96,610449
chr1,39903849,0.95,77,4,81,610450
chr1,39903921,0.86,77,13,90,610451
chr1,39904150,0.94,100,6,106,610452
chr1,39904172,0.98,108,2,110,610453
chr1,39904182,0.98,115,2,117,610454
chr1,39904254,1,95,0,95,610455
chr1,39904322,0.98,78,2,80,610456
chr1,39904364,0.96,67,3,70,610457
chr1,39904476,0.96,49,2,51,610458
chr1,39904520,0.96,45,2,47,610459
chr1,39904525,1,44,0,44,610460
chr1,39904552,1,41,0,41,610461
chr1,39904583,0.98,59,1,60,610462
chr1,39904711,0.93,54,4,58,610463
chr1,39904999,0.95,91,5,96,610464
chr1,39905011,0.93,85,6,91,610465
chr1,39905363,0.99,92,1,93,610466
chr1,39905557,0.92,77,7,84,610467
chr1,39905877,0.97,74,2,76,610468
chr1,39906029,0.92,58,5,63,610469
chr1,39906057,0.88,56,8,64,610470
chr1,39906662,0.74,104,37,141,610471
chr1,39906723,0.8,109,28,137,610472
chr1,39907168,0.99,98,1,99,610473
chr1,39907240,0.32,38,79,117,610474
chr1,39907910,0.88,75,10,85,610475
chr1,39907927,0.91,73,7,80,610476
chr1,39907987,0.92,58,5,63,610477
chr1,39908031,1,54,0,54,610478
chr1,39908047,0.95,52,3,55,610479
chr1,39908164,0.98,112,2,114,610480
chr1,39908227,0.94,89,6,95,610481
chr1,39908497,0.55,65,53,118,610482
chr1,39908900,0.9,79,9,88,610483
chr1,39909014,0.54,51,44,95,610484
chr1,39909597,0.77,69,21,90,610485
chr1,39909729,0.9,61,7,68,610486
chr1,39909733,0.95,61,3,64,610487
chr1,39909745,0.42,23,32,55,610488
chr1,39909773,0.12,3,23,26,610489
chr1,39909834,0,0,8,8,610490
chr1,39909863,1,4,0,4,610491
chr1,39909867,1,6,0,6,610492
chr1,39909875,0.67,2,1,3,610493
chr1,39909879,1,8,0,8,610494
chr1,39909931,0.95,37,2,39,610495
chr1,39909938,1,45,0,45,610496
chr1,39909955,0.58,29,21,50,610497
chr1,39910299,0.83,62,13,75,610498
chr1,39910412,0.72,78,30,108,610499
chr1,39910417,0.57,64,48,112,610500
chr1,39910729,0.92,82,7,89,610501
chr1,39910734,0.83,81,17,98,610502
chr1,39910851,0.97,88,3,91,610503
chr1,39910884,0.87,75,11,86,610504
chr1,39911191,0.83,85,17,102,610505
chr1,39911369,0.87,71,11,82,610506
chr1,39911504,0.88,60,8,68,610507
chr1,39912210,0.96,64,3,67,610508
chr1,39912265,0.36,38,67,105,610509
chr1,39912439,0.77,65,19,84,610510
chr1,39912566,0.59,47,33,80,610511
chr1,39912826,0.24,20,65,85,610512
chr1,39912971,0.17,15,71,86,610513
chr1,39913035,0.14,11,69,80,610514
chr1,39913062,0.16,9,49,58,610515
chr1,39913202,0.21,18,66,84,610516
chr1,39913391,0.6,81,54,135,610517
chr1,39913486,0.98,128,3,131,610518
chr1,39913496,0.91,116,11,127,610519
chr1,39913517,0.97,122,4,126,610520
chr1,39913535,1,105,0,105,610521
chr1,39913559,0.98,104,2,106,610522
chr1,39913649,0.82,67,15,82,610523
chr1,39913866,0.81,97,23,120,610524
chr1,39914222,0.26,22,63,85,610525
chr1,39914355,0.21,26,97,123,610526
chr1,39914434,0.95,81,4,85,610527
chr1,39914468,0.93,77,6,83,610528
chr1,39915131,0.97,32,1,33,610529
chr1,39915133,0.97,33,1,34,610530
chr1,39915139,0.93,25,2,27,610531
chr1,39915156,0.95,19,1,20,610532
chr1,39915171,0.92,12,1,13,610533
chr1,39915195,0.95,18,1,19,610534
chr1,39915219,0.97,33,1,34,610535
chr1,39915227,1,38,0,38,610536
chr1,39915305,1,47,0,47,610537
chr1,39915316,1,36,0,36,610538
chr1,39915349,1,19,0,19,610539
chr1,39915359,1,15,0,15,610540
chr1,39915361,0.8,12,3,15,610541
chr1,39915600,0.98,56,1,57,610542
chr1,39915625,1,66,0,66,610543
chr1,39915724,0.86,66,11,77,610544
chr1,39915785,0.97,83,3,86,610545
chr1,39915788,1,85,0,85,610546
chr1,39915825,0.96,76,3,79,610547
chr1,39916314,1,12,0,12,610548
chr1,39916352,0.95,21,1,22,610549
chr1,39916376,0.97,31,1,32,610550
chr1,39916382,0.97,37,1,38,610551
chr1,39916384,1,40,0,40,610552
chr1,39916408,0.97,30,1,31,610553
chr1,39916444,0.96,24,1,25,610554
chr1,39916484,0.83,5,1,6,610555
chr1,39916504,1,8,0,8,610556
chr1,39916518,1,14,0,14,610557
chr1,39916534,0.95,19,1,20,610558
chr1,39916572,1,51,0,51,610559
chr1,39916574,1,53,0,53,610560
chr1,39916578,0.98,54,1,55,610561
chr1,39916655,0.93,85,6,91,610562
chr1,39916704,0.96,100,4,104,610563
chr1,39916756,0.76,82,26,108,610564
chr1,39916835,0.6,55,36,91,610565
chr1,39916841,0.51,45,44,89,610566
chr1,39916856,0.42,40,55,95,610567
chr1,39917054,0.68,63,29,92,610568
chr1,39917115,0.96,90,4,94,610569
chr1,39917170,0.36,35,61,96,610570
chr1,39917270,0.87,73,11,84,610571
chr1,39917417,0.47,54,61,115,610572
chr1,39917576,0.9,60,7,67,610573
chr1,39917631,0.94,94,6,100,610574
chr1,39917671,0.97,103,3,106,610575
chr1,39917675,0.84,90,17,107,610576
chr1,39917852,0.92,122,11,133,610577
chr1,39917863,0.74,102,36,138,610578
chr1,39917879,0.96,137,5,142,610579
chr1,39917888,0.94,138,9,147,610580
chr1,39917909,0.89,133,17,150,610581
chr1,39917957,0.79,116,30,146,610582
chr1,39917999,0.89,107,13,120,610583
chr1,39918357,0.99,83,1,84,610584
chr1,39918368,0.96,75,3,78,610585
chr1,39918417,0.8,56,14,70,610586
chr1,39918422,0.99,78,1,79,610587
chr1,39918428,0.91,72,7,79,610588
chr1,39918648,0.97,68,2,70,610589
chr1,39918787,0.88,68,9,77,610590
chr1,39919116,0.81,58,14,72,610591
chr1,39919265,0.79,50,13,63,610592
chr1,39919349,0.64,63,35,98,610593
chr1,39919406,0.64,49,28,77,610594
chr1,39919414,0.15,12,66,78,610595
chr1,39919465,0.86,57,9,66,610596
chr1,39919505,0.41,26,37,63,610597
chr1,39919511,0.86,48,8,56,610598
chr1,39919516,0.67,42,21,63,610599
chr1,39919554,0.96,73,3,76,610600
chr1,39919844,0.94,116,7,123,610601
chr1,39919931,0.94,107,7,114,610602
chr1,39919938,1,104,0,104,610603
chr1,39920194,0.91,75,7,82,610604
chr1,39920210,0.98,79,2,81,610605
chr1,39920244,0.97,83,3,86,610606
chr1,39920396,0.94,72,5,77,610607
chr1,39920458,1,80,0,80,610608
chr1,39920611,0.83,59,12,71,610609
chr1,39920621,0.65,49,26,75,610610
chr1,39920707,0.85,99,18,117,610611
chr1,39920726,0.93,105,8,113,610612
chr1,39920740,0.85,98,17,115,610613
chr1,39920757,0.98,105,2,107,610614
chr1,39920806,0.92,67,6,73,610615
chr1,39921176,0.84,57,11,68,610616
chr1,39921421,0.97,71,2,73,610617
chr1,39921557,0.82,79,17,96,610618
chr1,39921731,0.95,61,3,64,610619
chr1,39921862,0.85,58,10,68,610620
chr1,39921902,0.97,69,2,71,610621
chr1,39921960,0.98,55,1,56,610622
chr1,39921984,0.96,68,3,71,610623
chr1,39922125,0.75,75,25,100,610624
chr1,39922164,0.85,80,14,94,610625
chr1,39922204,0.86,59,10,69,610626
chr1,39922232,0.93,54,4,58,610627
chr1,39922239,0.94,51,3,54,610628
chr1,39922425,0.98,88,2,90,610629
chr1,39922649,0.62,72,45,117,610630
chr1,39922713,0.67,72,35,107,610631
chr1,39922894,0.3,32,74,106,610632
chr1,39923220,0.97,88,3,91,610633
chr1,39923291,0.94,78,5,83,610634
chr1,39923488,0.14,16,100,116,610635
chr1,39923558,0.51,63,60,123,610636
chr1,39923575,0.17,20,99,119,610637
chr1,39923656,0.67,30,15,45,610638
chr1,39923820,0.72,54,21,75,610639
chr1,39923953,0.9,100,11,111,610640
chr1,39924063,0.97,71,2,73,610641
chr1,39924077,0.58,47,34,81,610642
chr1,39924084,0.78,61,17,78,610643
chr1,39924128,0.95,71,4,75,610644
chr1,39924130,0.97,71,2,73,610645
chr1,39924150,0.99,77,1,78,610646
chr1,39924155,0.99,78,1,79,610647
chr1,39924266,0.63,65,38,103,610648
chr1,39924371,0.48,32,35,67,610649
chr1,39924509,0.84,76,15,91,610650
chr1,39924612,0.84,70,13,83,610651
chr1,39924635,0.83,70,14,84,610652
chr1,39924826,0.27,29,78,107,610653
chr1,39924847,0.7,76,33,109,610654
chr1,39924880,0.9,94,11,105,610655
chr1,39924910,0.75,74,25,99,610656
chr1,39925111,0.66,77,39,116,610657
chr1,39925666,0.82,83,18,101,610658
chr1,39925875,0.85,94,16,110,610659
chr1,39925932,0.96,93,4,97,610660
chr1,39926113,0.78,82,23,105,610661
chr1,39926355,0.77,89,26,115,610662
chr1,39926379,0.91,105,11,116,610663
chr1,39926397,0.93,111,8,119,610664
chr1,39926400,0.99,115,1,116,610665
chr1,39926433,0.65,70,37,107,610666
chr1,39926447,0.95,98,5,103,610667
chr1,39926710,0.8,68,17,85,610668
chr1,39927084,0.95,102,5,107,610669
chr1,39927186,0.94,64,4,68,610670
chr1,39927196,0.95,61,3,64,610671
chr1,39927198,0.92,56,5,61,610672
chr1,39927289,0.65,45,24,69,610673
chr1,39927320,0.95,71,4,75,610674
chr1,39927336,0.99,71,1,72,610675
chr1,39927395,1,58,0,58,610676
chr1,39927412,0.88,36,5,41,610677
chr1,39927442,0.9,26,3,29,610678
chr1,39927499,0.98,47,1,48,610679
chr1,39927601,0.99,81,1,82,610680
chr1,39927605,0.96,81,3,84,610681
chr1,39927669,0.93,108,8,116,610682
chr1,39927674,0.99,119,1,120,610683
chr1,39927685,0.96,123,5,128,610684
chr1,39927700,0.92,115,10,125,610685
chr1,39928000,0.67,59,29,88,610686
chr1,39928147,0.88,73,10,83,610687
chr1,39928174,0.99,66,1,67,610688
chr1,39928218,0.87,26,4,30,610689
chr1,39928880,0.9,77,9,86,610690
chr1,39928884,0.96,76,3,79,610691
chr1,39928896,0.97,70,2,72,610692
chr1,39928933,0.97,56,2,58,610693
chr1,39928948,0.92,49,4,53,610694
chr1,39929032,0.91,58,6,64,610695
chr1,39929092,0.98,55,1,56,610696
chr1,39929110,0.94,46,3,49,610697
chr1,39929116,0.96,43,2,45,610698
chr1,39929149,0.98,45,1,46,610699
chr1,39929340,0.96,71,3,74,610700
chr1,39929356,0.91,70,7,77,610701
chr1,39929454,0.95,55,3,58,610702
chr1,39929960,0.97,73,2,75,610703
chr1,39930301,0.91,63,6,69,610704
chr1,39930305,0.97,62,2,64,610705
chr1,39930352,1,59,0,59,610706
chr1,39930356,0.97,57,2,59,610707
chr1,39930360,1,55,0,55,610708
chr1,39930383,0.86,62,10,72,610709
chr1,39930454,0.97,70,2,72,610710
chr1,39930508,0.9,60,7,67,610711
chr1,39930511,0.97,68,2,70,610712
chr1,39930517,0.95,57,3,60,610713
chr1,39930540,0.95,57,3,60,610714
chr1,39930542,1,57,0,57,610715
chr1,39930572,1,41,0,41,610716
chr1,39930775,0.89,57,7,64,610717
chr1,39930854,0.99,89,1,90,610718
chr1,39930893,0.97,84,3,87,610719
chr1,39931261,0.81,91,21,112,610720
chr1,39931271,0.81,87,21,108,610721
chr1,39931744,0.82,53,12,65,610722
chr1,39932414,0.7,86,36,122,610723
chr1,39932760,0.86,66,11,77,610724
chr1,39932764,0.9,69,8,77,610725
chr1,39932804,0.79,61,16,77,610726
chr1,39932809,0.74,60,21,81,610727
chr1,39932820,0.77,64,19,83,610728
chr1,39932834,0.59,52,36,88,610729
chr1,39932854,0.21,19,72,91,610730
chr1,39932865,0.16,13,69,82,610731
chr1,39932894,0.21,15,58,73,610732
chr1,39932905,0.27,15,40,55,610733
chr1,39932909,0.23,9,31,40,610734
chr1,39932929,0.11,6,48,54,610735
chr1,39932968,0.71,22,9,31,610736
chr1,39932991,0.1,4,38,42,610737
chr1,39932993,0.07,3,38,41,610738
chr1,39933015,0.09,3,30,33,610739
chr1,39933023,0.08,3,37,40,610740
chr1,39933080,0.11,9,75,84,610741
chr1,39933453,0.69,75,34,109,610742
chr1,39933785,0.87,71,11,82,610743
chr1,39933788,0.95,75,4,79,610744
chr1,39933837,0.93,64,5,69,610745
chr1,39933844,0.87,60,9,69,610746
chr1,39933888,0.58,43,31,74,610747
chr1,39933920,0.84,78,15,93,610748
chr1,39933932,0.91,92,9,101,610749
chr1,39933953,0.69,63,28,91,610750
chr1,39934308,0.96,104,4,108,610751
chr1,39934317,0.95,104,5,109,610752
chr1,39934326,0.97,98,3,101,610753
chr1,39934334,0.95,105,5,110,610754
chr1,39934344,0.97,108,3,111,610755
chr1,39934346,0.9,98,11,109,610756
chr1,39934401,0.81,88,21,109,610757
chr1,39934432,0.88,101,14,115,610758
chr1,39934664,0.83,70,14,84,610759
chr1,39934712,0.94,72,5,77,610760
chr1,39935047,0.72,36,14,50,610761
chr1,39935170,0.55,48,39,87,610762
chr1,39935202,0.83,74,15,89,610763
chr1,39935245,0.95,106,6,112,610764
chr1,39935264,0.91,102,10,112,610765
chr1,39935630,0.73,76,28,104,610766
chr1,39936832,0.69,102,46,148,610767
chr1,39936894,0.85,126,22,148,610768
chr1,39937305,0.1,8,73,81,610769
chr1,39937581,0.81,67,16,83,610770
chr1,39937590,0.71,58,24,82,610771
chr1,39937676,0.92,104,9,113,610772
chr1,39937764,0.88,79,11,90,610773
chr1,39938012,0.72,57,22,79,610774
chr1,39938093,0.97,94,3,97,610775
chr1,39938179,0.95,117,6,123,610776
chr1,39938257,0.76,96,30,126,610777
chr1,39938385,0.95,105,6,111,610778
chr1,39938573,0.95,86,5,91,610779
chr1,39938631,0.93,106,8,114,610780
chr1,39938669,0.53,65,57,122,610781
chr1,39938688,0.39,48,75,123,610782
chr1,39938790,0.92,105,9,114,610783
chr1,39938798,0.67,74,36,110,610784
chr1,39938806,0.96,107,4,111,610785
chr1,39938912,0.87,99,15,114,610786
chr1,39939213,0.84,69,13,82,610787
chr1,39939224,0.94,73,5,78,610788
chr1,39939294,0.94,83,5,88,610789
chr1,39939348,0.97,76,2,78,610790
chr1,39939450,0,0,3,3,610791
chr1,39939457,1,6,0,6,610792
chr1,39939663,0.68,44,21,65,610793
chr1,39939782,0.96,71,3,74,610794
chr1,39939826,0.97,68,2,70,610795
chr1,39939831,1,72,0,72,610796
chr1,39939866,0.95,76,4,80,610797
chr1,39939884,0.87,90,13,103,610798
chr1,39939917,0.91,106,10,116,610799
chr1,39939953,0.94,104,7,111,610800
chr1,39939975,0.92,90,8,98,610801
chr1,39940009,0.94,74,5,79,610802
chr1,39940030,0.93,65,5,70,610803
chr1,39940058,0.89,57,7,64,610804
chr1,39940138,0.91,60,6,66,610805
chr1,39940142,0.97,60,2,62,610806
chr1,39940151,0.83,52,11,63,610807
chr1,39940258,0.88,86,12,98,610808
chr1,39940289,0.97,88,3,91,610809
chr1,39940297,0.99,84,1,85,610810
chr1,39940429,0.99,78,1,79,610811
chr1,39940443,0.95,82,4,86,610812
chr1,39940664,0.32,32,69,101,610813
chr1,39940684,0.23,24,81,105,610814
chr1,39940785,0.71,71,29,100,610815
chr1,39940795,0.73,79,29,108,610816
chr1,39941371,0.22,21,73,94,610817
chr1,39941626,0.8,8,2,10,610818
chr1,39941968,0.96,53,2,55,610819
chr1,39941970,0.93,51,4,55,610820
chr1,39942008,0.89,24,3,27,610821
chr1,39942013,0.96,23,1,24,610822
chr1,39942024,0.72,23,9,32,610823
chr1,39942086,0.72,56,22,78,610824
chr1,39942102,0.92,91,8,99,610825
chr1,39942113,0.85,93,17,110,610826
chr1,39942115,0.96,107,4,111,610827
chr1,39942174,0.98,95,2,97,610828
chr1,39942285,0.57,48,36,84,610829
chr1,39942501,0.93,57,4,61,610830
chr1,39942534,0.92,44,4,48,610831
chr1,39942584,0.82,45,10,55,610832
chr1,39942596,0.87,46,7,53,610833
chr1,39942671,0.73,37,14,51,610834
chr1,39942889,0.96,50,2,52,610835
chr1,39942922,0.9,54,6,60,610836
chr1,39943128,0.71,55,22,77,610837
chr1,39943280,0.96,74,3,77,610838
chr1,39943312,0.97,66,2,68,610839
chr1,39943361,0.95,58,3,61,610840
chr1,39943393,0.78,62,17,79,610841
chr1,39943737,0.76,22,7,29,610842
chr1,39943743,0.88,30,4,34,610843
chr1,39943760,1,44,0,44,610844
chr1,39943863,0.82,84,19,103,610845
chr1,39943966,0.97,86,3,89,610846
chr1,39943970,0.72,67,26,93,610847
chr1,39944095,0.58,52,38,90,610848
chr1,39944108,0.77,68,20,88,610849
chr1,39944661,0.93,83,6,89,610850
chr1,39944687,0.94,80,5,85,610851
chr1,39944755,0.98,80,2,82,610852
chr1,39944770,0.89,76,9,85,610853
chr1,39944775,0.95,75,4,79,610854
chr1,39944783,0.84,76,14,90,610855
chr1,39944914,0.81,73,17,90,610856
chr1,39945029,0.79,59,16,75,610857
chr1,39945149,0.83,81,17,98,610858
chr1,39945217,0.51,42,40,82,610859
chr1,39945400,0.94,85,5,90,610860
chr1,39945411,0.76,77,24,101,610861
chr1,39945472,0.55,41,34,75,610862
chr1,39945547,1,59,0,59,610863
chr1,39945553,0.95,55,3,58,610864
chr1,39945559,0.96,55,2,57,610865
chr1,39945580,0.76,48,15,63,610866
chr1,39945598,0.67,40,20,60,610867
chr1,39945746,0.72,54,21,75,610868
chr1,39945819,0.58,51,37,88,610869
chr1,39946089,0.58,42,31,73,610870
chr1,39946582,0.83,63,13,76,610871
chr1,39946610,0.92,84,7,91,610872
chr1,39946699,0.88,91,13,104,610873
chr1,39946741,0.79,92,25,117,610874
chr1,39946750,0.86,95,15,110,610875
chr1,39946784,0.79,85,23,108,610876
chr1,39946867,0.82,84,19,103,610877
chr1,39947044,0.61,57,37,94,610878
chr1,39947075,0.97,91,3,94,610879
chr1,39947124,0.94,82,5,87,610880
chr1,39947182,0.82,82,18,100,610881
chr1,39947187,0.87,87,13,100,610882
chr1,39947356,0.69,86,38,124,610883
chr1,39947888,0.93,99,8,107,610884
chr1,39947920,0.98,100,2,102,610885
chr1,39948004,0.98,97,2,99,610886
chr1,39948083,0.72,73,29,102,610887
chr1,39948223,0.97,71,2,73,610888
chr1,39948339,1,50,0,50,610889
chr1,39948551,0.98,65,1,66,610890
chr1,39948690,0.94,44,3,47,610891
chr1,39949107,0.5,51,50,101,610892
chr1,39949419,0.84,77,15,92,610893
chr1,39949551,0.98,63,1,64,610894
chr1,39949619,0.96,49,2,51,610895
chr1,39949639,0.93,54,4,58,610896
chr1,39949650,0.82,51,11,62,610897
chr1,39949685,0.77,53,16,69,610898
chr1,39949693,0.96,64,3,67,610899
chr1,39949718,0.99,77,1,78,610900
chr1,39949765,0.93,74,6,80,610901
chr1,39949773,0.75,59,20,79,610902
chr1,39949811,0.95,63,3,66,610903
chr1,39949819,0.92,55,5,60,610904
chr1,39950303,0.67,61,30,91,610905
chr1,39950330,0.82,85,19,104,610906
chr1,39950370,0.96,109,5,114,610907
chr1,39950396,0.9,107,12,119,610908
chr1,39950417,0.95,116,6,122,610909
chr1,39950488,0.92,100,9,109,610910
chr1,39950632,0.84,72,14,86,610911
chr1,39950742,0.97,64,2,66,610912
chr1,39950903,0.86,92,15,107,610913
chr1,39951230,0.53,46,40,86,610914
chr1,39951242,0.48,49,54,103,610915
chr1,39951254,0.45,40,49,89,610916
chr1,39951259,0.65,64,35,99,610917
chr1,39951266,0.48,42,46,88,610918
chr1,39951278,0.59,50,35,85,610919
chr1,39951281,0.7,52,22,74,610920
chr1,39951292,0.65,46,25,71,610921
chr1,39951318,0.55,37,30,67,610922
chr1,39951334,0.61,39,25,64,610923
chr1,39951352,0.74,49,17,66,610924
chr1,39951461,0.96,77,3,80,610925
chr1,39951541,0.7,60,26,86,610926
chr1,39951775,0.96,76,3,79,610927
chr1,39951777,0.86,62,10,72,610928
chr1,39951925,0.85,77,14,91,610929
chr1,39952145,0.62,44,27,71,610930
chr1,39952251,0.84,66,13,79,610931
chr1,39952315,0.91,78,8,86,610932
chr1,39952350,0.8,92,23,115,610933
chr1,39952373,0.98,118,2,120,610934
chr1,39952386,0.9,123,13,136,610935
chr1,39952392,0.88,121,17,138,610936
chr1,39952444,0.92,129,11,140,610937
chr1,39952458,0.95,131,7,138,610938
chr1,39952538,0.91,87,9,96,610939
chr1,39952751,0.95,101,5,106,610940
chr1,39952853,0.96,76,3,79,610941
chr1,39952997,0.95,71,4,75,610942
chr1,39953065,0.91,51,5,56,610943
chr1,39953101,0.9,45,5,50,610944
chr1,39953313,0.93,83,6,89,610945
chr1,39953439,0.96,64,3,67,610946
chr1,39953552,0.95,94,5,99,610947
chr1,39953603,0.97,113,3,116,610948
chr1,39953636,0.81,88,20,108,610949
chr1,39953934,0.91,48,5,53,610950
chr1,39953943,0.8,37,9,46,610951
chr1,39954040,0.98,55,1,56,610952
chr1,39954056,0.95,58,3,61,610953
chr1,39954065,0.99,70,1,71,610954
chr1,39954247,0.85,67,12,79,610955
chr1,39954296,0.98,47,1,48,610956
chr1,39954354,1,22,0,22,610957
chr1,39954418,0.94,30,2,32,610958
chr1,39954457,0.91,41,4,45,610959
chr1,39954482,1,40,0,40,610960
chr1,39954914,0.61,33,21,54,610961
chr1,39954987,0.69,79,36,115,610962
chr1,39955087,0.49,36,37,73,610963
chr1,39955110,0.72,52,20,72,610964
chr1,39955172,0.55,45,37,82,610965
chr1,39955357,0.72,38,15,53,610966
chr1,39955398,0.58,19,14,33,610967
chr1,39955586,0.82,92,20,112,610968
chr1,39955623,0.35,42,79,121,610969
chr1,39955675,0.75,89,29,118,610970
chr1,39955688,0.58,78,56,134,610971
chr1,39955699,0.8,106,27,133,610972
chr1,39955724,0.64,96,54,150,610973
chr1,39955753,0.9,111,13,124,610974
chr1,39955765,0.48,63,69,132,610975
chr1,39955767,0.5,65,66,131,610976
chr1,39955780,0.64,85,47,132,610977
chr1,39955824,0.91,100,10,110,610978
chr1,39955962,0.58,32,23,55,610979
chr1,39955995,0.6,21,14,35,610980
chr1,39956020,0.83,40,8,48,610981
chr1,39956051,0.9,57,6,63,610982
chr1,39956096,0.88,75,10,85,610983
chr1,39956126,0.97,89,3,92,610984
chr1,39956141,0.85,75,13,88,610985
chr1,39956144,0.72,68,27,95,610986
chr1,39956204,0.67,60,29,89,610987
chr1,39956211,0.83,72,15,87,610988
chr1,39956231,0.78,72,20,92,610989
chr1,39956259,0.97,88,3,91,610990
chr1,39956300,0.56,53,41,94,610991
chr1,39956370,0.74,49,17,66,610992
chr1,39956425,0.84,41,8,49,610993
chr1,39956430,0.67,29,14,43,610994
chr1,39956458,0.66,42,22,64,610995
chr1,39956464,0.69,44,20,64,610996
chr1,39956466,0.67,45,22,67,610997
chr1,39956508,0.11,11,89,100,610998
chr1,39956513,0.03,3,93,96,610999
chr1,39956519,0.22,21,74,95,611000
chr1,39956521,0.13,12,81,93,611001
chr1,39956550,0.1,6,56,62,611002
chr1,39956556,0.04,2,46,48,611003
chr1,39956590,0.02,1,57,58,611004
chr1,39956598,0,0,65,65,611005
chr1,39956641,0.32,12,25,37,611006
chr1,39956653,0.02,1,56,57,611007
chr1,39956672,0,0,52,52,611008
chr1,39956678,0,0,46,46,611009
chr1,39956685,0,0,29,29,611010
chr1,39956702,0.03,1,32,33,611011
chr1,39956708,0,0,17,17,611012
chr1,39956713,0,0,43,43,611013
chr1,39956722,0.16,3,16,19,611014
chr1,39956737,0,0,46,46,611015
chr1,39956739,0,0,48,48,611016
chr1,39956757,0,0,35,35,611017
chr1,39956773,0,0,54,54,611018
chr1,39956784,0.04,2,52,54,611019
chr1,39956795,0.16,3,16,19,611020
chr1,39956799,0.04,2,53,55,611021
chr1,39956807,0.02,1,51,52,611022
chr1,39956822,0.07,4,50,54,611023
chr1,39956831,0.03,1,31,32,611024
chr1,39956841,0.08,2,23,25,611025
chr1,39956852,0,0,42,42,611026
chr1,39956854,0,0,41,41,611027
chr1,39956861,0,0,45,45,611028
chr1,39956868,0,0,49,49,611029
chr1,39956873,0,0,40,40,611030
chr1,39956882,0,0,40,40,611031
chr1,39956905,0,0,40,40,611032
chr1,39956907,0.02,1,41,42,611033
chr1,39956924,0,0,34,34,611034
chr1,39956928,0,0,46,46,611035
chr1,39956940,0,0,45,45,611036
chr1,39956948,0,0,47,47,611037
chr1,39956952,0,0,43,43,611038
chr1,39956954,0,0,42,42,611039
chr1,39956959,0.02,1,45,46,611040
chr1,39956965,0,0,43,43,611041
chr1,39956971,0,0,33,33,611042
chr1,39956977,0,0,45,45,611043
chr1,39956987,0,0,47,47,611044
chr1,39956990,0,0,35,35,611045
chr1,39956999,0,0,42,42,611046
chr1,39957015,0,0,41,41,611047
chr1,39957021,0,0,42,42,611048
chr1,39957026,0.05,2,38,40,611049
chr1,39957029,0.11,3,25,28,611050
chr1,39957032,0,0,43,43,611051
chr1,39957034,0.05,2,41,43,611052
chr1,39957051,0,0,35,35,611053
chr1,39957054,0,0,44,44,611054
chr1,39957061,0,0,46,46,611055
chr1,39957063,0.02,1,44,45,611056
chr1,39957066,0,0,41,41,611057
chr1,39957075,0,0,41,41,611058
chr1,39957078,0,0,40,40,611059
chr1,39957090,0.03,1,36,37,611060
chr1,39957096,0,0,33,33,611061
chr1,39957107,0,0,36,36,611062
chr1,39957116,0,0,29,29,611063
chr1,39957120,0,0,41,41,611064
chr1,39957129,0,0,36,36,611065
chr1,39957138,0.02,1,42,43,611066
chr1,39957141,0.04,2,47,49,611067
chr1,39957147,0,0,36,36,611068
chr1,39957160,0,0,25,25,611069
chr1,39957181,0,0,38,38,611070
chr1,39957188,0,0,57,57,611071
chr1,39957200,0,0,51,51,611072
chr1,39957204,0,0,36,36,611073
chr1,39957206,0.03,1,39,40,611074
chr1,39957213,0.04,2,44,46,611075
chr1,39957215,0,0,40,40,611076
chr1,39957226,0,0,30,30,611077
chr1,39957232,0,0,42,42,611078
chr1,39957234,0,0,34,34,611079
chr1,39957253,0,0,44,44,611080
chr1,39957263,0,0,23,23,611081
chr1,39957267,0,0,22,22,611082
chr1,39957276,0,0,43,43,611083
chr1,39957285,0,0,45,45,611084
chr1,39957298,0.03,1,38,39,611085
chr1,39957307,0,0,36,36,611086
chr1,39957309,0.03,1,31,32,611087
chr1,39957312,0.03,1,29,30,611088
chr1,39957316,0.02,1,44,45,611089
chr1,39957321,0,0,37,37,611090
chr1,39957327,0.02,1,42,43,611091
chr1,39957334,0,0,38,38,611092
chr1,39957337,0.08,4,45,49,611093
chr1,39957341,0,0,32,32,611094
chr1,39957349,0.06,3,44,47,611095
chr1,39957354,0,0,42,42,611096
chr1,39957356,0,0,50,50,611097
chr1,39957361,0.1,5,45,50,611098
chr1,39957373,0.02,1,52,53,611099
chr1,39957387,0.02,1,50,51,611100
chr1,39957390,0,0,33,33,611101
chr1,39957393,0,0,30,30,611102
chr1,39957400,0,0,52,52,611103
chr1,39957436,0,0,46,46,611104
chr1,39957442,0,0,47,47,611105
chr1,39957447,0,0,36,36,611106
chr1,39957453,0,0,35,35,611107
chr1,39957459,0,0,38,38,611108
chr1,39957463,0.05,2,37,39,611109
chr1,39957465,0,0,38,38,611110
chr1,39957471,0,0,38,38,611111
chr1,39957475,0,0,30,30,611112
chr1,39957484,0,0,36,36,611113
chr1,39957490,0,0,37,37,611114
chr1,39957501,0,0,24,24,611115
chr1,39957503,0,0,26,26,611116
chr1,39957505,0,0,29,29,611117
chr1,39957512,0,0,12,12,611118
chr1,39957524,0,0,35,35,611119
chr1,39957526,0,0,32,32,611120
chr1,39957535,0,0,32,32,611121
chr1,39957541,0,0,23,23,611122
chr1,39957544,0,0,23,23,611123
chr1,39957548,0,0,30,30,611124
chr1,39957551,0,0,37,37,611125
chr1,39957558,0,0,23,23,611126
chr1,39957569,0,0,38,38,611127
chr1,39957572,0,0,42,42,611128
chr1,39957586,0,0,47,47,611129
chr1,39957590,0.03,1,39,40,611130
chr1,39957593,0,0,49,49,611131
chr1,39957596,0.02,1,49,50,611132
chr1,39957601,0,0,29,29,611133
chr1,39957607,0.04,2,51,53,611134
chr1,39957619,0.09,3,31,34,611135
chr1,39957622,0.09,3,30,33,611136
chr1,39957625,0.03,1,30,31,611137
chr1,39957638,0.04,1,22,23,611138
chr1,39957642,0.07,3,38,41,611139
chr1,39957649,0,0,17,17,611140
chr1,39957655,0.03,1,37,38,611141
chr1,39957660,0.06,2,31,33,611142
chr1,39957669,0,0,39,39,611143
chr1,39957671,0,0,34,34,611144
chr1,39957673,0,0,28,28,611145
chr1,39957678,0,0,44,44,611146
chr1,39957683,0,0,35,35,611147
chr1,39957704,0,0,39,39,611148
chr1,39957711,0,0,38,38,611149
chr1,39957713,0,0,38,38,611150
chr1,39957720,0.04,1,23,24,611151
chr1,39957726,0,0,17,17,611152
chr1,39957732,0.08,3,33,36,611153
chr1,39957746,0.1,3,28,31,611154
chr1,39957750,0.05,2,39,41,611155
chr1,39957763,0.1,4,37,41,611156
chr1,39957766,0.02,1,42,43,611157
chr1,39957774,0.03,1,33,34,611158
chr1,39957776,0,0,35,35,611159
chr1,39957778,0.08,3,35,38,611160
chr1,39957780,0.12,5,38,43,611161
chr1,39957784,0.2,8,33,41,611162
chr1,39957787,0.02,1,43,44,611163
chr1,39957792,0.02,1,42,43,611164
chr1,39957799,0.03,1,34,35,611165
chr1,39957801,0.02,1,40,41,611166
chr1,39957812,0.1,4,37,41,611167
chr1,39957819,0.02,1,46,47,611168
chr1,39957828,0.02,1,49,50,611169
chr1,39957832,0,0,32,32,611170
chr1,39957838,0,0,38,38,611171
chr1,39957844,0.06,2,34,36,611172
chr1,39957846,0.03,1,32,33,611173
chr1,39957848,0,0,26,26,611174
chr1,39957855,0.05,1,21,22,611175
chr1,39957858,0,0,19,19,611176
chr1,39957865,0.03,1,29,30,611177
chr1,39957873,0,0,32,32,611178
chr1,39957875,0,0,35,35,611179
chr1,39957879,0.03,1,29,30,611180
chr1,39957881,0.08,2,23,25,611181
chr1,39957884,0.04,1,26,27,611182
chr1,39957909,0.18,6,28,34,611183
chr1,39957912,0.07,3,40,43,611184
chr1,39957921,0.04,2,46,48,611185
chr1,39957924,0,0,54,54,611186
chr1,39957927,0.02,1,57,58,611187
chr1,39957930,0,0,59,59,611188
chr1,39957936,0.05,3,56,59,611189
chr1,39957939,0.09,4,40,44,611190
chr1,39957941,0,0,45,45,611191
chr1,39957945,0.05,3,61,64,611192
chr1,39957947,0.02,1,65,66,611193
chr1,39957955,0.08,4,46,50,611194
chr1,39957964,0.07,4,56,60,611195
chr1,39957966,0.04,2,45,47,611196
chr1,39957969,0.02,1,64,65,611197
chr1,39957987,0.03,2,62,64,611198
chr1,39958005,0.14,7,44,51,611199
chr1,39958009,0.16,7,38,45,611200
chr1,39958013,0.08,4,47,51,611201
chr1,39958015,0.02,1,47,48,611202
chr1,39958017,0.04,2,49,51,611203
chr1,39958027,0,0,53,53,611204
chr1,39958054,0.19,5,22,27,611205
chr1,39958056,0.15,5,28,33,611206
chr1,39958062,0.07,3,43,46,611207
chr1,39958064,0.02,1,45,46,611208
chr1,39958068,0.04,1,25,26,611209
chr1,39958074,0.06,3,46,49,611210
chr1,39958079,0.02,1,43,44,611211
chr1,39958085,0.08,4,48,52,611212
chr1,39958089,0.12,6,46,52,611213
chr1,39958103,0.2,10,39,49,611214
chr1,39958110,0.21,8,31,39,611215
chr1,39958112,0.5,17,17,34,611216
chr1,39958133,0.23,6,20,26,611217
chr1,39958136,0.14,4,24,28,611218
chr1,39958180,0.14,2,12,14,611219
chr1,39958224,0.75,18,6,24,611220
chr1,39958297,0.5,23,23,46,611221
chr1,39958343,0.68,49,23,72,611222
chr1,39958396,0.51,40,39,79,611223
chr1,39958420,0.92,72,6,78,611224
chr1,39958440,0.84,51,10,61,611225
chr1,39958442,0.9,53,6,59,611226
chr1,39958476,0.97,36,1,37,611227
chr1,39958494,0.97,28,1,29,611228
chr1,39958509,0.97,30,1,31,611229
chr1,39958535,0.7,32,14,46,611230
chr1,39958609,0.87,41,6,47,611231
chr1,39958667,0.85,34,6,40,611232
chr1,39958771,0.71,62,25,87,611233
chr1,39958798,0.96,76,3,79,611234
chr1,39958835,0.95,57,3,60,611235
chr1,39958868,0.88,45,6,51,611236
chr1,39958965,0.95,40,2,42,611237
chr1,39958986,0.95,39,2,41,611238
chr1,39959037,0.98,45,1,46,611239
chr1,39959054,0.97,61,2,63,611240
chr1,39959285,0.9,55,6,61,611241
chr1,39959310,0.98,60,1,61,611242
chr1,39959338,0.94,67,4,71,611243
chr1,39959345,0.97,65,2,67,611244
chr1,39959373,0.81,60,14,74,611245
chr1,39959519,0,0,1,1,611246
chr1,39959543,1,3,0,3,611247
chr1,39959557,0.42,5,7,12,611248
chr1,39959578,0.33,8,16,24,611249
chr1,39959890,0.94,68,4,72,611250
chr1,39960085,0.95,58,3,61,611251
chr1,39960115,0.95,78,4,82,611252
chr1,39960167,0.93,74,6,80,611253
chr1,39960213,0.94,79,5,84,611254
chr1,39960306,0.94,89,6,95,611255
chr1,39960328,0.94,98,6,104,611256
chr1,39960400,0.99,96,1,97,611257
chr1,39960520,0.96,100,4,104,611258
chr1,39960532,0.96,96,4,100,611259
chr1,39960535,0.93,98,7,105,611260
chr1,39960555,0.86,87,14,101,611261
chr1,39960587,0.98,92,2,94,611262
chr1,39960691,0.98,45,1,46,611263
chr1,39960717,0.94,29,2,31,611264
chr1,39960796,0.96,22,1,23,611265
chr1,39960942,0.97,85,3,88,611266
chr1,39960951,0.94,87,6,93,611267
chr1,39960982,0.78,75,21,96,611268
chr1,39961016,0.96,55,2,57,611269
chr1,39961066,0.8,4,1,5,611270
chr1,39961641,1,5,0,5,611271
chr1,39961676,0.86,12,2,14,611272
chr1,39961713,0.75,43,14,57,611273
chr1,39961725,0.84,53,10,63,611274
chr1,39961750,0.88,71,10,81,611275
chr1,39961764,0.75,67,22,89,611276
chr1,39961779,0.7,52,22,74,611277
chr1,39962017,0,0,3,3,611278
chr1,39962247,1,48,0,48,611279
chr1,39962256,0.95,42,2,44,611280
chr1,39962305,1,29,0,29,611281
chr1,39962438,0.99,76,1,77,611282
chr1,39962467,0.93,78,6,84,611283
chr1,39962641,0.99,78,1,79,611284
chr1,39962859,0.92,70,6,76,611285
chr1,39962926,0.99,87,1,88,611286
chr1,39962948,0.99,103,1,104,611287
chr1,39963025,0.87,74,11,85,611288
chr1,39963057,0.97,68,2,70,611289
chr1,39963093,0.94,81,5,86,611290
chr1,39963122,0.93,83,6,89,611291
chr1,39963311,0.98,65,1,66,611292
chr1,39963432,0.42,16,22,38,611293
chr1,39963523,0.88,21,3,24,611294
chr1,39963631,1,8,0,8,611295
chr1,39963641,1,3,0,3,611296
chr1,39963672,0.8,4,1,5,611297
chr1,39963907,0.81,52,12,64,611298
chr1,39964035,0.84,84,16,100,611299
chr1,39964101,0.89,64,8,72,611300
chr1,39964172,0.9,35,4,39,611301
chr1,39964269,0.96,64,3,67,611302
chr1,39964274,0.66,48,25,73,611303
chr1,39964279,0.98,61,1,62,611304
chr1,39964318,0.94,29,2,31,611305
chr1,39964529,0.86,6,1,7,611306
chr1,39964538,0.69,11,5,16,611307
chr1,39964622,0.97,58,2,60,611308
chr1,39964634,0.98,49,1,50,611309
chr1,39964673,0.97,38,1,39,611310
chr1,39964684,0.95,41,2,43,611311
chr1,39964697,0.96,43,2,45,611312
chr1,39964707,0.98,45,1,46,611313
chr1,39964711,0.98,47,1,48,611314
chr1,39964726,0.96,44,2,46,611315
chr1,39964760,0.96,44,2,46,611316
chr1,39964776,0.97,37,1,38,611317
chr1,39964828,1,5,0,5,611318
chr1,39964939,1,4,0,4,611319
chr1,39964946,0.93,13,1,14,611320
chr1,39964973,1,34,0,34,611321
chr1,39964997,0.98,45,1,46,611322
chr1,39965036,0.93,70,5,75,611323
chr1,39965042,0.92,57,5,62,611324
chr1,39965219,0.92,83,7,90,611325
chr1,39965231,0.89,80,10,90,611326
chr1,39965282,0.95,80,4,84,611327
chr1,39965349,0.66,41,21,62,611328
chr1,39965403,0.88,57,8,65,611329
chr1,39965452,1,69,0,69,611330
chr1,39965454,0.93,62,5,67,611331
chr1,39965561,0.88,71,10,81,611332
chr1,39965760,0.95,58,3,61,611333
chr1,39965896,0.52,55,51,106,611334
chr1,39966137,0.77,66,20,86,611335
chr1,39966198,0.88,78,11,89,611336
chr1,39966347,0.79,33,9,42,611337
chr1,39966473,0.94,47,3,50,611338
chr1,39966572,0.95,81,4,85,611339
chr1,39966617,0.96,96,4,100,611340
chr1,39966625,0.95,102,5,107,611341
chr1,39966933,0.8,66,16,82,611342
chr1,39967633,0.89,92,11,103,611343
chr1,39967637,0.94,95,6,101,611344
chr1,39967649,0.92,84,7,91,611345
chr1,39967699,0.85,61,11,72,611346
chr1,39967802,0.94,88,6,94,611347
chr1,39967824,1,87,0,87,611348
chr1,39967866,0.96,50,2,52,611349
chr1,39967888,0.96,44,2,46,611350
chr1,39968453,0.96,49,2,51,611351
chr1,39968486,0.98,49,1,50,611352
chr1,39968513,1,49,0,49,611353
chr1,39968578,1,98,0,98,611354
chr1,39968649,0.98,111,2,113,611355
chr1,39968823,0.96,49,2,51,611356
chr1,39968981,0.97,83,3,86,611357
chr1,39969219,1,24,0,24,611358
chr1,39969245,0.98,42,1,43,611359
chr1,39969406,0.96,87,4,91,611360
chr1,39969436,0.95,90,5,95,611361
chr1,39969591,0.98,59,1,60,611362
chr1,39969649,0.98,87,2,89,611363
chr1,39969678,0.85,91,16,107,611364
chr1,39969714,0.98,112,2,114,611365
chr1,39969737,0.99,111,1,112,611366
chr1,39969844,0.89,62,8,70,611367
chr1,39969927,0.91,60,6,66,611368
chr1,39969955,0.8,39,10,49,611369
chr1,39970012,0.8,12,3,15,611370
chr1,39970113,0.97,64,2,66,611371
chr1,39970123,0.78,58,16,74,611372
chr1,39970211,0.84,141,26,167,611373
chr1,39970242,0.73,136,51,187,611374
chr1,39970266,0.96,165,6,171,611375
chr1,39970311,0.98,121,3,124,611376
chr1,39970402,0.96,77,3,80,611377
chr1,39970411,0.95,74,4,78,611378
chr1,39970582,0.89,66,8,74,611379
chr1,39970620,0.95,61,3,64,611380
chr1,39970653,1,68,0,68,611381
chr1,39970719,0.88,76,10,86,611382
chr1,39970733,0.89,84,10,94,611383
chr1,39970906,0.7,52,22,74,611384
chr1,39971723,0.91,58,6,64,611385
chr1,39971734,0.96,71,3,74,611386
chr1,39971758,0.95,95,5,100,611387
chr1,39971904,0.79,63,17,80,611388
chr1,39971942,0.99,82,1,83,611389
chr1,39972037,0.94,46,3,49,611390
chr1,39972125,1,19,0,19,611391
chr1,39972130,0.86,18,3,21,611392
chr1,39972168,0.95,40,2,42,611393
chr1,39972170,1,40,0,40,611394
chr1,39972479,0.8,99,25,124,611395
chr1,39972751,0.78,60,17,77,611396
chr1,39972856,0.97,73,2,75,611397
chr1,39972874,0.93,65,5,70,611398
chr1,39973113,0.15,19,109,128,611399
chr1,39973117,0.73,91,34,125,611400
chr1,39973169,0.62,80,50,130,611401
chr1,39973182,0.65,80,43,123,611402
chr1,39973202,0.89,99,12,111,611403
chr1,39973218,0.79,81,22,103,611404
chr1,39973226,0.42,44,60,104,611405
chr1,39973269,0.96,78,3,81,611406
chr1,39973288,0.93,70,5,75,611407
chr1,39973316,0.92,68,6,74,611408
chr1,39973402,0.68,44,21,65,611409
chr1,39973424,0.97,64,2,66,611410
chr1,39973452,0.95,73,4,77,611411
chr1,39973517,0.93,82,6,88,611412
chr1,39973645,0.94,81,5,86,611413
chr1,39973661,0.99,74,1,75,611414
chr1,39973689,0.98,53,1,54,611415
chr1,39973694,0.98,54,1,55,611416
chr1,39973719,0.94,46,3,49,611417
chr1,39973739,0.82,40,9,49,611418
chr1,39973783,0.99,92,1,93,611419
chr1,39973795,0.97,91,3,94,611420
chr1,39973839,0.96,73,3,76,611421
chr1,39973847,0.97,67,2,69,611422
chr1,39973854,1,59,0,59,611423
chr1,39973877,0.75,38,13,51,611424
chr1,39973917,0.77,17,5,22,611425
chr1,39973962,0.63,27,16,43,611426
chr1,39973999,0.9,52,6,58,611427
chr1,39974084,0.98,59,1,60,611428
chr1,39974100,0.95,58,3,61,611429
chr1,39974150,0.91,74,7,81,611430
chr1,39974192,0.77,58,17,75,611431
chr1,39974583,0.56,75,58,133,611432
chr1,39974602,0.88,119,17,136,611433
chr1,39974604,0.92,130,11,141,611434
chr1,39974624,0.76,97,31,128,611435
chr1,39974677,0.95,99,5,104,611436
chr1,39974697,0.7,68,29,97,611437
chr1,39974701,0.8,64,16,80,611438
chr1,39974853,0.97,88,3,91,611439
chr1,39974864,0.95,92,5,97,611440
chr1,39974878,0.79,81,21,102,611441
chr1,39974903,0.92,103,9,112,611442
chr1,39975025,0.7,57,24,81,611443
chr1,39975059,0.6,42,28,70,611444
chr1,39975128,0.95,60,3,63,611445
chr1,39975142,0.9,56,6,62,611446
chr1,39975158,0.86,51,8,59,611447
chr1,39975169,0.93,50,4,54,611448
chr1,39975233,0.96,48,2,50,611449
chr1,39975252,0.93,41,3,44,611450
chr1,39975276,0.74,35,12,47,611451
chr1,39975293,0.96,49,2,51,611452
chr1,39975298,0.82,42,9,51,611453
chr1,39975310,0.88,51,7,58,611454
chr1,39975342,0.42,36,50,86,611455
chr1,39975368,0.86,66,11,77,611456
chr1,39975373,0.46,40,47,87,611457
chr1,39975378,0.65,55,30,85,611458
chr1,39975408,0.33,30,60,90,611459
chr1,39975504,0.87,47,7,54,611460
chr1,39975524,0.89,55,7,62,611461
chr1,39975556,0.75,54,18,72,611462
chr1,39975589,0.79,50,13,63,611463
chr1,39975604,0.59,36,25,61,611464
chr1,39975644,0.96,26,1,27,611465
chr1,39975687,0.5,2,2,4,611466
chr1,39975786,0,0,22,22,611467
chr1,39976047,0.9,18,2,20,611468
chr1,39976076,0.95,18,1,19,611469
chr1,39976119,0.75,3,1,4,611470
chr1,39976267,1,5,0,5,611471
chr1,39976292,0.91,21,2,23,611472
chr1,39976343,0.97,72,2,74,611473
chr1,39976363,0.98,93,2,95,611474
chr1,39976400,0.92,90,8,98,611475
chr1,39976403,0.92,91,8,99,611476
chr1,39976412,0.89,90,11,101,611477
chr1,39976551,0.97,67,2,69,611478
chr1,39976566,0.99,73,1,74,611479
chr1,39976571,0.93,74,6,80,611480
chr1,39976671,0.91,67,7,74,611481
chr1,39976692,0.62,43,26,69,611482
chr1,39976711,0.96,64,3,67,611483
chr1,39976737,0.94,62,4,66,611484
chr1,39976768,1,50,0,50,611485
chr1,39976803,0.97,29,1,30,611486
chr1,39976828,1,16,0,16,611487
chr1,39976851,1,5,0,5,611488
chr1,39976857,1,1,0,1,611489
chr1,39977320,1,40,0,40,611490
chr1,39977343,0.9,52,6,58,611491
chr1,39977348,0.97,60,2,62,611492
chr1,39977364,0.92,48,4,52,611493
chr1,39977379,0.82,36,8,44,611494
chr1,39977394,0.81,30,7,37,611495
chr1,39977398,0.85,22,4,26,611496
chr1,39977401,0.67,18,9,27,611497
chr1,39977932,0,0,1,1,611498
chr1,39977944,0,0,1,1,611499
chr1,39978379,0.6,9,6,15,611500
chr1,39978384,0.48,10,11,21,611501
chr1,39978449,0.74,57,20,77,611502
chr1,39978457,0.84,69,13,82,611503
chr1,39978476,0.63,45,27,72,611504
chr1,39978485,0.59,38,26,64,611505
chr1,39978515,0.83,33,7,40,611506
chr1,39978533,0.88,14,2,16,611507
chr1,39978546,0.89,8,1,9,611508
chr1,39979075,0.71,10,4,14,611509
chr1,39979106,0.96,23,1,24,611510
chr1,39979153,0.88,14,2,16,611511
chr1,39979185,1,7,0,7,611512
chr1,39979394,0.92,24,2,26,611513
chr1,39979401,0.96,22,1,23,611514
chr1,39979415,0.94,17,1,18,611515
chr1,39979624,0.63,10,6,16,611516
chr1,39980012,1,7,0,7,611517
chr1,39980034,0.54,15,13,28,611518
chr1,39980096,0.54,29,25,54,611519
chr1,39980154,0.11,2,16,18,611520
chr1,39980300,0.42,5,7,12,611521
chr1,39980366,0.04,2,45,47,611522
chr1,39980368,0.07,3,42,45,611523
chr1,39980394,0.1,4,37,41,611524
chr1,39980398,0.02,1,48,49,611525
chr1,39980408,0.02,1,44,45,611526
chr1,39980417,0.02,1,47,48,611527
chr1,39980430,0.02,1,45,46,611528
chr1,39980449,0,0,21,21,611529
chr1,39980455,0,0,35,35,611530
chr1,39980472,0,0,21,21,611531
chr1,39980477,0,0,23,23,611532
chr1,39980479,0,0,15,15,611533
chr1,39980499,0,0,11,11,611534
chr1,39980507,0.06,1,15,16,611535
chr1,39980532,0,0,10,10,611536
chr1,39980540,0,0,7,7,611537
chr1,39980542,0,0,9,9,611538
chr1,39980546,0,0,2,2,611539
chr1,39980550,0,0,10,10,611540
chr1,39980565,0,0,13,13,611541
chr1,39980567,0,0,14,14,611542
chr1,39980569,0,0,14,14,611543
chr1,39980574,0,0,17,17,611544
chr1,39980579,0,0,14,14,611545
chr1,39980583,0,0,19,19,611546
chr1,39980613,0,0,22,22,611547
chr1,39980618,0,0,23,23,611548
chr1,39980623,0,0,21,21,611549
chr1,39980632,0,0,20,20,611550
chr1,39980635,0,0,16,16,611551
chr1,39980640,0,0,16,16,611552
chr1,39980650,0,0,16,16,611553
chr1,39980660,0,0,14,14,611554
chr1,39980664,0,0,13,13,611555
chr1,39980666,0,0,13,13,611556
chr1,39980675,0,0,11,11,611557
chr1,39980678,0,0,15,15,611558
chr1,39980681,0,0,16,16,611559
chr1,39980693,0,0,13,13,611560
chr1,39980695,0,0,15,15,611561
chr1,39980711,0,0,6,6,611562
chr1,39980715,0,0,21,21,611563
chr1,39980736,0,0,28,28,611564
chr1,39980742,0.03,1,28,29,611565
chr1,39980756,0.08,2,24,26,611566
chr1,39980758,0,0,28,28,611567
chr1,39980764,0,0,27,27,611568
chr1,39980792,0,0,13,13,611569
chr1,39980797,0,0,10,10,611570
chr1,39980801,0.11,1,8,9,611571
chr1,39980810,0,0,7,7,611572
chr1,39980819,0.33,1,2,3,611573
chr1,39980837,0,0,2,2,611574
chr1,39980852,0,0,3,3,611575
chr1,39980854,0,0,2,2,611576
chr1,39980900,0,0,4,4,611577
chr1,39981272,0,0,3,3,611578
chr1,39981276,0,0,6,6,611579
chr1,39981287,0,0,11,11,611580
chr1,39981305,0.13,2,13,15,611581
chr1,39981309,0.08,2,23,25,611582
chr1,39981320,0.06,2,32,34,611583
chr1,39981344,0.06,3,47,50,611584
chr1,39981349,0.09,5,52,57,611585
chr1,39981352,0.15,8,47,55,611586
chr1,39981388,0.16,11,57,68,611587
chr1,39981410,0.22,16,58,74,611588
chr1,39981412,0.29,22,53,75,611589
chr1,39981433,0.19,17,71,88,611590
chr1,39981440,0.16,14,76,90,611591
chr1,39981449,0.26,21,60,81,611592
chr1,39981456,0.13,10,67,77,611593
chr1,39981461,0.19,16,68,84,611594
chr1,39981481,0.13,10,66,76,611595
chr1,39981499,0.25,14,42,56,611596
chr1,39981507,0.18,9,40,49,611597
chr1,39981509,0.26,12,35,47,611598
chr1,39981521,0.19,7,30,37,611599
chr1,39981523,0.2,7,28,35,611600
chr1,39981544,0.07,1,13,14,611601
chr1,39981553,0,0,10,10,611602
chr1,39981724,0,0,1,1,611603
chr1,39981745,0,0,1,1,611604
chr1,39982128,0.86,6,1,7,611605
chr1,39982163,1,13,0,13,611606
chr1,39982180,1,15,0,15,611607
chr1,39982190,0.94,17,1,18,611608
chr1,39982202,0.88,23,3,26,611609
chr1,39982212,0.76,19,6,25,611610
chr1,39982363,1,3,0,3,611611
chr1,39982436,0.57,24,18,42,611612
chr1,39982450,0.63,32,19,51,611613
chr1,39982477,1,27,0,27,611614
chr1,39982486,0.96,23,1,24,611615
chr1,39982520,1,13,0,13,611616
chr1,39982588,1,31,0,31,611617
chr1,39982802,0.61,44,28,72,611618
chr1,39982906,0.95,42,2,44,611619
chr1,39983283,0.8,16,4,20,611620
chr1,39983296,0.77,17,5,22,611621
chr1,39983306,0.88,15,2,17,611622
chr1,39983423,0.94,15,1,16,611623
chr1,39983461,0.89,42,5,47,611624
chr1,39983496,0.8,61,15,76,611625
chr1,39983700,0.47,20,23,43,611626
chr1,39983720,0.91,42,4,46,611627
chr1,39983786,0.92,65,6,71,611628
chr1,39983794,0.91,69,7,76,611629
chr1,39983796,0.89,71,9,80,611630
chr1,39983804,0.78,65,18,83,611631
chr1,39984538,1,8,0,8,611632
chr1,39985020,0.25,3,9,12,611633
chr1,39985102,0.79,73,19,92,611634
chr1,39985202,0.17,1,5,6,611635
chr1,39985412,0.67,47,23,70,611636
chr1,39985453,0.74,25,9,34,611637
chr1,39985937,0.76,52,16,68,611638
chr1,39986054,0.92,23,2,25,611639
chr1,39986951,1,1,0,1,611640
chr1,39986974,1,1,0,1,611641
chr1,39986986,1,1,0,1,611642
chr1,39987009,0,0,1,1,611643
chr1,39987016,1,1,0,1,611644
chr1,39987582,0,0,1,1,611645
chr1,39987594,1,2,0,2,611646
chr1,39987654,0.67,2,1,3,611647
chr1,39987788,0.78,7,2,9,611648
chr1,39987825,1,10,0,10,611649
chr1,39987922,0.88,60,8,68,611650
chr1,39988079,0.87,45,7,52,611651
chr1,39988083,0.67,40,20,60,611652
chr1,39988085,0.89,55,7,62,611653
chr1,39988094,0.86,60,10,70,611654
chr1,39988098,0.78,51,14,65,611655
chr1,39988110,0.68,42,20,62,611656
chr1,39988113,0.72,46,18,64,611657
chr1,39988118,0.76,50,16,66,611658
chr1,39988127,0.91,63,6,69,611659
chr1,39988205,0,0,44,44,611660
chr1,39988401,0.72,48,19,67,611661
chr1,39988434,0.83,39,8,47,611662
chr1,39988470,0.19,11,48,59,611663
chr1,39988484,0.64,39,22,61,611664
chr1,39988550,0.96,43,2,45,611665
chr1,39988553,0.58,26,19,45,611666
chr1,39988591,0.74,17,6,23,611667
chr1,39988690,0.93,25,2,27,611668
chr1,39988740,0.88,38,5,43,611669
chr1,39988759,0.8,33,8,41,611670
chr1,39988771,0.85,35,6,41,611671
chr1,39988798,0.66,29,15,44,611672
chr1,39988863,0.61,33,21,54,611673
chr1,39988896,0.9,56,6,62,611674
chr1,39989003,0.93,95,7,102,611675
chr1,39989011,0.88,91,13,104,611676
chr1,39989021,0.92,98,8,106,611677
chr1,39989023,0.91,97,10,107,611678
chr1,39989080,0.97,111,4,115,611679
chr1,39989084,0.95,106,6,112,611680
chr1,39989087,0.96,109,4,113,611681
chr1,39989152,0.89,74,9,83,611682
chr1,39989160,0.95,74,4,78,611683
chr1,39989166,0.99,75,1,76,611684
chr1,39989182,0.95,56,3,59,611685
chr1,39989186,0.93,54,4,58,611686
chr1,39989197,0.97,59,2,61,611687
chr1,39989217,0.96,65,3,68,611688
chr1,39989240,0.92,68,6,74,611689
chr1,39989297,0.9,83,9,92,611690
chr1,39989440,0.91,100,10,110,611691
chr1,39989453,0.75,79,27,106,611692
chr1,39989536,0.42,42,57,99,611693
chr1,39989555,0.97,90,3,93,611694
chr1,39989576,0.92,71,6,77,611695
chr1,39989585,0.87,67,10,77,611696
chr1,39989681,0.72,38,15,53,611697
chr1,39989685,0.9,46,5,51,611698
chr1,39989828,0.8,47,12,59,611699
chr1,39989830,0.89,50,6,56,611700
chr1,39989863,0.65,36,19,55,611701
chr1,39989926,0.88,50,7,57,611702
chr1,39990034,0.66,53,27,80,611703
chr1,39990058,0.54,49,42,91,611704
chr1,39990097,0.8,70,18,88,611705
chr1,39990102,0.7,63,27,90,611706
chr1,39990150,0.6,52,35,87,611707
chr1,39990292,0.82,45,10,55,611708
chr1,39990314,0.66,39,20,59,611709
chr1,39990410,0.94,68,4,72,611710
chr1,39990455,0.93,54,4,58,611711
chr1,39990457,0.85,47,8,55,611712
chr1,39990527,0.74,35,12,47,611713
chr1,39990544,0.87,39,6,45,611714
chr1,39990554,0.8,37,9,46,611715
chr1,39990601,0.98,54,1,55,611716
chr1,39990631,0.92,61,5,66,611717
chr1,39990651,0.97,69,2,71,611718
chr1,39990723,0.96,81,3,84,611719
chr1,39990779,0.98,62,1,63,611720
chr1,39990811,1,43,0,43,611721
chr1,39990854,1,28,0,28,611722
chr1,39991053,0.83,34,7,41,611723
chr1,39991143,1,78,0,78,611724
chr1,39991252,0.97,36,1,37,611725
chr1,39991341,0.58,35,25,60,611726
chr1,39991355,0.95,41,2,43,611727
chr1,39991380,0.98,43,1,44,611728
chr1,39991416,0.96,52,2,54,611729
chr1,39991426,1,55,0,55,611730
chr1,39991435,1,61,0,61,611731
chr1,39991458,0.97,65,2,67,611732
chr1,39991478,0.99,71,1,72,611733
chr1,39991515,0.78,59,17,76,611734
chr1,39991587,0.65,55,30,85,611735
chr1,39991623,0.76,61,19,80,611736
chr1,39991670,0.76,53,17,70,611737
chr1,39991744,0,0,96,96,611738
chr1,39991781,0.39,34,54,88,611739
chr1,39991805,0.56,45,35,80,611740
chr1,39991902,0.99,85,1,86,611741
chr1,39991997,0.59,32,22,54,611742
chr1,39992120,0.91,84,8,92,611743
chr1,39992167,0.93,86,6,92,611744
chr1,39992199,0.96,82,3,85,611745
chr1,39992215,0.9,78,9,87,611746
chr1,39992257,0.97,74,2,76,611747
chr1,39992261,0.9,72,8,80,611748
chr1,39992299,0.81,66,15,81,611749
chr1,39992529,0.96,69,3,72,611750
chr1,39992575,0.91,64,6,70,611751
chr1,39992729,0.96,69,3,72,611752
chr1,39992808,0.97,68,2,70,611753
chr1,39992811,0.95,69,4,73,611754
chr1,39992833,0.99,85,1,86,611755
chr1,39992931,0.96,67,3,70,611756
chr1,39992947,0.9,66,7,73,611757
chr1,39992954,0.91,62,6,68,611758
chr1,39993062,0.63,38,22,60,611759
chr1,39993089,0.84,59,11,70,611760
chr1,39993149,0.96,51,2,53,611761
chr1,39993166,0.72,34,13,47,611762
chr1,39993432,0.96,52,2,54,611763
chr1,39993486,0.96,49,2,51,611764
chr1,39993695,0.91,112,11,123,611765
chr1,39993790,0.98,79,2,81,611766
chr1,39993796,0.95,73,4,77,611767
chr1,39993884,0.63,38,22,60,611768
chr1,39993972,0.7,45,19,64,611769
chr1,39994225,0.96,93,4,97,611770
chr1,39994262,0.99,70,1,71,611771
chr1,39994266,0.99,70,1,71,611772
chr1,39994271,0.92,61,5,66,611773
chr1,39994346,0.67,24,12,36,611774
chr1,39994414,0.71,22,9,31,611775
chr1,39994497,0.86,51,8,59,611776
chr1,39994521,0.87,48,7,55,611777
chr1,39994586,0.88,56,8,64,611778
chr1,39994674,0.97,95,3,98,611779
chr1,39994689,0.99,100,1,101,611780
chr1,39994737,0.9,92,10,102,611781
chr1,39994749,0.92,94,8,102,611782
chr1,39994830,0.97,103,3,106,611783
chr1,39994895,0.95,101,5,106,611784
chr1,39994997,0.82,76,17,93,611785
chr1,39995035,0.98,86,2,88,611786
chr1,39995043,0.88,76,10,86,611787
chr1,39995074,0.96,76,3,79,611788
chr1,39995076,0.97,76,2,78,611789
chr1,39995127,0.86,54,9,63,611790
chr1,39995230,0.97,65,2,67,611791
chr1,39995270,0.89,62,8,70,611792
chr1,39995477,0.96,94,4,98,611793
chr1,39995604,0.9,46,5,51,611794
chr1,39995623,0.93,39,3,42,611795
chr1,39995672,0.88,61,8,69,611796
chr1,39995682,0.65,46,25,71,611797
chr1,39995834,0.88,64,9,73,611798
chr1,39995968,0.95,60,3,63,611799
chr1,39995976,0.9,55,6,61,611800
chr1,39996104,0.92,83,7,90,611801
chr1,39996133,0.9,87,10,97,611802
chr1,39996189,0.96,65,3,68,611803
chr1,39996389,0.95,75,4,79,611804
chr1,39996438,0.95,62,3,65,611805
chr1,39996751,0.98,44,1,45,611806
chr1,39996852,0.99,79,1,80,611807
chr1,39996867,0.99,80,1,81,611808
chr1,39996883,0.73,65,24,89,611809
chr1,39997064,0.89,72,9,81,611810
chr1,39997111,0.83,69,14,83,611811
chr1,39997270,0.94,65,4,69,611812
chr1,39997311,0.86,50,8,58,611813
chr1,39997427,0.8,48,12,60,611814
chr1,39997506,0.98,40,1,41,611815
chr1,39997989,0.96,66,3,69,611816
chr1,39998084,0.94,66,4,70,611817
chr1,39998189,1,60,0,60,611818
chr1,39998205,0.95,61,3,64,611819
chr1,39998240,0.97,71,2,73,611820
chr1,39998242,0.92,72,6,78,611821
chr1,39998283,0.98,47,1,48,611822
chr1,39998327,1,20,0,20,611823
chr1,39998335,1,22,0,22,611824
chr1,39998339,1,21,0,21,611825
chr1,39998383,0.98,43,1,44,611826
chr1,39998421,1,42,0,42,611827
chr1,39998429,0.97,33,1,34,611828
chr1,39998445,1,32,0,32,611829
chr1,39998582,0.97,64,2,66,611830
chr1,39998636,0.83,58,12,70,611831
chr1,39998832,0.97,60,2,62,611832
chr1,39998842,0.98,51,1,52,611833
chr1,39998856,0.95,40,2,42,611834
chr1,39998880,0.97,28,1,29,611835
chr1,39998885,0.96,23,1,24,611836
chr1,39998910,1,25,0,25,611837
chr1,39998971,0.98,46,1,47,611838
chr1,39998974,0.91,43,4,47,611839
chr1,39998982,0.96,43,2,45,611840
chr1,39998986,0.98,47,1,48,611841
chr1,39999030,0.97,59,2,61,611842
chr1,39999038,0.92,59,5,64,611843
chr1,39999092,0.95,52,3,55,611844
chr1,39999483,0.82,63,14,77,611845
chr1,39999562,0.85,55,10,65,611846
chr1,39999784,0.37,34,57,91,611847
chr1,39999877,0.89,96,12,108,611848
chr1,40000080,0.73,83,31,114,611849
chr1,40000109,0.95,101,5,106,611850
chr1,40000304,0.93,74,6,80,611851
chr1,40000307,0.99,78,1,79,611852
chr1,40000354,0.96,76,3,79,611853
chr1,40000358,0.96,71,3,74,611854
chr1,40000370,0.99,71,1,72,611855
chr1,40000403,0.98,50,1,51,611856
chr1,40000448,0.82,47,10,57,611857
chr1,40000630,0.6,41,27,68,611858
chr1,40000729,0.9,83,9,92,611859
chr1,40001091,0.94,64,4,68,611860
chr1,40001216,0.97,62,2,64,611861
chr1,40001264,0.86,43,7,50,611862
chr1,40001275,1,44,0,44,611863
chr1,40001280,1,43,0,43,611864
chr1,40001284,1,39,0,39,611865
chr1,40001325,0.9,46,5,51,611866
chr1,40001370,0.98,44,1,45,611867
chr1,40001382,0.97,34,1,35,611868
chr1,40001402,0.93,25,2,27,611869
chr1,40001426,0.82,18,4,22,611870
chr1,40001434,1,19,0,19,611871
chr1,40001441,1,19,0,19,611872
chr1,40001466,1,20,0,20,611873
chr1,40001560,0.4,35,52,87,611874
chr1,40001598,0.52,59,54,113,611875
chr1,40001655,0.77,119,36,155,611876
chr1,40001685,0.67,97,48,145,611877
chr1,40001713,0.6,76,50,126,611878
chr1,40001803,0.78,53,15,68,611879
chr1,40002069,0.93,57,4,61,611880
chr1,40002075,0.95,58,3,61,611881
chr1,40002085,0.96,51,2,53,611882
chr1,40002129,0.87,20,3,23,611883
chr1,40002143,1,14,0,14,611884
chr1,40002163,0.95,18,1,19,611885
chr1,40002207,1,39,0,39,611886
chr1,40002215,1,41,0,41,611887
chr1,40002274,1,46,0,46,611888
chr1,40002291,0.84,32,6,38,611889
chr1,40002546,0.9,93,10,103,611890
chr1,40002741,0.89,58,7,65,611891
chr1,40002937,0.92,55,5,60,611892
chr1,40002946,0.9,53,6,59,611893
chr1,40003264,0.91,53,5,58,611894
chr1,40003286,0.89,58,7,65,611895
chr1,40003339,0.97,69,2,71,611896
chr1,40003474,0.96,71,3,74,611897
chr1,40003496,0.95,76,4,80,611898
chr1,40003647,0.86,79,13,92,611899
chr1,40003655,0.96,93,4,97,611900
chr1,40003676,0.95,90,5,95,611901
chr1,40003745,0.94,83,5,88,611902
chr1,40003761,0.93,75,6,81,611903
chr1,40003783,0.93,52,4,56,611904
chr1,40003871,0.92,58,5,63,611905
chr1,40003879,0.96,68,3,71,611906
chr1,40003913,0.92,68,6,74,611907
chr1,40003970,0.99,78,1,79,611908
chr1,40003976,0.96,77,3,80,611909
chr1,40004016,0.95,75,4,79,611910
chr1,40004084,0.9,65,7,72,611911
chr1,40004131,0.95,58,3,61,611912
chr1,40004210,0.98,88,2,90,611913
chr1,40004434,0.99,71,1,72,611914
chr1,40004459,1,72,0,72,611915
chr1,40004528,0.94,74,5,79,611916
chr1,40004536,0.98,79,2,81,611917
chr1,40004543,1,82,0,82,611918
chr1,40004667,0.84,74,14,88,611919
chr1,40004756,0.7,71,30,101,611920
chr1,40004883,0.34,29,56,85,611921
chr1,40004980,0.04,3,77,80,611922
chr1,40005011,0.02,1,63,64,611923
chr1,40005014,0,0,62,62,611924
chr1,40005105,0,0,62,62,611925
chr1,40005168,0,0,46,46,611926
chr1,40005609,0.64,39,22,61,611927
chr1,40005848,0.93,71,5,76,611928
chr1,40005876,0.93,95,7,102,611929
chr1,40005902,0.85,108,19,127,611930
chr1,40006052,0.94,92,6,98,611931
chr1,40006272,0.88,70,10,80,611932
chr1,40006338,0.92,76,7,83,611933
chr1,40006355,0.81,71,17,88,611934
chr1,40006497,0.85,76,13,89,611935
chr1,40006511,0.61,57,36,93,611936
chr1,40006523,0.89,76,9,85,611937
chr1,40006559,0.92,99,9,108,611938
chr1,40006562,0.76,84,26,110,611939
chr1,40006565,0.88,98,14,112,611940
chr1,40006567,0.87,99,15,114,611941
chr1,40006618,0.84,75,14,89,611942
chr1,40006639,0.79,69,18,87,611943
chr1,40006671,0.63,54,32,86,611944
chr1,40006869,0.89,66,8,74,611945
chr1,40006978,0.98,83,2,85,611946
chr1,40007000,0.84,73,14,87,611947
chr1,40007074,0.73,58,21,79,611948
chr1,40007191,0.55,43,35,78,611949
chr1,40007252,0.75,67,22,89,611950
chr1,40007274,0.87,84,13,97,611951
chr1,40007288,0.93,91,7,98,611952
chr1,40007312,0.8,92,23,115,611953
chr1,40007404,0.82,81,18,99,611954
chr1,40007451,0.94,81,5,86,611955
chr1,40007476,0.86,64,10,74,611956
chr1,40007633,0.71,46,19,65,611957
chr1,40007703,0.96,49,2,51,611958
chr1,40007951,0.92,76,7,83,611959
chr1,40007967,0.8,67,17,84,611960
chr1,40008087,0.86,44,7,51,611961
chr1,40008131,0.95,61,3,64,611962
chr1,40008139,0.89,59,7,66,611963
chr1,40008169,0.98,64,1,65,611964
chr1,40008262,0.86,70,11,81,611965
chr1,40008297,0.86,65,11,76,611966
chr1,40008329,0.96,69,3,72,611967
chr1,40008336,0.98,61,1,62,611968
chr1,40008400,0.86,18,3,21,611969
chr1,40008534,0.66,35,18,53,611970
chr1,40008685,1,54,0,54,611971
chr1,40008841,1,49,0,49,611972
chr1,40008844,0.87,39,6,45,611973
chr1,40008868,0.98,39,1,40,611974
chr1,40008988,0.98,42,1,43,611975
chr1,40009008,0.93,43,3,46,611976
chr1,40009040,0.91,51,5,56,611977
chr1,40009047,0.96,53,2,55,611978
chr1,40009237,0.68,67,32,99,611979
chr1,40009464,0.96,46,2,48,611980
chr1,40009468,0.96,45,2,47,611981
chr1,40009502,1,45,0,45,611982
chr1,40009599,0.95,52,3,55,611983
chr1,40009637,0.97,30,1,31,611984
chr1,40009642,0.94,32,2,34,611985
chr1,40009667,0.96,26,1,27,611986
chr1,40009698,0.95,39,2,41,611987
chr1,40009732,1,67,0,67,611988
chr1,40009788,0.97,58,2,60,611989
chr1,40009803,1,43,0,43,611990
chr1,40009866,1,6,0,6,611991
chr1,40010039,0.92,46,4,50,611992
chr1,40010053,0.89,42,5,47,611993
chr1,40010206,0.46,56,65,121,611994
chr1,40010373,0.88,112,15,127,611995
chr1,40010630,0.79,84,22,106,611996
chr1,40010658,0.92,90,8,98,611997
chr1,40010921,0.99,74,1,75,611998
chr1,40010932,0.85,67,12,79,611999
chr1,40011299,0.95,81,4,85,612000
chr1,40011379,0.91,74,7,81,612001
chr1,40011398,0.97,91,3,94,612002
chr1,40011420,0.92,93,8,101,612003
chr1,40011423,0.89,93,11,104,612004
chr1,40011426,0.99,102,1,103,612005
chr1,40011431,0.94,101,6,107,612006
chr1,40011457,0.97,104,3,107,612007
chr1,40011582,0.98,56,1,57,612008
chr1,40011689,1,38,0,38,612009
chr1,40011693,0.97,37,1,38,612010
chr1,40011720,0.98,41,1,42,612011
chr1,40011815,0.97,72,2,74,612012
chr1,40011831,0.97,65,2,67,612013
chr1,40011909,0.93,86,6,92,612014
chr1,40011987,0.84,63,12,75,612015
chr1,40012205,0.95,63,3,66,612016
chr1,40012207,0.99,68,1,69,612017
chr1,40012230,0.95,61,3,64,612018
chr1,40012291,0.93,94,7,101,612019
chr1,40012305,0.96,101,4,105,612020
chr1,40012345,0.83,86,17,103,612021
chr1,40012363,0.97,100,3,103,612022
chr1,40012377,0.98,101,2,103,612023
chr1,40012388,0.96,99,4,103,612024
chr1,40012421,0.99,99,1,100,612025
chr1,40012433,0.88,88,12,100,612026
chr1,40012437,0.91,91,9,100,612027
chr1,40012629,0.96,90,4,94,612028
chr1,40012975,0.96,75,3,78,612029
chr1,40013305,0.97,76,2,78,612030
chr1,40013724,0.53,62,56,118,612031
chr1,40013985,0.9,98,11,109,612032
chr1,40014000,0.94,105,7,112,612033
chr1,40014315,1,48,0,48,612034
chr1,40014365,1,67,0,67,612035
chr1,40014643,0.88,105,14,119,612036
chr1,40014715,0.93,136,11,147,612037
chr1,40014911,0.55,47,39,86,612038
chr1,40014953,0.94,73,5,78,612039
chr1,40015101,0.98,78,2,80,612040
chr1,40015172,0.93,57,4,61,612041
chr1,40015353,0.94,45,3,48,612042
chr1,40015917,0.9,101,11,112,612043
chr1,40015979,0.45,49,59,108,612044
chr1,40016492,0.94,97,6,103,612045
chr1,40016851,0.96,78,3,81,612046
chr1,40016882,0.94,72,5,77,612047
chr1,40016926,0.95,80,4,84,612048
chr1,40016994,0.92,58,5,63,612049
chr1,40017002,0.98,54,1,55,612050
chr1,40017404,0.96,85,4,89,612051
chr1,40017428,0.9,75,8,83,612052
chr1,40017449,0.96,75,3,78,612053
chr1,40017551,0.99,86,1,87,612054
chr1,40017635,0.98,82,2,84,612055
chr1,40017939,0.99,85,1,86,612056
chr1,40017988,0.94,84,5,89,612057
chr1,40018053,0.91,82,8,90,612058
chr1,40018109,0.96,89,4,93,612059
chr1,40018115,0.95,89,5,94,612060
chr1,40018146,0.99,101,1,102,612061
chr1,40018252,0.85,97,17,114,612062
chr1,40018367,1,48,0,48,612063
chr1,40018421,0.92,44,4,48,612064
chr1,40018461,0.98,64,1,65,612065
chr1,40018509,0.93,75,6,81,612066
chr1,40018557,1,78,0,78,612067
chr1,40018658,0.94,48,3,51,612068
chr1,40019055,0.84,49,9,58,612069
chr1,40019120,0.96,54,2,56,612070
chr1,40019206,0.94,75,5,80,612071
chr1,40019240,0.8,71,18,89,612072
chr1,40019358,0.84,51,10,61,612073
chr1,40020114,0.96,77,3,80,612074
chr1,40020182,0.64,67,38,105,612075
chr1,40020415,0.87,91,14,105,612076
chr1,40020440,0.83,79,16,95,612077
chr1,40020457,0.97,95,3,98,612078
chr1,40020493,0.93,83,6,89,612079
chr1,40020728,0.96,85,4,89,612080
chr1,40020930,0.89,51,6,57,612081
chr1,40020982,0.69,50,22,72,612082
chr1,40021014,0.96,69,3,72,612083
chr1,40021070,0.94,59,4,63,612084
chr1,40021076,1,51,0,51,612085
chr1,40021078,0.92,44,4,48,612086
chr1,40021116,0.79,30,8,38,612087
chr1,40021306,0.94,66,4,70,612088
chr1,40021342,0.99,71,1,72,612089
chr1,40021391,0.97,74,2,76,612090
chr1,40021398,0.91,68,7,75,612091
chr1,40021491,0.89,65,8,73,612092
chr1,40021524,0.91,71,7,78,612093
chr1,40021566,0.95,81,4,85,612094
chr1,40021672,0.92,77,7,84,612095
chr1,40021849,0.91,68,7,75,612096
chr1,40021935,0.96,73,3,76,612097
chr1,40021974,0.95,70,4,74,612098
chr1,40022028,0.79,45,12,57,612099
chr1,40022092,0.75,12,4,16,612100
chr1,40022131,1,28,0,28,612101
chr1,40022148,0.95,36,2,38,612102
chr1,40022154,0.97,37,1,38,612103
chr1,40022156,0.95,38,2,40,612104
chr1,40022259,0.97,91,3,94,612105
chr1,40022271,0.94,93,6,99,612106
chr1,40022350,0.89,74,9,83,612107
chr1,40022406,0.69,24,11,35,612108
chr1,40022482,0.98,42,1,43,612109
chr1,40022489,0.91,43,4,47,612110
chr1,40022534,0.81,39,9,48,612111
chr1,40022622,0.94,85,5,90,612112
chr1,40022662,0.92,61,5,66,612113
chr1,40022963,1,70,0,70,612114
chr1,40022979,0.9,73,8,81,612115
chr1,40023039,0.67,62,30,92,612116
chr1,40023067,1,58,0,58,612117
chr1,40023069,0.96,54,2,56,612118
chr1,40023079,0.92,49,4,53,612119
chr1,40023112,0.97,60,2,62,612120
chr1,40023116,0.98,46,1,47,612121
chr1,40023123,0.96,50,2,52,612122
chr1,40023137,0.95,63,3,66,612123
chr1,40023159,0.92,87,8,95,612124
chr1,40023170,0.94,87,6,93,612125
chr1,40023199,0.96,90,4,94,612126
chr1,40023203,0.96,86,4,90,612127
chr1,40023235,0.88,51,7,58,612128
chr1,40023259,0.88,22,3,25,612129
chr1,40023267,0.91,21,2,23,612130
chr1,40023274,0.95,19,1,20,612131
chr1,40023297,0.86,6,1,7,612132
chr1,40023299,0.88,7,1,8,612133
chr1,40023409,0.97,62,2,64,612134
chr1,40023447,0.98,45,1,46,612135
chr1,40023449,0.98,44,1,45,612136
chr1,40023455,0.93,41,3,44,612137
chr1,40023472,0.98,49,1,50,612138
chr1,40023479,0.96,52,2,54,612139
chr1,40023487,0.96,50,2,52,612140
chr1,40023511,0.96,65,3,68,612141
chr1,40023543,0.99,73,1,74,612142
chr1,40023547,0.96,71,3,74,612143
chr1,40023587,1,54,0,54,612144
chr1,40023607,0.98,43,1,44,612145
chr1,40023621,0.91,32,3,35,612146
chr1,40023628,1,32,0,32,612147
chr1,40023632,0.98,39,1,40,612148
chr1,40023665,1,40,0,40,612149
chr1,40023675,0.98,45,1,46,612150
chr1,40023677,1,48,0,48,612151
chr1,40023809,0.81,21,5,26,612152
chr1,40023847,0.89,39,5,44,612153
chr1,40023849,0.77,36,11,47,612154
chr1,40023872,0.98,43,1,44,612155
chr1,40023879,1,42,0,42,612156
chr1,40023931,1,5,0,5,612157
chr1,40023935,0.89,16,2,18,612158
chr1,40023943,0.95,18,1,19,612159
chr1,40023947,0.94,17,1,18,612160
chr1,40023976,1,17,0,17,612161
chr1,40024007,0.73,11,4,15,612162
chr1,40024021,1,11,0,11,612163
chr1,40024032,1,24,0,24,612164
chr1,40024037,0.9,28,3,31,612165
chr1,40024055,0.91,39,4,43,612166
chr1,40024075,0.96,52,2,54,612167
chr1,40024077,0.96,54,2,56,612168
chr1,40024612,0.72,56,22,78,612169
chr1,40024656,0.61,65,42,107,612170
chr1,40024708,0.59,63,43,106,612171
chr1,40024775,0.59,46,32,78,612172
chr1,40024871,0.48,53,57,110,612173
chr1,40024893,0.49,59,62,121,612174
chr1,40024902,0.52,58,53,111,612175
chr1,40024933,0.46,54,64,118,612176
chr1,40024948,0.5,59,60,119,612177
chr1,40024971,0.39,46,73,119,612178
chr1,40024990,0.5,57,58,115,612179
chr1,40025055,0.52,49,45,94,612180
chr1,40025059,0.47,44,50,94,612181
chr1,40025073,0.56,43,34,77,612182
chr1,40025078,0.53,42,38,80,612183
chr1,40025089,0.51,35,34,69,612184
chr1,40025170,0.39,12,19,31,612185
chr1,40025176,0.44,11,14,25,612186
chr1,40025209,0.37,10,17,27,612187
chr1,40025225,0.55,11,9,20,612188
chr1,40025232,0.64,16,9,25,612189
chr1,40025274,0.51,22,21,43,612190
chr1,40025322,0.52,27,25,52,612191
chr1,40025325,0.57,26,20,46,612192
chr1,40025329,0.64,30,17,47,612193
chr1,40025346,0.58,28,20,48,612194
chr1,40025352,0.54,27,23,50,612195
chr1,40025355,0.5,26,26,52,612196
chr1,40025363,0.56,25,20,45,612197
chr1,40025368,0.5,24,24,48,612198
chr1,40025384,0.62,33,20,53,612199
chr1,40025411,0.57,26,20,46,612200
chr1,40025415,0.54,29,25,54,612201
chr1,40025483,0.5,1,1,2,612202
chr1,40025521,0.73,16,6,22,612203
chr1,40025523,0.72,18,7,25,612204
chr1,40025546,0.93,39,3,42,612205
chr1,40025561,0.77,43,13,56,612206
chr1,40025609,0.96,72,3,75,612207
chr1,40025617,0.93,64,5,69,612208
chr1,40025621,0.94,64,4,68,612209
chr1,40025652,0.79,37,10,47,612210
chr1,40025663,0.92,45,4,49,612211
chr1,40025683,1,38,0,38,612212
chr1,40025704,0.96,43,2,45,612213
chr1,40025708,0.97,60,2,62,612214
chr1,40025713,0.94,63,4,67,612215
chr1,40025741,0.98,91,2,93,612216
chr1,40025761,0.87,88,13,101,612217
chr1,40025882,0.96,52,2,54,612218
chr1,40026062,0.96,78,3,81,612219
chr1,40026070,0.92,76,7,83,612220
chr1,40026125,0.85,51,9,60,612221
chr1,40026145,0.87,54,8,62,612222
chr1,40026183,0.88,63,9,72,612223
chr1,40026202,1,71,0,71,612224
chr1,40026447,0.79,77,20,97,612225
chr1,40026520,0.77,43,13,56,612226
chr1,40026632,0.86,99,16,115,612227
chr1,40027224,0.86,106,17,123,612228
chr1,40027356,0.68,88,41,129,612229
chr1,40027393,0.97,107,3,110,612230
chr1,40027463,1,76,0,76,612231
chr1,40027630,0.95,82,4,86,612232
chr1,40027752,0.95,115,6,121,612233
chr1,40027762,0.9,107,12,119,612234
chr1,40027817,0.85,80,14,94,612235
chr1,40027869,0.88,58,8,66,612236
chr1,40028074,0.89,66,8,74,612237
chr1,40028323,0.94,59,4,63,612238
chr1,40028333,0.8,56,14,70,612239
chr1,40028593,0.82,84,18,102,612240
chr1,40028607,0.83,84,17,101,612241
chr1,40028904,0.67,75,37,112,612242
chr1,40028987,0.96,110,5,115,612243
chr1,40029032,0.79,64,17,81,612244
chr1,40029063,0.81,65,15,80,612245
chr1,40029170,0.95,99,5,104,612246
chr1,40029317,0.98,80,2,82,612247
chr1,40029330,1,74,0,74,612248
chr1,40029353,0.89,56,7,63,612249
chr1,40029378,1,50,0,50,612250
chr1,40029380,0.98,49,1,50,612251
chr1,40029385,1,49,0,49,612252
chr1,40029411,0.86,42,7,49,612253
chr1,40029464,0.9,53,6,59,612254
chr1,40029544,0.98,53,1,54,612255
chr1,40029576,0.85,68,12,80,612256
chr1,40029581,0.8,66,16,82,612257
chr1,40029629,0.94,84,5,89,612258
chr1,40029650,0.83,78,16,94,612259
chr1,40029657,0.91,86,8,94,612260
chr1,40029679,0.71,72,29,101,612261
chr1,40029685,0.96,94,4,98,612262
chr1,40029719,0.87,86,13,99,612263
chr1,40029887,0.95,105,5,110,612264
chr1,40029995,0.93,84,6,90,612265
chr1,40030004,0.94,75,5,80,612266
chr1,40030095,0.76,53,17,70,612267
chr1,40030124,0.66,57,29,86,612268
chr1,40030132,0.82,75,16,91,612269
chr1,40030160,0.96,105,4,109,612270
chr1,40030172,0.83,85,17,102,612271
chr1,40030187,0.39,37,58,95,612272
chr1,40030384,0.86,32,5,37,612273
chr1,40030697,0.89,64,8,72,612274
chr1,40030738,0.86,65,11,76,612275
chr1,40030808,0.87,92,14,106,612276
chr1,40030869,0.64,65,37,102,612277
chr1,40030956,0.94,64,4,68,612278
chr1,40031011,0.86,87,14,101,612279
chr1,40031227,0.92,61,5,66,612280
chr1,40031267,0.94,61,4,65,612281
chr1,40031283,0.9,61,7,68,612282
chr1,40031328,0.81,58,14,72,612283
chr1,40031360,0.9,70,8,78,612284
chr1,40031414,0.96,78,3,81,612285
chr1,40031424,0.88,74,10,84,612286
chr1,40031448,0.93,70,5,75,612287
chr1,40031454,0.97,70,2,72,612288
chr1,40031456,0.94,66,4,70,612289
chr1,40031478,0.91,70,7,77,612290
chr1,40031486,0.94,78,5,83,612291
chr1,40031846,0.92,67,6,73,612292
chr1,40031917,0.75,77,25,102,612293
chr1,40031948,0.62,75,46,121,612294
chr1,40031975,0.75,89,30,119,612295
chr1,40032516,0,0,46,46,612296
chr1,40032659,0.34,27,52,79,612297
chr1,40032722,0.69,42,19,61,612298
chr1,40032725,0.6,75,49,124,612299
chr1,40032735,0.64,51,29,80,612300
chr1,40032938,0.98,89,2,91,612301
chr1,40033143,0.89,93,11,104,612302
chr1,40033148,0.7,74,31,105,612303
chr1,40033305,0.51,35,33,68,612304
chr1,40033410,0.97,88,3,91,612305
chr1,40033647,0.9,74,8,82,612306
chr1,40033651,0.92,72,6,78,612307
chr1,40033655,0.89,65,8,73,612308
chr1,40033657,0.96,66,3,69,612309
chr1,40033667,0.95,54,3,57,612310
chr1,40033695,0.97,28,1,29,612311
chr1,40033700,0.96,25,1,26,612312
chr1,40033704,0.94,16,1,17,612313
chr1,40033725,1,6,0,6,612314
chr1,40033756,0.8,4,1,5,612315
chr1,40033797,0.96,26,1,27,612316
chr1,40033847,0.95,59,3,62,612317
chr1,40033853,0.95,57,3,60,612318
chr1,40033860,1,61,0,61,612319
chr1,40033877,0.95,52,3,55,612320
chr1,40033907,0.92,33,3,36,612321
chr1,40033915,1,31,0,31,612322
chr1,40034401,0.93,68,5,73,612323
chr1,40034481,0.93,100,7,107,612324
chr1,40034517,0.89,105,13,118,612325
chr1,40034535,0.86,106,17,123,612326
chr1,40034556,0.87,99,15,114,612327
chr1,40034650,0.94,76,5,81,612328
chr1,40034862,0.92,100,9,109,612329
chr1,40034875,0.92,98,8,106,612330
chr1,40034966,0.6,52,34,86,612331
chr1,40035028,0.41,31,45,76,612332
chr1,40035114,0.9,71,8,79,612333
chr1,40035176,0.97,83,3,86,612334
chr1,40035281,0.89,87,11,98,612335
chr1,40035290,0.94,94,6,100,612336
chr1,40035642,1,99,0,99,612337
chr1,40035651,0.96,97,4,101,612338
chr1,40035779,0.82,54,12,66,612339
chr1,40036461,0.88,86,12,98,612340
chr1,40036463,0.92,90,8,98,612341
chr1,40036490,0.95,87,5,92,612342
chr1,40036584,0.99,90,1,91,612343
chr1,40036599,0.95,83,4,87,612344
chr1,40036688,0.94,82,5,87,612345
chr1,40036728,0.83,74,15,89,612346
chr1,40036747,0.78,65,18,83,612347
chr1,40036810,0.92,54,5,59,612348
chr1,40036824,0.98,59,1,60,612349
chr1,40036848,0.92,54,5,59,612350
chr1,40036861,0.74,48,17,65,612351
chr1,40036874,0.94,59,4,63,612352
chr1,40036889,0.91,64,6,70,612353
chr1,40036912,1,67,0,67,612354
chr1,40036943,0.94,72,5,77,612355
chr1,40036955,0.96,71,3,74,612356
chr1,40036973,0.92,72,6,78,612357
chr1,40037003,0.95,82,4,86,612358
chr1,40037037,0.98,83,2,85,612359
chr1,40037340,0.93,82,6,88,612360
chr1,40037354,0.93,78,6,84,612361
chr1,40037415,0.83,50,10,60,612362
chr1,40037477,0.93,53,4,57,612363
chr1,40037593,0.75,89,29,118,612364
chr1,40037674,0.83,85,17,102,612365
chr1,40037710,0.94,72,5,77,612366
chr1,40037813,0.61,50,32,82,612367
chr1,40037881,0.92,81,7,88,612368
chr1,40037894,0.95,88,5,93,612369
chr1,40038151,0.16,14,74,88,612370
chr1,40038204,0.71,61,25,86,612371
chr1,40038252,0.92,57,5,62,612372
chr1,40038296,0.59,57,40,97,612373
chr1,40038717,0.65,55,30,85,612374
chr1,40039030,0.95,102,5,107,612375
chr1,40039170,0.37,37,64,101,612376
chr1,40039261,0.76,73,23,96,612377
chr1,40039288,0.9,75,8,83,612378
chr1,40039359,0.85,63,11,74,612379
chr1,40039445,0.81,54,13,67,612380
chr1,40039447,0.73,45,17,62,612381
chr1,40039569,0.74,67,24,91,612382
chr1,40039631,0.3,30,70,100,612383
chr1,40039752,0.49,44,46,90,612384
chr1,40039781,0.31,26,59,85,612385
chr1,40039889,0.45,26,32,58,612386
chr1,40039962,0.25,18,53,71,612387
chr1,40040016,0.03,2,69,71,612388
chr1,40040050,0.1,7,61,68,612389
chr1,40040160,0,0,88,88,612390
chr1,40040244,0.54,54,46,100,612391
chr1,40040342,0.5,50,50,100,612392
chr1,40040489,0.03,2,68,70,612393
chr1,40040532,0.13,8,52,60,612394
chr1,40040562,0.07,6,80,86,612395
chr1,40040748,0.21,18,67,85,612396
chr1,40040769,0.04,4,99,103,612397
chr1,40040868,0.02,2,86,88,612398
chr1,40040900,0.15,15,87,102,612399
chr1,40040911,0.01,1,92,93,612400
chr1,40040998,0.16,9,49,58,612401
chr1,40041003,0.09,5,49,54,612402
chr1,40041032,0.06,4,60,64,612403
chr1,40041034,0.03,2,59,61,612404
chr1,40041053,0,0,53,53,612405
chr1,40041058,0.07,3,39,42,612406
chr1,40041131,0,0,69,69,612407
chr1,40041263,0,0,97,97,612408
chr1,40041284,0.01,1,100,101,612409
chr1,40041286,0,0,109,109,612410
chr1,40041299,0.01,1,94,95,612411
chr1,40041318,0.02,2,100,102,612412
chr1,40041335,0.01,1,92,93,612413
chr1,40041343,0,0,43,43,612414
chr1,40041352,0,0,80,80,612415
chr1,40041376,0,0,78,78,612416
chr1,40041383,0,0,82,82,612417
chr1,40041393,0,0,78,78,612418
chr1,40041403,0,0,77,77,612419
chr1,40041407,0.01,1,77,78,612420
chr1,40041431,0,0,75,75,612421
chr1,40041434,0,0,77,77,612422
chr1,40041438,0,0,78,78,612423
chr1,40041455,0,0,83,83,612424
chr1,40041475,0,0,63,63,612425
chr1,40041478,0,0,64,64,612426
chr1,40041491,0,0,73,73,612427
chr1,40041493,0,0,69,69,612428
chr1,40041502,0,0,67,67,612429
chr1,40041522,0,0,55,55,612430
chr1,40041524,0,0,57,57,612431
chr1,40041539,0,0,50,50,612432
chr1,40041554,0,0,37,37,612433
chr1,40041560,0,0,34,34,612434
chr1,40041564,0,0,34,34,612435
chr1,40041575,0,0,23,23,612436
chr1,40041581,0,0,31,31,612437
chr1,40041612,0,0,28,28,612438
chr1,40041617,0,0,33,33,612439
chr1,40041629,0,0,16,16,612440
chr1,40041644,0.21,7,27,34,612441
chr1,40041651,0,0,31,31,612442
chr1,40041670,0,0,34,34,612443
chr1,40041676,0,0,32,32,612444
chr1,40041679,0,0,36,36,612445
chr1,40041694,0.04,1,23,24,612446
chr1,40041700,0.02,1,45,46,612447
chr1,40041707,0,0,54,54,612448
chr1,40041713,0,0,52,52,612449
chr1,40041715,0.02,1,48,49,612450
chr1,40041718,0.02,1,53,54,612451
chr1,40041720,0.02,1,53,54,612452
chr1,40041737,0.03,2,59,61,612453
chr1,40041740,0,0,52,52,612454
chr1,40041742,0,0,57,57,612455
chr1,40041745,0,0,49,49,612456
chr1,40041751,0,0,58,58,612457
chr1,40041762,0,0,63,63,612458
chr1,40041765,0,0,46,46,612459
chr1,40041777,0,0,58,58,612460
chr1,40041782,0,0,61,61,612461
chr1,40041788,0,0,62,62,612462
chr1,40041795,0,0,34,34,612463
chr1,40041802,0,0,45,45,612464
chr1,40041811,0,0,56,56,612465
chr1,40041815,0,0,55,55,612466
chr1,40041823,0,0,61,61,612467
chr1,40041841,0.03,2,60,62,612468
chr1,40041850,0,0,65,65,612469
chr1,40041860,0,0,70,70,612470
chr1,40041862,0,0,68,68,612471
chr1,40041878,0,0,82,82,612472
chr1,40041880,0.02,2,79,81,612473
chr1,40041891,0,0,78,78,612474
chr1,40041935,0.01,1,100,101,612475
chr1,40041950,0,0,103,103,612476
chr1,40041975,0,0,73,73,612477
chr1,40041979,0.01,1,98,99,612478
chr1,40041983,0,0,85,85,612479
chr1,40041992,0,0,94,94,612480
chr1,40041995,0.02,2,81,83,612481
chr1,40042001,0.01,1,88,89,612482
chr1,40042009,0,0,86,86,612483
chr1,40042011,0.01,1,85,86,612484
chr1,40042034,0,0,79,79,612485
chr1,40042041,0,0,77,77,612486
chr1,40042044,0,0,61,61,612487
chr1,40042061,0,0,53,53,612488
chr1,40042064,0,0,71,71,612489
chr1,40042094,0,0,29,29,612490
chr1,40042097,0.04,2,54,56,612491
chr1,40042102,0,0,56,56,612492
chr1,40042105,0,0,44,44,612493
chr1,40042112,0,0,53,53,612494
chr1,40042116,0.03,1,36,37,612495
chr1,40042120,0,0,30,30,612496
chr1,40042123,0,0,36,36,612497
chr1,40042148,0,0,29,29,612498
chr1,40042151,0,0,42,42,612499
chr1,40042160,0.14,2,12,14,612500
chr1,40042162,0,0,24,24,612501
chr1,40042167,0.14,1,6,7,612502
chr1,40042169,0.06,1,15,16,612503
chr1,40042183,0,0,25,25,612504
chr1,40042203,0,0,20,20,612505
chr1,40042208,0,0,24,24,612506
chr1,40042212,0,0,14,14,612507
chr1,40042227,0,0,30,30,612508
chr1,40042235,0,0,32,32,612509
chr1,40042239,0,0,34,34,612510
chr1,40042246,0,0,37,37,612511
chr1,40042249,0,0,39,39,612512
chr1,40042253,0.03,1,28,29,612513
chr1,40042265,0.05,2,38,40,612514
chr1,40042268,0,0,33,33,612515
chr1,40042271,0,0,22,22,612516
chr1,40042275,0,0,24,24,612517
chr1,40042277,0,0,29,29,612518
chr1,40042293,0,0,35,35,612519
chr1,40042297,0.02,1,44,45,612520
chr1,40042312,0,0,48,48,612521
chr1,40042314,0,0,49,49,612522
chr1,40042323,0,0,54,54,612523
chr1,40042331,0,0,50,50,612524
chr1,40042370,0,0,46,46,612525
chr1,40042416,0,0,60,60,612526
chr1,40042423,0,0,50,50,612527
chr1,40042432,0,0,66,66,612528
chr1,40042438,0.03,1,39,40,612529
chr1,40042444,0,0,65,65,612530
chr1,40042449,0,0,73,73,612531
chr1,40042454,0,0,39,39,612532
chr1,40042464,0,0,72,72,612533
chr1,40042468,0,0,78,78,612534
chr1,40042480,0,0,46,46,612535
chr1,40042495,0,0,60,60,612536
chr1,40042499,0,0,33,33,612537
chr1,40042504,0,0,63,63,612538
chr1,40042508,0,0,71,71,612539
chr1,40042518,0,0,73,73,612540
chr1,40042525,0,0,37,37,612541
chr1,40042530,0,0,49,49,612542
chr1,40042541,0,0,42,42,612543
chr1,40042547,0.02,1,49,50,612544
chr1,40042553,0.03,1,34,35,612545
chr1,40042561,0,0,46,46,612546
chr1,40042566,0,0,48,48,612547
chr1,40042574,0,0,43,43,612548
chr1,40042579,0,0,35,35,612549
chr1,40042584,0,0,28,28,612550
chr1,40042590,0,0,35,35,612551
chr1,40042592,0,0,35,35,612552
chr1,40042598,0,0,30,30,612553
chr1,40042603,0,0,36,36,612554
chr1,40042606,0,0,28,28,612555
chr1,40042608,0,0,27,27,612556
chr1,40042612,0,0,32,32,612557
chr1,40042614,0,0,29,29,612558
chr1,40042616,0,0,32,32,612559
chr1,40042619,0,0,26,26,612560
chr1,40042627,0,0,26,26,612561
chr1,40042637,0,0,20,20,612562
chr1,40042640,0,0,32,32,612563
chr1,40042649,0,0,24,24,612564
chr1,40042658,0,0,38,38,612565
chr1,40042660,0,0,41,41,612566
chr1,40042666,0,0,42,42,612567
chr1,40042727,0,0,60,60,612568
chr1,40042764,0.01,1,66,67,612569
chr1,40042812,0.36,21,37,58,612570
chr1,40042840,0.77,47,14,61,612571
chr1,40042845,0.93,57,4,61,612572
chr1,40042871,0.58,35,25,60,612573
chr1,40042889,0.46,25,29,54,612574
chr1,40042891,0.67,38,19,57,612575
chr1,40042902,0.27,16,43,59,612576
chr1,40042931,0.56,35,27,62,612577
chr1,40042935,0.54,33,28,61,612578
chr1,40042947,0.67,43,21,64,612579
chr1,40042967,0.44,31,40,71,612580
chr1,40042998,0.78,51,14,65,612581
chr1,40043005,0.98,57,1,58,612582
chr1,40043012,0.71,40,16,56,612583
chr1,40043014,0.97,58,2,60,612584
chr1,40043028,0.92,59,5,64,612585
chr1,40043216,0.98,90,2,92,612586
chr1,40043236,0.84,81,15,96,612587
chr1,40043365,0.76,71,22,93,612588
chr1,40043493,0.89,73,9,82,612589
chr1,40043509,0.88,66,9,75,612590
chr1,40043521,0.98,59,1,60,612591
chr1,40043549,0.85,44,8,52,612592
chr1,40043554,0.96,43,2,45,612593
chr1,40043572,0.84,38,7,45,612594
chr1,40043580,0.85,40,7,47,612595
chr1,40043612,0.82,46,10,56,612596
chr1,40043680,1,79,0,79,612597
chr1,40043698,1,87,0,87,612598
chr1,40043708,0.93,80,6,86,612599
chr1,40043771,0.93,52,4,56,612600
chr1,40043779,0.84,42,8,50,612601
chr1,40043840,0.94,60,4,64,612602
chr1,40044152,0.9,66,7,73,612603
chr1,40044199,0.97,72,2,74,612604
chr1,40044222,0.92,54,5,59,612605
chr1,40044280,0.79,42,11,53,612606
chr1,40044294,0.67,42,21,63,612607
chr1,40044338,0.95,79,4,83,612608
chr1,40044358,0.97,76,2,78,612609
chr1,40044410,0.82,36,8,44,612610
chr1,40044512,0.93,96,7,103,612611
chr1,40044684,0.92,77,7,84,612612
chr1,40044713,0.99,79,1,80,612613
chr1,40044765,0.88,73,10,83,612614
chr1,40044906,0.97,58,2,60,612615
chr1,40044951,0.56,40,31,71,612616
chr1,40045115,0.59,10,7,17,612617
chr1,40045222,0.95,41,2,43,612618
chr1,40045263,0.93,62,5,67,612619
chr1,40045294,0.98,82,2,84,612620
chr1,40045317,1,86,0,86,612621
chr1,40045324,0.88,70,10,80,612622
chr1,40045356,0.82,46,10,56,612623
chr1,40045378,1,34,0,34,612624
chr1,40045476,1,14,0,14,612625
chr1,40045481,1,16,0,16,612626
chr1,40045521,0.94,16,1,17,612627
chr1,40045595,0.97,38,1,39,612628
chr1,40045603,0.95,41,2,43,612629
chr1,40045617,1,52,0,52,612630
chr1,40045627,0.97,58,2,60,612631
chr1,40045755,0.88,56,8,64,612632
chr1,40045781,0.77,60,18,78,612633
chr1,40045786,0.95,73,4,77,612634
chr1,40045814,0.8,52,13,65,612635
chr1,40045880,0.44,27,35,62,612636
chr1,40045942,0.9,45,5,50,612637
chr1,40045950,0.91,42,4,46,612638
chr1,40045974,0.86,37,6,43,612639
chr1,40046006,0.98,46,1,47,612640
chr1,40046010,0.98,48,1,49,612641
chr1,40046085,0.87,39,6,45,612642
chr1,40046092,0.93,42,3,45,612643
chr1,40046242,0.97,113,3,116,612644
chr1,40046575,0.65,36,19,55,612645
chr1,40046599,0.75,45,15,60,612646
chr1,40046639,0.97,65,2,67,612647
chr1,40046688,0.96,65,3,68,612648
chr1,40046756,0.98,61,1,62,612649
chr1,40046779,0.95,56,3,59,612650
chr1,40046904,0.96,43,2,45,612651
chr1,40046908,1,48,0,48,612652
chr1,40046910,0.92,46,4,50,612653
chr1,40046920,0.98,49,1,50,612654
chr1,40046980,0.9,56,6,62,612655
chr1,40047042,0.85,69,12,81,612656
chr1,40047105,0.96,102,4,106,612657
chr1,40047122,0.99,85,1,86,612658
chr1,40047130,0.96,71,3,74,612659
chr1,40047138,0.96,65,3,68,612660
chr1,40047277,0.98,64,1,65,612661
chr1,40047289,0.94,72,5,77,612662
chr1,40047390,0.93,85,6,91,612663
chr1,40047417,0.77,76,23,99,612664
chr1,40047485,0.89,87,11,98,612665
chr1,40047539,0.74,48,17,65,612666
chr1,40047693,1,39,0,39,612667
chr1,40047755,0.81,29,7,36,612668
chr1,40047759,0.66,27,14,41,612669
chr1,40047777,0.88,44,6,50,612670
chr1,40047802,0.98,59,1,60,612671
chr1,40047809,0.87,62,9,71,612672
chr1,40047817,0.88,66,9,75,612673
chr1,40047841,0.71,53,22,75,612674
chr1,40047873,0.99,83,1,84,612675
chr1,40047877,0.96,82,3,85,612676
chr1,40047907,0.91,72,7,79,612677
chr1,40047952,0.95,61,3,64,612678
chr1,40047959,0.98,56,1,57,612679
chr1,40047963,1,71,0,71,612680
chr1,40047996,0.93,70,5,75,612681
chr1,40048008,0.96,74,3,77,612682
chr1,40048121,0.98,63,1,64,612683
chr1,40048209,1,47,0,47,612684
chr1,40048234,0.98,58,1,59,612685
chr1,40048252,0.98,60,1,61,612686
chr1,40048267,0.97,63,2,65,612687
chr1,40048347,0.96,89,4,93,612688
chr1,40048353,0.93,86,6,92,612689
chr1,40048396,0.99,97,1,98,612690
chr1,40048421,0.95,101,5,106,612691
chr1,40048452,0.94,106,7,113,612692
chr1,40048482,0.94,103,7,110,612693
chr1,40048514,0.88,94,13,107,612694
chr1,40048695,0.96,78,3,81,612695
chr1,40048810,0.85,61,11,72,612696
chr1,40048844,0.79,56,15,71,612697
chr1,40049256,0.67,16,8,24,612698
chr1,40049264,0.97,28,1,29,612699
chr1,40049281,0.96,46,2,48,612700
chr1,40049296,0.92,61,5,66,612701
chr1,40049302,0.94,68,4,72,612702
chr1,40049319,0.98,86,2,88,612703
chr1,40049378,0.65,82,44,126,612704
chr1,40049504,0.41,37,54,91,612705
chr1,40049655,0.56,27,21,48,612706
chr1,40049858,0.78,49,14,63,612707
chr1,40049898,0.95,58,3,61,612708
chr1,40049902,0.97,62,2,64,612709
chr1,40049910,1,57,0,57,612710
chr1,40049914,0.98,54,1,55,612711
chr1,40049933,0.75,50,17,67,612712
chr1,40049957,0.9,66,7,73,612713
chr1,40049965,0.96,73,3,76,612714
chr1,40049972,0.98,65,1,66,612715
chr1,40049989,0.95,58,3,61,612716
chr1,40049995,0.97,57,2,59,612717
chr1,40049997,1,57,0,57,612718
chr1,40050027,0.98,44,1,45,612719
chr1,40050068,0.76,16,5,21,612720
chr1,40050334,0.88,77,11,88,612721
chr1,40050495,0.84,80,15,95,612722
chr1,40050567,0.92,69,6,75,612723
chr1,40050654,0.98,61,1,62,612724
chr1,40050727,1,74,0,74,612725
chr1,40050735,0.99,76,1,77,612726
chr1,40050754,0.97,72,2,74,612727
chr1,40050789,0.93,55,4,59,612728
chr1,40050843,0.97,38,1,39,612729
chr1,40050845,1,39,0,39,612730
chr1,40050885,0.96,71,3,74,612731
chr1,40050906,0.95,87,5,92,612732
chr1,40050945,0.97,72,2,74,612733
chr1,40050973,0.97,58,2,60,612734
chr1,40050983,1,57,0,57,612735
chr1,40050985,0.98,58,1,59,612736
chr1,40051103,0.94,49,3,52,612737
chr1,40051201,0.97,70,2,72,612738
chr1,40051377,0.9,66,7,73,612739
chr1,40051666,0.96,65,3,68,612740
chr1,40051860,0.97,66,2,68,612741
chr1,40051866,1,66,0,66,612742
chr1,40051878,0.97,68,2,70,612743
chr1,40051904,0.99,80,1,81,612744
chr1,40051908,0.99,74,1,75,612745
chr1,40051962,0.93,50,4,54,612746
chr1,40052028,0.95,41,2,43,612747
chr1,40052036,0.98,44,1,45,612748
chr1,40052060,0.95,42,2,44,612749
chr1,40052092,0.86,18,3,21,612750
chr1,40052123,0.94,16,1,17,612751
chr1,40052259,0.92,78,7,85,612752
chr1,40052437,1,50,0,50,612753
chr1,40052445,0.97,57,2,59,612754
chr1,40052469,0.97,77,2,79,612755
chr1,40052479,0.97,73,2,75,612756
chr1,40052501,1,67,0,67,612757
chr1,40052537,0.93,56,4,60,612758
chr1,40052598,0.93,78,6,84,612759
chr1,40052625,0.99,93,1,94,612760
chr1,40052646,0.95,105,6,111,612761
chr1,40052674,0.98,99,2,101,612762
chr1,40052820,0.95,69,4,73,612763
chr1,40052825,0.93,62,5,67,612764
chr1,40052829,0.97,60,2,62,612765
chr1,40052831,0.97,61,2,63,612766
chr1,40052841,0.95,57,3,60,612767
chr1,40052874,1,50,0,50,612768
chr1,40052919,0.92,36,3,39,612769
chr1,40052930,0.95,37,2,39,612770
chr1,40052961,0.91,31,3,34,612771
chr1,40052977,1,22,0,22,612772
chr1,40053021,0.94,15,1,16,612773
chr1,40053061,0,0,20,20,612774
chr1,40053083,0.88,23,3,26,612775
chr1,40053091,1,27,0,27,612776
chr1,40053099,0.84,26,5,31,612777
chr1,40053160,0.85,40,7,47,612778
chr1,40053193,0.89,41,5,46,612779
chr1,40053199,0.73,38,14,52,612780
chr1,40053256,0.84,49,9,58,612781
chr1,40053535,0.95,78,4,82,612782
chr1,40053573,0.94,74,5,79,612783
chr1,40053590,0.96,79,3,82,612784
chr1,40053614,0.89,81,10,91,612785
chr1,40053661,1,94,0,94,612786
chr1,40053685,0.94,87,6,93,612787
chr1,40053702,1,76,0,76,612788
chr1,40053752,0.97,71,2,73,612789
chr1,40053757,0.9,62,7,69,612790
chr1,40053785,0.99,77,1,78,612791
chr1,40053797,0.96,82,3,85,612792
chr1,40053840,0.91,79,8,87,612793
chr1,40053878,0.84,64,12,76,612794
chr1,40053907,0.82,69,15,84,612795
chr1,40053918,0.87,77,12,89,612796
chr1,40054179,0.78,90,25,115,612797
chr1,40054222,0.62,71,44,115,612798
chr1,40054371,0.87,88,13,101,612799
chr1,40054437,0.95,58,3,61,612800
chr1,40054601,0.9,55,6,61,612801
chr1,40054633,0.85,40,7,47,612802
chr1,40054647,0.9,36,4,40,612803
chr1,40054654,0.92,24,2,26,612804
chr1,40054658,0.97,35,1,36,612805
chr1,40054663,0.92,33,3,36,612806
chr1,40054703,0.98,48,1,49,612807
chr1,40054788,0.99,69,1,70,612808
chr1,40054937,0.95,63,3,66,612809
chr1,40054942,0.99,66,1,67,612810
chr1,40055040,0.92,68,6,74,612811
chr1,40055044,0.99,66,1,67,612812
chr1,40055064,0.9,69,8,77,612813
chr1,40055103,1,68,0,68,612814
chr1,40055150,0.82,51,11,62,612815
chr1,40055201,0.65,42,23,65,612816
chr1,40055502,0.86,32,5,37,612817
chr1,40055625,0.95,52,3,55,612818
chr1,40055627,0.95,52,3,55,612819
chr1,40055637,0.94,46,3,49,612820
chr1,40055665,0.91,42,4,46,612821
chr1,40055681,0.88,49,7,56,612822
chr1,40055726,0.95,70,4,74,612823
chr1,40055754,0.96,75,3,78,612824
chr1,40055768,0.97,75,2,77,612825
chr1,40055790,1,67,0,67,612826
chr1,40055854,1,77,0,77,612827
chr1,40055875,0.95,72,4,76,612828
chr1,40055883,0.95,70,4,74,612829
chr1,40056115,0.82,75,17,92,612830
chr1,40056133,0.95,87,5,92,612831
chr1,40056231,0.99,93,1,94,612832
chr1,40056315,0.92,101,9,110,612833
chr1,40056329,0.95,101,5,106,612834
chr1,40056469,0.47,43,48,91,612835
chr1,40056472,0.92,84,7,91,612836
chr1,40056550,0.84,61,12,73,612837
chr1,40056563,0.72,49,19,68,612838
chr1,40056694,0.93,77,6,83,612839
chr1,40056718,0.99,79,1,80,612840
chr1,40057019,0.74,29,10,39,612841
chr1,40057095,0.78,63,18,81,612842
chr1,40057269,0.83,59,12,71,612843
chr1,40057398,0.86,86,14,100,612844
chr1,40057436,0.99,93,1,94,612845
chr1,40057452,0.93,85,6,91,612846
chr1,40057466,0.98,87,2,89,612847
chr1,40057486,0.96,82,3,85,612848
chr1,40057497,0.93,80,6,86,612849
chr1,40057526,0.89,71,9,80,612850
chr1,40057588,0.93,43,3,46,612851
chr1,40057594,0.98,40,1,41,612852
chr1,40057618,0.97,29,1,30,612853
chr1,40057626,0.96,25,1,26,612854
chr1,40057656,0.95,20,1,21,612855
chr1,40057821,0.98,59,1,60,612856
chr1,40057982,0.93,62,5,67,612857
chr1,40058005,0.95,75,4,79,612858
chr1,40058051,0.93,75,6,81,612859
chr1,40058170,0.97,68,2,70,612860
chr1,40058406,0.98,93,2,95,612861
chr1,40058421,0.95,92,5,97,612862
chr1,40058911,0.88,29,4,33,612863
chr1,40058945,0.97,31,1,32,612864
chr1,40058967,0.88,29,4,33,612865
chr1,40058999,0.93,54,4,58,612866
chr1,40059121,0.99,66,1,67,612867
chr1,40059131,0.94,66,4,70,612868
chr1,40059133,1,73,0,73,612869
chr1,40059386,0.98,101,2,103,612870
chr1,40059464,0.97,71,2,73,612871
chr1,40059474,0.96,64,3,67,612872
chr1,40059642,0.96,54,2,56,612873
chr1,40059673,0.99,75,1,76,612874
chr1,40059680,0.84,71,14,85,612875
chr1,40059732,0.97,63,2,65,612876
chr1,40059744,0.84,59,11,70,612877
chr1,40059784,0.98,53,1,54,612878
chr1,40059834,0.88,37,5,42,612879
chr1,40059861,0.98,41,1,42,612880
chr1,40060035,0.89,83,10,93,612881
chr1,40060075,0.65,53,29,82,612882
chr1,40060178,0.97,90,3,93,612883
chr1,40060259,0.92,76,7,83,612884
chr1,40060521,0.88,59,8,67,612885
chr1,40060648,0.96,25,1,26,612886
chr1,40060687,0.84,51,10,61,612887
chr1,40060941,0.8,76,19,95,612888
chr1,40061001,0.84,89,17,106,612889
chr1,40061207,0.82,32,7,39,612890
chr1,40061233,0.9,47,5,52,612891
chr1,40061303,0.92,97,8,105,612892
chr1,40061572,0.88,59,8,67,612893
chr1,40061622,0.92,46,4,50,612894
chr1,40061708,0.51,40,39,79,612895
chr1,40061782,0.82,86,19,105,612896
chr1,40061812,0.93,92,7,99,612897
chr1,40061831,0.9,88,10,98,612898
chr1,40061834,0.85,84,15,99,612899
chr1,40061989,0.84,72,14,86,612900
chr1,40062000,0.8,70,18,88,612901
chr1,40062032,0.93,91,7,98,612902
chr1,40062140,0.87,109,17,126,612903
chr1,40062153,0.96,120,5,125,612904
chr1,40062169,0.9,112,12,124,612905
chr1,40062276,0.91,61,6,67,612906
chr1,40062412,0.92,23,2,25,612907
chr1,40062461,0.97,37,1,38,612908
chr1,40062633,0.82,67,15,82,612909
chr1,40062829,0.81,56,13,69,612910
chr1,40062909,0.19,9,39,48,612911
chr1,40063014,0.88,23,3,26,612912
chr1,40063088,0.91,59,6,65,612913
chr1,40063148,0.96,77,3,80,612914
chr1,40063172,0.94,68,4,72,612915
chr1,40063245,0.99,74,1,75,612916
chr1,40063305,0.98,92,2,94,612917
chr1,40063377,0.94,94,6,100,612918
chr1,40063447,0.94,82,5,87,612919
chr1,40063479,0.94,68,4,72,612920
chr1,40063592,0.8,35,9,44,612921
chr1,40064079,0.94,62,4,66,612922
chr1,40064096,0.94,82,5,87,612923
chr1,40064130,0.97,101,3,104,612924
chr1,40064152,0.89,82,10,92,612925
chr1,40064184,0.71,57,23,80,612926
chr1,40064248,0.94,32,2,34,612927
chr1,40064280,0.9,36,4,40,612928
chr1,40064308,0.88,52,7,59,612929
chr1,40064318,0.7,43,18,61,612930
chr1,40064325,0.94,67,4,71,612931
chr1,40064628,0.83,66,14,80,612932
chr1,40064724,0.76,45,14,59,612933
chr1,40064960,0.75,59,20,79,612934
chr1,40065112,0.94,85,5,90,612935
chr1,40065188,0.67,56,28,84,612936
chr1,40065467,0.83,82,17,99,612937
chr1,40065539,0.85,77,14,91,612938
chr1,40065573,0.97,76,2,78,612939
chr1,40065615,0.92,68,6,74,612940
chr1,40065661,1,89,0,89,612941
chr1,40065669,0.98,99,2,101,612942
chr1,40065701,0.87,83,12,95,612943
chr1,40065720,0.92,76,7,83,612944
chr1,40065755,0.91,62,6,68,612945
chr1,40065759,0.5,58,57,115,612946
chr1,40065775,0.42,51,71,122,612947
chr1,40065792,0.4,52,78,130,612948
chr1,40065802,0.33,43,88,131,612949
chr1,40065812,0.92,47,4,51,612950
chr1,40065938,0.62,26,16,42,612951
chr1,40066048,0.92,91,8,99,612952
chr1,40066050,0.77,74,22,96,612953
chr1,40066058,0.93,96,7,103,612954
chr1,40066080,0.9,90,10,100,612955
chr1,40066100,0.89,85,10,95,612956
chr1,40066112,0.85,76,13,89,612957
chr1,40066144,0.92,60,5,65,612958
chr1,40066154,0.81,44,10,54,612959
chr1,40066175,0.9,55,6,61,612960
chr1,40066189,0.81,54,13,67,612961
chr1,40066196,0.98,61,1,62,612962
chr1,40066205,0.84,63,12,75,612963
chr1,40066242,0.86,74,12,86,612964
chr1,40066245,0.86,71,12,83,612965
chr1,40066254,0.9,77,9,86,612966
chr1,40066271,0.6,53,36,89,612967
chr1,40066309,0.68,50,23,73,612968
chr1,40066502,0.98,56,1,57,612969
chr1,40066558,0.97,83,3,86,612970
chr1,40066618,0.94,89,6,95,612971
chr1,40066621,0.88,87,12,99,612972
chr1,40066766,0.92,90,8,98,612973
chr1,40066769,0.95,99,5,104,612974
chr1,40066778,0.97,101,3,104,612975
chr1,40066806,0.99,99,1,100,612976
chr1,40066863,0.92,73,6,79,612977
chr1,40066871,0.99,74,1,75,612978
chr1,40066944,0.84,48,9,57,612979
chr1,40066960,0.94,48,3,51,612980
chr1,40066988,0.93,42,3,45,612981
chr1,40066993,0.98,44,1,45,612982
chr1,40066997,0.97,37,1,38,612983
chr1,40067004,0.9,35,4,39,612984
chr1,40067092,0.97,57,2,59,612985
chr1,40067144,0.88,49,7,56,612986
chr1,40067151,0.96,47,2,49,612987
chr1,40067168,0.74,32,11,43,612988
chr1,40067176,0.94,33,2,35,612989
chr1,40067280,0.71,15,6,21,612990
chr1,40067346,0.92,44,4,48,612991
chr1,40067376,0.96,54,2,56,612992
chr1,40067414,1,75,0,75,612993
chr1,40067467,0.91,69,7,76,612994
chr1,40067513,0.97,85,3,88,612995
chr1,40067567,0.92,78,7,85,612996
chr1,40067586,1,78,0,78,612997
chr1,40067757,0.94,78,5,83,612998
chr1,40068114,0.88,80,11,91,612999
chr1,40068154,0.98,86,2,88,613000
chr1,40068190,0.96,64,3,67,613001
chr1,40068202,0.94,66,4,70,613002
chr1,40068265,0.88,53,7,60,613003
chr1,40068269,0.96,53,2,55,613004
chr1,40068292,0.96,55,2,57,613005
chr1,40068561,0.89,89,11,100,613006
chr1,40068851,0.73,38,14,52,613007
chr1,40068880,0.99,70,1,71,613008
chr1,40068936,0.81,75,18,93,613009
chr1,40068968,0.98,89,2,91,613010
chr1,40069000,0.69,54,24,78,613011
chr1,40069045,0.84,61,12,73,613012
chr1,40069061,0.88,56,8,64,613013
chr1,40069089,0.81,50,12,62,613014
chr1,40069181,0.86,56,9,65,613015
chr1,40069198,0.99,77,1,78,613016
chr1,40069205,0.99,80,1,81,613017
chr1,40069215,0.97,84,3,87,613018
chr1,40069346,0.89,51,6,57,613019
chr1,40069542,1,75,0,75,613020
chr1,40069574,1,63,0,63,613021
chr1,40069704,0.7,28,12,40,613022
chr1,40069764,0.53,36,32,68,613023
chr1,40069787,0.86,69,11,80,613024
chr1,40069817,0.41,41,60,101,613025
chr1,40069877,0.89,86,11,97,613026
chr1,40070188,0.81,89,21,110,613027
chr1,40070477,0.92,86,7,93,613028
chr1,40070523,0.93,91,7,98,613029
chr1,40070635,0.99,67,1,68,613030
chr1,40070638,0.91,60,6,66,613031
chr1,40070650,0.88,59,8,67,613032
chr1,40070678,0.93,52,4,56,613033
chr1,40070683,0.96,50,2,52,613034
chr1,40070728,0.44,24,30,54,613035
chr1,40070820,0.73,66,25,91,613036
chr1,40070837,0.81,68,16,84,613037
chr1,40070844,0.99,78,1,79,613038
chr1,40070861,0.94,67,4,71,613039
chr1,40070869,0.99,66,1,67,613040
chr1,40070912,0.92,55,5,60,613041
chr1,40071004,0.91,49,5,54,613042
chr1,40071012,0.71,35,14,49,613043
chr1,40071066,0.88,53,7,60,613044
chr1,40071076,0.9,55,6,61,613045
chr1,40071098,0.81,56,13,69,613046
chr1,40071118,0.97,66,2,68,613047
chr1,40071199,0.72,66,26,92,613048
chr1,40071214,0.92,88,8,96,613049
chr1,40071251,0.79,81,21,102,613050
chr1,40071267,0.73,76,28,104,613051
chr1,40071472,0.42,32,45,77,613052
chr1,40071650,0.02,2,90,92,613053
chr1,40071796,0.3,19,44,63,613054
chr1,40071932,0,0,109,109,613055
chr1,40071972,0,0,91,91,613056
chr1,40072014,0,0,113,113,613057
chr1,40072059,0,0,106,106,613058
chr1,40072096,0.01,1,82,83,613059
chr1,40072151,0,0,41,41,613060
chr1,40072156,0,0,32,32,613061
chr1,40072160,0,0,25,25,613062
chr1,40072167,0,0,29,29,613063
chr1,40072181,0,0,18,18,613064
chr1,40072192,0,0,14,14,613065
chr1,40072201,0,0,10,10,613066
chr1,40072212,0,0,2,2,613067
chr1,40072253,0,0,1,1,613068
chr1,40072257,0,0,1,1,613069
chr1,40072301,0.12,3,22,25,613070
chr1,40072309,0.2,6,24,30,613071
chr1,40072316,0.43,10,13,23,613072
chr1,40072333,0.03,1,34,35,613073
chr1,40072339,0.03,1,36,37,613074
chr1,40072363,0.07,2,25,27,613075
chr1,40072371,0.08,2,24,26,613076
chr1,40072379,0.07,2,27,29,613077
chr1,40072430,0.74,14,5,19,613078
chr1,40072434,0.95,19,1,20,613079
chr1,40072474,0.48,15,16,31,613080
chr1,40072479,0.76,22,7,29,613081
chr1,40072529,0.98,52,1,53,613082
chr1,40072537,0.9,53,6,59,613083
chr1,40072602,0.96,85,4,89,613084
chr1,40072610,0.99,90,1,91,613085
chr1,40072616,1,101,0,101,613086
chr1,40072623,0.75,76,25,101,613087
chr1,40072634,0.87,81,12,93,613088
chr1,40072658,0.89,70,9,79,613089
chr1,40072666,0.97,66,2,68,613090
chr1,40072688,0.64,35,20,55,613091
chr1,40072704,0.65,31,17,48,613092
chr1,40072744,0.81,29,7,36,613093
chr1,40072807,0.86,54,9,63,613094
chr1,40072813,0.79,46,12,58,613095
chr1,40072851,0.82,47,10,57,613096
chr1,40072860,0.9,53,6,59,613097
chr1,40072867,0.85,41,7,48,613098
chr1,40072881,0.98,49,1,50,613099
chr1,40072959,1,53,0,53,613100
chr1,40072979,1,61,0,61,613101
chr1,40073003,0.98,61,1,62,613102
chr1,40073010,1,58,0,58,613103
chr1,40073018,0.98,60,1,61,613104
chr1,40073035,0.79,42,11,53,613105
chr1,40073049,0.86,49,8,57,613106
chr1,40073081,0.91,31,3,34,613107
chr1,40073177,0.96,52,2,54,613108
chr1,40073278,1,69,0,69,613109
chr1,40073280,0.96,66,3,69,613110
chr1,40073360,0.94,46,3,49,613111
chr1,40073588,0.92,47,4,51,613112
chr1,40073592,1,48,0,48,613113
chr1,40073594,0.98,47,1,48,613114
chr1,40073604,1,52,0,52,613115
chr1,40073608,0.98,50,1,51,613116
chr1,40073624,0.9,57,6,63,613117
chr1,40073632,0.88,57,8,65,613118
chr1,40073641,0.97,67,2,69,613119
chr1,40073648,0.97,67,2,69,613120
chr1,40073723,0.94,74,5,79,613121
chr1,40073727,0.95,69,4,73,613122
chr1,40073759,0.85,62,11,73,613123
chr1,40073783,0.94,64,4,68,613124
chr1,40073791,0.92,61,5,66,613125
chr1,40073814,0.96,49,2,51,613126
chr1,40073821,0.98,48,1,49,613127
chr1,40073823,1,46,0,46,613128
chr1,40073829,0.95,41,2,43,613129
chr1,40073861,0.4,12,18,30,613130
chr1,40074114,0.97,72,2,74,613131
chr1,40074142,0.97,58,2,60,613132
chr1,40074147,0.98,57,1,58,613133
chr1,40074151,0.95,39,2,41,613134
chr1,40074172,1,47,0,47,613135
chr1,40074192,0.9,47,5,52,613136
chr1,40074203,0.67,36,18,54,613137
chr1,40074237,0.94,62,4,66,613138
chr1,40074245,0.94,65,4,69,613139
chr1,40074249,0.98,59,1,60,613140
chr1,40074301,0.98,83,2,85,613141
chr1,40074324,0.99,93,1,94,613142
chr1,40074330,0.98,86,2,88,613143
chr1,40074332,0.99,88,1,89,613144
chr1,40074354,0.99,95,1,96,613145
chr1,40074370,0.9,89,10,99,613146
chr1,40074406,0.83,81,17,98,613147
chr1,40074521,0.95,95,5,100,613148
chr1,40074614,0.27,32,88,120,613149
chr1,40074712,0.96,93,4,97,613150
chr1,40074770,0.93,95,7,102,613151
chr1,40074776,0.92,94,8,102,613152
chr1,40074794,0.98,90,2,92,613153
chr1,40074836,0.83,70,14,84,613154
chr1,40074883,0.95,81,4,85,613155
chr1,40074939,0.85,76,13,89,613156
chr1,40075016,1,63,0,63,613157
chr1,40075025,0.95,71,4,75,613158
chr1,40075053,0.98,81,2,83,613159
chr1,40075061,0.96,86,4,90,613160
chr1,40075089,0.99,91,1,92,613161
chr1,40075097,0.85,81,14,95,613162
chr1,40075104,0.73,63,23,86,613163
chr1,40075120,0.76,73,23,96,613164
chr1,40075124,0.89,84,10,94,613165
chr1,40075126,0.73,66,25,91,613166
chr1,40075276,0.28,17,44,61,613167
chr1,40075280,0.46,24,28,52,613168
chr1,40075304,0.63,27,16,43,613169
chr1,40075310,0.22,14,49,63,613170
chr1,40075327,0.82,59,13,72,613171
chr1,40075348,0.22,15,53,68,613172
chr1,40075377,0.81,34,8,42,613173
chr1,40075380,0.43,26,34,60,613174
chr1,40075433,0.05,3,63,66,613175
chr1,40075455,0.19,8,34,42,613176
chr1,40075465,0.07,3,42,45,613177
chr1,40075469,0.04,2,54,56,613178
chr1,40075478,0.22,6,21,27,613179
chr1,40075495,0.07,4,52,56,613180
chr1,40075516,0.58,31,22,53,613181
chr1,40075525,0.94,44,3,47,613182
chr1,40075533,0.9,38,4,42,613183
chr1,40075548,0.55,28,23,51,613184
chr1,40075561,0.56,33,26,59,613185
chr1,40075565,0.48,28,30,58,613186
chr1,40075570,0.88,43,6,49,613187
chr1,40075576,0.48,29,31,60,613188
chr1,40075586,0.57,37,28,65,613189
chr1,40075618,0.92,60,5,65,613190
chr1,40075631,0.92,66,6,72,613191
chr1,40075646,0.88,60,8,68,613192
chr1,40075689,0.71,50,20,70,613193
chr1,40075726,0.22,16,56,72,613194
chr1,40075759,0.2,13,51,64,613195
chr1,40075765,0.21,12,45,57,613196
chr1,40075769,0.43,25,33,58,613197
chr1,40075771,0.45,23,28,51,613198
chr1,40075795,0.38,21,34,55,613199
chr1,40075801,0.34,18,35,53,613200
chr1,40075810,0.52,24,22,46,613201
chr1,40075881,0.75,41,14,55,613202
chr1,40075892,0.5,28,28,56,613203
chr1,40075899,0.44,27,34,61,613204
chr1,40075904,0.54,36,31,67,613205
chr1,40075933,0.3,18,43,61,613206
chr1,40075935,0.38,23,38,61,613207
chr1,40075941,0.32,20,43,63,613208
chr1,40075973,0.77,36,11,47,613209
chr1,40075975,0.83,34,7,41,613210
chr1,40076004,0.97,35,1,36,613211
chr1,40076011,0.95,40,2,42,613212
chr1,40076023,0.98,48,1,49,613213
chr1,40076045,0.96,48,2,50,613214
chr1,40076056,0.88,42,6,48,613215
chr1,40076064,0.98,49,1,50,613216
chr1,40076089,0.84,47,9,56,613217
chr1,40076353,0.81,73,17,90,613218
chr1,40076383,0.88,87,12,99,613219
chr1,40076386,0.93,89,7,96,613220
chr1,40076411,0.77,96,29,125,613221
chr1,40076440,0.93,114,8,122,613222
chr1,40076444,0.86,100,16,116,613223
chr1,40076475,0.91,73,7,80,613224
chr1,40076545,0.98,107,2,109,613225
chr1,40076559,0.92,113,10,123,613226
chr1,40076568,0.87,106,16,122,613227
chr1,40076572,0.98,119,2,121,613228
chr1,40076589,0.83,120,25,145,613229
chr1,40076608,0.83,123,25,148,613230
chr1,40076644,0.82,105,23,128,613231
chr1,40076769,0.55,46,37,83,613232
chr1,40076779,0.51,43,42,85,613233
chr1,40077177,1,110,0,110,613234
chr1,40077471,0.85,82,14,96,613235
chr1,40077496,0.96,90,4,94,613236
chr1,40077503,0.94,80,5,85,613237
chr1,40077509,0.88,82,11,93,613238
chr1,40077678,0.95,82,4,86,613239
chr1,40077855,0.8,76,19,95,613240
chr1,40078007,0.96,51,2,53,613241
chr1,40078062,0.97,28,1,29,613242
chr1,40078069,1,30,0,30,613243
chr1,40078077,0.97,33,1,34,613244
chr1,40078121,0.97,31,1,32,613245
chr1,40078133,0.95,39,2,41,613246
chr1,40078137,0.85,39,7,46,613247
chr1,40078177,0.83,49,10,59,613248
chr1,40078195,0.96,53,2,55,613249
chr1,40078197,0.95,56,3,59,613250
chr1,40078211,0.98,56,1,57,613251
chr1,40078218,0.96,51,2,53,613252
chr1,40078255,0.91,31,3,34,613253
chr1,40078265,0.85,28,5,33,613254
chr1,40078271,0.94,30,2,32,613255
chr1,40078340,0.98,45,1,46,613256
chr1,40078460,0.96,85,4,89,613257
chr1,40078476,0.94,82,5,87,613258
chr1,40078486,0.99,88,1,89,613259
chr1,40078504,0.97,95,3,98,613260
chr1,40078513,0.95,89,5,94,613261
chr1,40078536,0.97,91,3,94,613262
chr1,40078550,0.97,93,3,96,613263
chr1,40078567,0.96,90,4,94,613264
chr1,40078609,0.94,88,6,94,613265
chr1,40078653,1,98,0,98,613266
chr1,40078663,0.94,85,5,90,613267
chr1,40078733,0.97,63,2,65,613268
chr1,40078915,0.99,73,1,74,613269
chr1,40078966,0.77,62,19,81,613270
chr1,40078970,0.99,84,1,85,613271
chr1,40079243,0.64,46,26,72,613272
chr1,40079259,0.79,49,13,62,613273
chr1,40079261,0.68,43,20,63,613274
chr1,40079270,0.8,41,10,51,613275
chr1,40079331,0.37,22,38,60,613276
chr1,40079532,0.81,70,16,86,613277
chr1,40079580,0.94,93,6,99,613278
chr1,40079609,0.8,88,22,110,613279
chr1,40079630,0.92,113,10,123,613280
chr1,40079636,0.73,92,34,126,613281
chr1,40079653,0.88,106,15,121,613282
chr1,40079690,0.9,97,11,108,613283
chr1,40079750,0.95,77,4,81,613284
chr1,40079769,0.89,72,9,81,613285
chr1,40079907,0.75,72,24,96,613286
chr1,40080109,0.95,90,5,95,613287
chr1,40080149,0.95,74,4,78,613288
chr1,40080371,0.95,81,4,85,613289
chr1,40080430,0.98,96,2,98,613290
chr1,40080505,0.98,82,2,84,613291
chr1,40080517,0.99,78,1,79,613292
chr1,40080545,0.96,75,3,78,613293
chr1,40080554,0.99,74,1,75,613294
chr1,40080575,0.85,66,12,78,613295
chr1,40080772,0.75,38,13,51,613296
chr1,40080985,0.44,34,43,77,613297
chr1,40081013,0.6,53,36,89,613298
chr1,40081066,0.71,65,26,91,613299
chr1,40081189,0.63,20,12,32,613300
chr1,40081229,0.25,6,18,24,613301
chr1,40081323,1,55,0,55,613302
chr1,40081331,0.9,55,6,61,613303
chr1,40081355,0.95,62,3,65,613304
chr1,40081387,0.96,49,2,51,613305
chr1,40081411,0.92,34,3,37,613306
chr1,40081419,0.94,34,2,36,613307
chr1,40081452,0.98,39,1,40,613308
chr1,40081483,0.91,50,5,55,613309
chr1,40081508,0.93,67,5,72,613310
chr1,40081513,0.9,73,8,81,613311
chr1,40081541,0.9,79,9,88,613312
chr1,40081553,0.95,81,4,85,613313
chr1,40081604,0.97,73,2,75,613314
chr1,40081644,1,82,0,82,613315
chr1,40081758,0.95,60,3,63,613316
chr1,40081937,0.95,70,4,74,613317
chr1,40081959,0.8,70,17,87,613318
chr1,40082006,0.88,67,9,76,613319
chr1,40082022,0.76,56,18,74,613320
chr1,40082093,0.94,59,4,63,613321
chr1,40082099,1,64,0,64,613322
chr1,40082116,0.97,73,2,75,613323
chr1,40082133,0.96,76,3,79,613324
chr1,40082219,0.98,80,2,82,613325
chr1,40082250,0.95,80,4,84,613326
chr1,40082277,0.99,83,1,84,613327
chr1,40082308,0.96,82,3,85,613328
chr1,40082325,0.98,95,2,97,613329
chr1,40082390,0.95,126,7,133,613330
chr1,40082408,0.86,109,18,127,613331
chr1,40082426,0.65,86,46,132,613332
chr1,40082471,0.89,119,15,134,613333
chr1,40082554,0.94,99,6,105,613334
chr1,40082606,0.84,80,15,95,613335
chr1,40082651,0.9,74,8,82,613336
chr1,40082728,0.9,62,7,69,613337
chr1,40083044,0.92,46,4,50,613338
chr1,40083051,0.98,43,1,44,613339
chr1,40083140,0.85,58,10,68,613340
chr1,40083201,0.97,62,2,64,613341
chr1,40083343,0.73,77,28,105,613342
chr1,40083368,0.93,101,8,109,613343
chr1,40083419,0.58,70,50,120,613344
chr1,40083919,0.52,15,14,29,613345
chr1,40083952,0.69,31,14,45,613346
chr1,40083975,0.9,56,6,62,613347
chr1,40083992,0.27,24,64,88,613348
chr1,40084170,0.93,76,6,82,613349
chr1,40084214,0.82,77,17,94,613350
chr1,40084627,0.83,29,6,35,613351
chr1,40084683,0.93,50,4,54,613352
chr1,40084715,0.92,57,5,62,613353
chr1,40084751,0.91,51,5,56,613354
chr1,40084811,0.94,32,2,34,613355
chr1,40084883,0.94,58,4,62,613356
chr1,40085213,0.97,88,3,91,613357
chr1,40085217,1,78,0,78,613358
chr1,40085378,0.86,64,10,74,613359
chr1,40085582,0.89,51,6,57,613360
chr1,40085687,0.99,74,1,75,613361
chr1,40085695,0.99,70,1,71,613362
chr1,40085805,0.65,58,31,89,613363
chr1,40085957,0.97,94,3,97,613364
chr1,40086144,0.9,53,6,59,613365
chr1,40086260,0.86,49,8,57,613366
chr1,40086386,0.95,57,3,60,613367
chr1,40086635,0.95,99,5,104,613368
chr1,40086816,0.97,71,2,73,613369
chr1,40087162,0.91,68,7,75,613370
chr1,40087227,0.95,83,4,87,613371
chr1,40087260,0.95,84,4,88,613372
chr1,40087295,0.68,55,26,81,613373
chr1,40087357,0.93,52,4,56,613374
chr1,40087365,0.95,55,3,58,613375
chr1,40087389,0.98,43,1,44,613376
chr1,40087395,0.94,47,3,50,613377
chr1,40087429,0.82,42,9,51,613378
chr1,40087453,1,57,0,57,613379
chr1,40087515,1,59,0,59,613380
chr1,40087616,0.89,57,7,64,613381
chr1,40087626,0.4,29,43,72,613382
chr1,40087766,0.9,46,5,51,613383
chr1,40087820,0.93,78,6,84,613384
chr1,40087872,0.93,85,6,91,613385
chr1,40087889,0.96,85,4,89,613386
chr1,40087946,0.92,35,3,38,613387
chr1,40087973,1,33,0,33,613388
chr1,40087978,0.97,38,1,39,613389
chr1,40088022,0.98,65,1,66,613390
chr1,40088171,0.94,94,6,100,613391
chr1,40088189,0.99,93,1,94,613392
chr1,40088381,0.98,61,1,62,613393
chr1,40088512,0.23,15,50,65,613394
chr1,40088532,0.11,8,65,73,613395
chr1,40088629,0.87,68,10,78,613396
chr1,40088641,0.68,52,25,77,613397
chr1,40088816,0.07,8,104,112,613398
chr1,40088830,0.08,8,92,100,613399
chr1,40088921,0.11,8,63,71,613400
chr1,40088934,0.11,8,64,72,613401
chr1,40089022,0.06,3,44,47,613402
chr1,40089073,0.13,10,70,80,613403
chr1,40089135,0.21,22,82,104,613404
chr1,40089224,0.22,23,82,105,613405
chr1,40089343,0.8,86,21,107,613406
chr1,40089361,0.83,92,19,111,613407
chr1,40089369,0.8,84,21,105,613408
chr1,40089489,0.84,88,17,105,613409
chr1,40089636,0.91,96,10,106,613410
chr1,40089861,0.97,75,2,77,613411
chr1,40090087,0.09,9,91,100,613412
chr1,40090250,0.55,31,25,56,613413
chr1,40090360,0.91,51,5,56,613414
chr1,40090776,0.08,7,82,89,613415
chr1,40090796,0.12,10,76,86,613416
chr1,40090823,0.23,14,47,61,613417
chr1,40090869,0.06,5,81,86,613418
chr1,40090943,0.13,12,80,92,613419
chr1,40090960,0.04,3,76,79,613420
chr1,40091013,0.11,9,72,81,613421
chr1,40091077,0.17,10,48,58,613422
chr1,40091081,0.06,4,67,71,613423
chr1,40091117,0.03,2,64,66,613424
chr1,40091206,0.1,9,83,92,613425
chr1,40091230,0.05,5,97,102,613426
chr1,40091264,0.05,4,77,81,613427
chr1,40091284,0.03,2,77,79,613428
chr1,40091324,0.05,3,59,62,613429
chr1,40091338,0.05,3,54,57,613430
chr1,40091349,0.09,7,68,75,613431
chr1,40091709,0.13,7,48,55,613432
chr1,40091739,0.07,5,68,73,613433
chr1,40091788,0.09,6,64,70,613434
chr1,40091901,0.44,28,35,63,613435
chr1,40092063,0.12,8,58,66,613436
chr1,40092159,0.54,57,48,105,613437
chr1,40092190,0.26,29,81,110,613438
chr1,40092236,0.69,43,19,62,613439
chr1,40092289,0.51,23,22,45,613440
chr1,40092299,0.39,15,23,38,613441
chr1,40092349,0.89,31,4,35,613442
chr1,40092385,0.47,14,16,30,613443
chr1,40092401,0.35,15,28,43,613444
chr1,40092420,0.95,40,2,42,613445
chr1,40092429,0.25,13,38,51,613446
chr1,40092447,0.25,13,40,53,613447
chr1,40092468,0.35,19,35,54,613448
chr1,40092498,0.56,29,23,52,613449
chr1,40092508,0.72,28,11,39,613450
chr1,40092513,0.42,24,33,57,613451
chr1,40092550,0.16,9,49,58,613452
chr1,40092586,0.24,10,32,42,613453
chr1,40092671,0.7,37,16,53,613454
chr1,40092677,0.96,51,2,53,613455
chr1,40092691,0.37,22,38,60,613456
chr1,40092697,0.47,27,31,58,613457
chr1,40092723,0.93,51,4,55,613458
chr1,40092729,0.67,41,20,61,613459
chr1,40092733,0.67,39,19,58,613460
chr1,40092744,0.5,28,28,56,613461
chr1,40092801,0.9,46,5,51,613462
chr1,40092816,0.84,46,9,55,613463
chr1,40092837,0.46,23,27,50,613464
chr1,40092866,1,45,0,45,613465
chr1,40092963,0.49,23,24,47,613466
chr1,40093262,0.96,77,3,80,613467
chr1,40093305,0.96,76,3,79,613468
chr1,40093331,0.49,39,41,80,613469
chr1,40093334,0.7,57,25,82,613470
chr1,40093464,0.79,76,20,96,613471
chr1,40093636,0.74,50,18,68,613472
chr1,40093780,0.59,64,44,108,613473
chr1,40093934,0.5,36,36,72,613474
chr1,40093982,0.89,51,6,57,613475
chr1,40094014,0.6,50,33,83,613476
chr1,40094037,0.96,97,4,101,613477
chr1,40094111,0.78,71,20,91,613478
chr1,40094170,0.91,42,4,46,613479
chr1,40094193,0.98,44,1,45,613480
chr1,40094202,0.82,37,8,45,613481
chr1,40094242,0.98,54,1,55,613482
chr1,40094292,0.95,57,3,60,613483
chr1,40094300,1,65,0,65,613484
chr1,40094308,1,59,0,59,613485
chr1,40094332,0.91,74,7,81,613486
chr1,40094338,0.66,57,30,87,613487
chr1,40094355,0.99,89,1,90,613488
chr1,40094394,0.51,41,39,80,613489
chr1,40094414,0.93,69,5,74,613490
chr1,40094430,0.86,64,10,74,613491
chr1,40094475,0.87,40,6,46,613492
chr1,40094495,0.87,26,4,30,613493
chr1,40094516,1,25,0,25,613494
chr1,40094525,0.95,18,1,19,613495
chr1,40094553,0.93,38,3,41,613496
chr1,40094563,0.96,45,2,47,613497
chr1,40094565,0.96,46,2,48,613498
chr1,40094569,0.94,44,3,47,613499
chr1,40094574,1,57,0,57,613500
chr1,40094722,0.96,73,3,76,613501
chr1,40094743,0.93,70,5,75,613502
chr1,40094766,0.92,78,7,85,613503
chr1,40095659,0.98,90,2,92,613504
chr1,40095707,0.97,75,2,77,613505
chr1,40095808,0.82,55,12,67,613506
chr1,40095873,0.87,68,10,78,613507
chr1,40095939,0.75,63,21,84,613508
chr1,40095956,0.74,54,19,73,613509
chr1,40095984,0.82,51,11,62,613510
chr1,40096034,0.99,70,1,71,613511
chr1,40096058,0.47,37,41,78,613512
chr1,40096184,0.86,91,15,106,613513
chr1,40096223,0.8,80,20,100,613514
chr1,40096271,0.79,78,21,99,613515
chr1,40096308,0.84,87,17,104,613516
chr1,40096648,0.89,55,7,62,613517
chr1,40096711,0.98,65,1,66,613518
chr1,40096863,0.96,67,3,70,613519
chr1,40097109,0.33,33,67,100,613520
chr1,40097196,0.73,90,34,124,613521
chr1,40097199,0.65,82,45,127,613522
chr1,40097226,0.94,118,7,125,613523
chr1,40097232,0.51,63,61,124,613524
chr1,40097235,0.71,80,33,113,613525
chr1,40097238,0.59,73,50,123,613526
chr1,40097442,0.88,75,10,85,613527
chr1,40097477,0.7,66,28,94,613528
chr1,40097556,0.31,22,49,71,613529
chr1,40097582,0.36,19,34,53,613530
chr1,40097606,0.81,38,9,47,613531
chr1,40097645,0.21,10,37,47,613532
chr1,40097722,0.26,12,35,47,613533
chr1,40097917,0.64,25,14,39,613534
chr1,40097956,0.62,18,11,29,613535
chr1,40098194,0.21,19,72,91,613536
chr1,40098251,0.66,67,34,101,613537
chr1,40098254,0.57,60,46,106,613538
chr1,40098310,0.6,64,42,106,613539
chr1,40098328,0.41,36,52,88,613540
chr1,40098351,0.36,28,49,77,613541
chr1,40098372,0.52,25,23,48,613542
chr1,40098438,0.05,2,36,38,613543
chr1,40098448,0.05,2,36,38,613544
chr1,40098454,0.07,3,41,44,613545
chr1,40098531,0.02,1,59,60,613546
chr1,40098579,0,0,63,63,613547
chr1,40098589,0.02,1,57,58,613548
chr1,40098595,0.07,2,27,29,613549
chr1,40098602,0.09,3,29,32,613550
chr1,40098609,0.03,1,31,32,613551
chr1,40098616,0.06,2,34,36,613552
chr1,40098623,0,0,20,20,613553
chr1,40098630,0.02,1,48,49,613554
chr1,40098632,0.04,2,45,47,613555
chr1,40098635,0.06,3,45,48,613556
chr1,40098639,0.06,3,46,49,613557
chr1,40098642,0.09,5,48,53,613558
chr1,40098650,0.09,4,43,47,613559
chr1,40098652,0.06,3,47,50,613560
chr1,40098657,0.11,5,42,47,613561
chr1,40098659,0.12,6,44,50,613562
chr1,40098662,0.13,6,40,46,613563
chr1,40098664,0.13,6,42,48,613564
chr1,40098673,0.1,5,43,48,613565
chr1,40098687,0.08,4,47,51,613566
chr1,40098694,0.04,2,47,49,613567
chr1,40098700,0.14,6,37,43,613568
chr1,40098705,0.12,5,36,41,613569
chr1,40098709,0.14,5,32,37,613570
chr1,40098722,0.03,1,39,40,613571
chr1,40098725,0.08,3,34,37,613572
chr1,40098728,0.06,2,31,33,613573
chr1,40098731,0.12,4,30,34,613574
chr1,40098742,0.08,3,36,39,613575
chr1,40098746,0.1,3,28,31,613576
chr1,40098768,0.05,2,36,38,613577
chr1,40098777,0.08,3,33,36,613578
chr1,40098781,0.14,4,25,29,613579
chr1,40098799,0.07,2,25,27,613580
chr1,40098811,0.07,2,27,29,613581
chr1,40098816,0.08,2,24,26,613582
chr1,40098820,0.22,2,7,9,613583
chr1,40098822,0.29,4,10,14,613584
chr1,40098825,0.04,1,23,24,613585
chr1,40098829,0.2,3,12,15,613586
chr1,40098833,0.07,1,14,15,613587
chr1,40098840,0.15,3,17,20,613588
chr1,40098845,0.15,3,17,20,613589
chr1,40098858,0.15,2,11,13,613590
chr1,40098870,0.06,1,15,16,613591
chr1,40098872,0.07,1,14,15,613592
chr1,40098877,0.08,1,11,12,613593
chr1,40098881,0.05,1,18,19,613594
chr1,40098887,0.07,1,13,14,613595
chr1,40098898,0,0,12,12,613596
chr1,40098923,0,0,27,27,613597
chr1,40098963,0,0,30,30,613598
chr1,40098977,0.03,1,30,31,613599
chr1,40098995,0,0,33,33,613600
chr1,40099010,0.12,2,15,17,613601
chr1,40099015,0.03,1,29,30,613602
chr1,40099186,0.45,32,39,71,613603
chr1,40099353,0.27,20,54,74,613604
chr1,40099370,0.82,65,14,79,613605
chr1,40099538,0.93,86,6,92,613606
chr1,40099561,0.53,48,42,90,613607
chr1,40099580,0.86,83,13,96,613608
chr1,40099600,0.9,84,9,93,613609
chr1,40099853,0.68,38,18,56,613610
chr1,40099860,0.15,11,62,73,613611
chr1,40099890,0.35,23,43,66,613612
chr1,40099923,0.25,16,47,63,613613
chr1,40099955,0.32,21,44,65,613614
chr1,40100013,0.9,45,5,50,613615
chr1,40100142,0.83,76,16,92,613616
chr1,40100647,0.73,55,20,75,613617
chr1,40100845,0.16,12,62,74,613618
chr1,40101007,0,0,67,67,613619
chr1,40101036,0.08,6,70,76,613620
chr1,40101044,0.06,5,77,82,613621
chr1,40101068,0.14,12,75,87,613622
chr1,40101095,0.29,27,67,94,613623
chr1,40101121,0.31,26,57,83,613624
chr1,40101189,0.1,9,83,92,613625
chr1,40101388,0.06,5,81,86,613626
chr1,40101403,0.21,16,61,77,613627
chr1,40101459,0.08,6,74,80,613628
chr1,40101513,0.15,14,78,92,613629
chr1,40101515,0.14,13,79,92,613630
chr1,40101664,0.23,14,46,60,613631
chr1,40101737,0.09,8,80,88,613632
chr1,40101901,0.15,7,41,48,613633
chr1,40102024,0.94,46,3,49,613634
chr1,40102085,0.16,10,54,64,613635
chr1,40102159,0.63,15,9,24,613636
chr1,40102173,0.47,15,17,32,613637
chr1,40102217,0.73,37,14,51,613638
chr1,40102227,0.34,22,42,64,613639
chr1,40102233,0.49,33,35,68,613640
chr1,40102293,0.64,60,34,94,613641
chr1,40102493,0.44,35,44,79,613642
chr1,40102553,0.7,62,27,89,613643
chr1,40102567,0.07,6,85,91,613644
chr1,40102645,0.53,51,46,97,613645
chr1,40102679,0.28,23,59,82,613646
chr1,40102681,0.49,42,44,86,613647
chr1,40102889,0.45,37,46,83,613648
chr1,40103004,0.12,7,50,57,613649
chr1,40103027,0.66,39,20,59,613650
chr1,40103044,0.24,15,48,63,613651
chr1,40103062,0.24,18,57,75,613652
chr1,40103069,0.2,15,61,76,613653
chr1,40103204,0.17,16,77,93,613654
chr1,40103693,0.75,77,25,102,613655
chr1,40103709,0.11,13,102,115,613656
chr1,40103807,0.35,39,73,112,613657
chr1,40103817,0.55,56,45,101,613658
chr1,40104538,0.1,9,85,94,613659
chr1,40104560,0.45,42,52,94,613660
chr1,40104571,0.31,32,70,102,613661
chr1,40104635,0.11,9,73,82,613662
chr1,40104678,0.17,11,53,64,613663
chr1,40104832,0.11,7,54,61,613664
chr1,40104969,0.04,2,55,57,613665
chr1,40105011,0.02,1,50,51,613666
chr1,40105015,0.05,3,54,57,613667
chr1,40105021,0.04,2,47,49,613668
chr1,40105023,0.06,3,49,52,613669
chr1,40105040,0.02,1,57,58,613670
chr1,40105044,0,0,59,59,613671
chr1,40105051,0.04,2,53,55,613672
chr1,40105056,0.02,1,50,51,613673
chr1,40105061,0,0,45,45,613674
chr1,40105067,0,0,21,21,613675
chr1,40105076,0,0,35,35,613676
chr1,40105079,0,0,47,47,613677
chr1,40105095,0.02,1,41,42,613678
chr1,40105097,0,0,32,32,613679
chr1,40105119,0,0,48,48,613680
chr1,40105138,0.03,1,30,31,613681
chr1,40105146,0.02,1,50,51,613682
chr1,40105149,0.02,1,45,46,613683
chr1,40105155,0.02,1,53,54,613684
chr1,40105158,0,0,54,54,613685
chr1,40105163,0,0,43,43,613686
chr1,40105175,0.02,1,42,43,613687
chr1,40105179,0.08,2,22,24,613688
chr1,40105186,0,0,41,41,613689
chr1,40105194,0.02,1,58,59,613690
chr1,40105201,0,0,54,54,613691
chr1,40105208,0,0,56,56,613692
chr1,40105240,0,0,64,64,613693
chr1,40105243,0,0,65,65,613694
chr1,40105252,0,0,61,61,613695
chr1,40105255,0,0,61,61,613696
chr1,40105264,0,0,67,67,613697
chr1,40105267,0.01,1,69,70,613698
chr1,40105273,0,0,51,51,613699
chr1,40105277,0,0,64,64,613700
chr1,40105290,0.02,1,55,56,613701
chr1,40105300,0,0,55,55,613702
chr1,40105304,0,0,56,56,613703
chr1,40105327,0.02,1,53,54,613704
chr1,40105329,0.02,1,48,49,613705
chr1,40105346,0.02,1,53,54,613706
chr1,40105361,0,0,27,27,613707
chr1,40105366,0.09,3,30,33,613708
chr1,40105372,0,0,24,24,613709
chr1,40105377,0.08,3,34,37,613710
chr1,40105383,0.03,1,28,29,613711
chr1,40105388,0,0,38,38,613712
chr1,40105394,0,0,10,10,613713
chr1,40105397,0,0,22,22,613714
chr1,40105403,0,0,24,24,613715
chr1,40105428,0,0,15,15,613716
chr1,40105431,0,0,25,25,613717
chr1,40105439,0,0,25,25,613718
chr1,40105443,0,0,9,9,613719
chr1,40105451,0,0,10,10,613720
chr1,40105459,0,0,15,15,613721
chr1,40105465,0,0,28,28,613722
chr1,40105467,0,0,32,32,613723
chr1,40105473,0,0,28,28,613724
chr1,40105475,0.05,1,19,20,613725
chr1,40105478,0,0,27,27,613726
chr1,40105481,0,0,34,34,613727
chr1,40105486,0,0,35,35,613728
chr1,40105503,0,0,33,33,613729
chr1,40105507,0,0,32,32,613730
chr1,40105510,0,0,37,37,613731
chr1,40105519,0,0,52,52,613732
chr1,40105522,0,0,49,49,613733
chr1,40105535,0,0,53,53,613734
chr1,40105546,0,0,53,53,613735
chr1,40105554,0,0,58,58,613736
chr1,40105561,0.04,2,53,55,613737
chr1,40105563,0,0,53,53,613738
chr1,40105565,0.02,1,47,48,613739
chr1,40105601,0.02,1,57,58,613740
chr1,40105603,0,0,62,62,613741
chr1,40105622,0.01,1,67,68,613742
chr1,40105637,0.02,1,54,55,613743
chr1,40105645,0,0,55,55,613744
chr1,40105664,0.02,1,41,42,613745
chr1,40105667,0.03,2,60,62,613746
chr1,40105672,0,0,67,67,613747
chr1,40105679,0,0,69,69,613748
chr1,40105687,0.04,3,67,70,613749
chr1,40105704,0.02,1,59,60,613750
chr1,40105706,0,0,60,60,613751
chr1,40105754,0.02,1,60,61,613752
chr1,40105764,0,0,59,59,613753
chr1,40105903,0.11,8,62,70,613754
chr1,40105922,0.32,23,48,71,613755
chr1,40105948,0.44,30,38,68,613756
chr1,40105968,0.48,32,35,67,613757
chr1,40106022,0.5,29,29,58,613758
chr1,40106036,0.71,39,16,55,613759
chr1,40106069,0.35,18,33,51,613760
chr1,40106234,0.97,75,2,77,613761
chr1,40106248,0.99,75,1,76,613762
chr1,40106392,1,38,0,38,613763
chr1,40106441,0.98,42,1,43,613764
chr1,40106543,0.95,39,2,41,613765
chr1,40106599,0.75,46,15,61,613766
chr1,40106629,0.98,61,1,62,613767
chr1,40106638,0.98,63,1,64,613768
chr1,40106671,0.86,54,9,63,613769
chr1,40106805,0.94,115,7,122,613770
chr1,40106904,0.93,84,6,90,613771
chr1,40106913,0.79,77,21,98,613772
chr1,40107013,0.84,75,14,89,613773
chr1,40107072,0.82,56,12,68,613774
chr1,40107426,0.88,83,11,94,613775
chr1,40107563,0.98,83,2,85,613776
chr1,40107600,0.98,86,2,88,613777
chr1,40107621,0.98,83,2,85,613778
chr1,40107641,0.96,82,3,85,613779
chr1,40107686,0.44,32,41,73,613780
chr1,40107718,0.93,65,5,70,613781
chr1,40107742,0.95,54,3,57,613782
chr1,40107750,0.91,51,5,56,613783
chr1,40107757,0.94,46,3,49,613784
chr1,40107782,0.93,27,2,29,613785
chr1,40107820,0.56,10,8,18,613786
chr1,40107887,0.93,41,3,44,613787
chr1,40107975,0.89,77,10,87,613788
chr1,40108054,0.6,55,37,92,613789
chr1,40108479,0.07,4,52,56,613790
chr1,40108544,0.14,9,54,63,613791
chr1,40108561,0.13,10,66,76,613792
chr1,40108760,0.05,3,52,55,613793
chr1,40108980,0.32,36,77,113,613794
chr1,40109172,0.57,55,42,97,613795
chr1,40109205,0.52,54,49,103,613796
chr1,40109541,1,34,0,34,613797
chr1,40109638,0.93,98,7,105,613798
chr1,40109759,0.99,91,1,92,613799
chr1,40109856,0.81,85,20,105,613800
chr1,40109971,0.96,69,3,72,613801
chr1,40110157,0.95,84,4,88,613802
chr1,40110194,0.99,83,1,84,613803
chr1,40110349,0.92,65,6,71,613804
chr1,40110374,0.93,62,5,67,613805
chr1,40110572,0.94,60,4,64,613806
chr1,40110702,0.98,45,1,46,613807
chr1,40110707,0.95,41,2,43,613808
chr1,40110728,1,45,0,45,613809
chr1,40110757,0.96,52,2,54,613810
chr1,40110775,0.8,44,11,55,613811
chr1,40110834,0.94,103,7,110,613812
chr1,40110891,0.8,105,27,132,613813
chr1,40111148,0.69,60,27,87,613814
chr1,40111151,0.7,60,26,86,613815
chr1,40111488,0.95,82,4,86,613816
chr1,40111809,0.87,79,12,91,613817
chr1,40111820,0.8,74,18,92,613818
chr1,40112007,0.89,41,5,46,613819
chr1,40112028,0.57,29,22,51,613820
chr1,40112073,0.03,2,63,65,613821
chr1,40112113,0.25,17,52,69,613822
chr1,40112140,0.13,8,54,62,613823
chr1,40112204,0.39,17,27,44,613824
chr1,40112391,0.07,5,70,75,613825
chr1,40112410,0.12,9,64,73,613826
chr1,40112494,0.1,9,81,90,613827
chr1,40112541,0.14,9,55,64,613828
chr1,40112609,0.1,6,57,63,613829
chr1,40112624,0.1,6,57,63,613830
chr1,40112632,0.1,5,46,51,613831
chr1,40112763,0.21,6,23,29,613832
chr1,40112772,0.36,9,16,25,613833
chr1,40112814,0.59,23,16,39,613834
chr1,40112921,0.22,16,58,74,613835
chr1,40113237,0.94,81,5,86,613836
chr1,40113273,0.89,91,11,102,613837
chr1,40113487,0.94,60,4,64,613838
chr1,40114206,0.75,48,16,64,613839
chr1,40114369,0.7,74,31,105,613840
chr1,40114634,0.97,59,2,61,613841
chr1,40114636,0.98,59,1,60,613842
chr1,40114646,1,64,0,64,613843
chr1,40114674,1,65,0,65,613844
chr1,40114679,0.95,60,3,63,613845
chr1,40114851,0.98,57,1,58,613846
chr1,40114856,0.98,60,1,61,613847
chr1,40114864,0.97,58,2,60,613848
chr1,40114894,1,71,0,71,613849
chr1,40114972,0.81,61,14,75,613850
chr1,40115114,0.97,93,3,96,613851
chr1,40115196,0.88,67,9,76,613852
chr1,40115246,0.95,53,3,56,613853
chr1,40115257,0.98,60,1,61,613854
chr1,40115300,0.85,50,9,59,613855
chr1,40115302,0.98,59,1,60,613856
chr1,40115306,0.98,61,1,62,613857
chr1,40115439,0.76,37,12,49,613858
chr1,40115513,0.43,16,21,37,613859
chr1,40115801,0.97,83,3,86,613860
chr1,40115998,0.96,44,2,46,613861
chr1,40116117,1,55,0,55,613862
chr1,40116655,0.98,51,1,52,613863
chr1,40116722,0.99,94,1,95,613864
chr1,40116797,0.96,79,3,82,613865
chr1,40116823,0.97,75,2,77,613866
chr1,40116895,0.99,71,1,72,613867
chr1,40117074,0.79,62,16,78,613868
chr1,40117162,0.85,68,12,80,613869
chr1,40117189,0.96,75,3,78,613870
chr1,40117329,0.97,96,3,99,613871
chr1,40117341,0.94,96,6,102,613872
chr1,40117392,0.98,83,2,85,613873
chr1,40117416,0.96,71,3,74,613874
chr1,40117423,0.46,35,41,76,613875
chr1,40117439,0.94,68,4,72,613876
chr1,40117499,1,46,0,46,613877
chr1,40117571,0.92,46,4,50,613878
chr1,40117634,0.7,44,19,63,613879
chr1,40117697,0.08,3,37,40,613880
chr1,40117754,0.18,10,47,57,613881
chr1,40117893,0.25,28,86,114,613882
chr1,40117919,0.05,5,102,107,613883
chr1,40117926,0.05,4,84,88,613884
chr1,40118030,0.09,4,39,43,613885
chr1,40118039,0.07,4,52,56,613886
chr1,40118075,0.08,6,65,71,613887
chr1,40118151,0.33,26,53,79,613888
chr1,40118281,0.76,71,23,94,613889
chr1,40118596,0.98,59,1,60,613890
chr1,40118691,0.9,47,5,52,613891
chr1,40118734,0.26,10,28,38,613892
chr1,40118913,0.46,32,37,69,613893
chr1,40118936,0.84,54,10,64,613894
chr1,40119115,0.13,14,96,110,613895
chr1,40119119,0.19,21,88,109,613896
chr1,40119125,0.14,15,96,111,613897
chr1,40119189,0.17,20,98,118,613898
chr1,40119202,0.02,2,114,116,613899
chr1,40119207,0.01,1,118,119,613900
chr1,40119214,0,0,122,122,613901
chr1,40119276,0,0,108,108,613902
chr1,40119292,0.01,1,85,86,613903
chr1,40119362,0,0,59,59,613904
chr1,40119367,0,0,60,60,613905
chr1,40119436,0.02,1,40,41,613906
chr1,40119451,0.03,1,38,39,613907
chr1,40119462,0,0,54,54,613908
chr1,40119641,0.12,8,59,67,613909
chr1,40119730,0.5,34,34,68,613910
chr1,40119757,0.88,51,7,58,613911
chr1,40119881,0.38,23,38,61,613912
chr1,40119960,0.97,77,2,79,613913
chr1,40119975,0.84,72,14,86,613914
chr1,40119989,0.69,60,27,87,613915
chr1,40119992,0.82,70,15,85,613916
chr1,40120041,0.72,79,31,110,613917
chr1,40120102,0.95,102,5,107,613918
chr1,40120156,0.6,55,37,92,613919
chr1,40120303,0.81,96,23,119,613920
chr1,40120385,0.88,90,12,102,613921
chr1,40120466,0.94,118,8,126,613922
chr1,40120674,0.76,34,11,45,613923
chr1,40120682,0.78,42,12,54,613924
chr1,40120699,0.95,57,3,60,613925
chr1,40120706,0.91,58,6,64,613926
chr1,40120738,0.98,54,1,55,613927
chr1,40120758,0.92,49,4,53,613928
chr1,40120770,0.95,59,3,62,613929
chr1,40120802,0.9,44,5,49,613930
chr1,40120833,0.86,44,7,51,613931
chr1,40120858,0.88,57,8,65,613932
chr1,40120959,0.73,89,33,122,613933
chr1,40121066,0.58,49,35,84,613934
chr1,40121414,0.89,96,12,108,613935
chr1,40121454,0.68,83,39,122,613936
chr1,40121484,0.35,44,82,126,613937
chr1,40121508,0.62,66,40,106,613938
chr1,40121884,0.27,18,49,67,613939
chr1,40122026,0.45,51,63,114,613940
chr1,40122365,0.91,121,12,133,613941
chr1,40122432,0.5,59,59,118,613942
chr1,40122487,0.24,16,50,66,613943
chr1,40122664,0.19,19,83,102,613944
chr1,40122731,0.4,44,65,109,613945
chr1,40122919,0.48,49,54,103,613946
chr1,40122937,0.74,71,25,96,613947
chr1,40123317,0.96,79,3,82,613948
chr1,40123355,0.87,46,7,53,613949
chr1,40123384,0.93,52,4,56,613950
chr1,40123646,0.96,76,3,79,613951
chr1,40123717,0.27,25,67,92,613952
chr1,40123813,0,0,84,84,613953
chr1,40123868,0,0,78,78,613954
chr1,40123916,0.03,2,71,73,613955
chr1,40124050,0.25,9,27,36,613956
chr1,40124288,0.97,89,3,92,613957
chr1,40124637,0.87,72,11,83,613958
chr1,40124739,0.83,62,13,75,613959
chr1,40124782,0.9,60,7,67,613960
chr1,40124830,0.93,56,4,60,613961
chr1,40124833,0.88,58,8,66,613962
chr1,40124867,0.98,80,2,82,613963
chr1,40124935,0.93,69,5,74,613964
chr1,40124964,0.99,73,1,74,613965
chr1,40125010,0.99,79,1,80,613966
chr1,40125028,0.91,64,6,70,613967
chr1,40125035,0.91,70,7,77,613968
chr1,40125052,0.89,63,8,71,613969
chr1,40125073,0.69,52,23,75,613970
chr1,40125091,0.84,62,12,74,613971
chr1,40125322,0.95,77,4,81,613972
chr1,40125324,0.92,76,7,83,613973
chr1,40125467,0.9,87,10,97,613974
chr1,40125520,0.95,89,5,94,613975
chr1,40125596,0.69,60,27,87,613976
chr1,40125725,0.7,71,30,101,613977
chr1,40125782,0.55,64,52,116,613978
chr1,40125798,0.9,110,12,122,613979
chr1,40125903,0.86,96,16,112,613980
chr1,40125942,0.95,96,5,101,613981
chr1,40125991,0.75,73,24,97,613982
chr1,40126232,0.9,54,6,60,613983
chr1,40126315,0.78,21,6,27,613984
chr1,40126438,0.86,60,10,70,613985
chr1,40126623,0.74,46,16,62,613986
chr1,40126771,0.82,50,11,61,613987
chr1,40126789,0.92,60,5,65,613988
chr1,40126797,0.95,62,3,65,613989
chr1,40126807,0.94,63,4,67,613990
chr1,40126819,0.91,59,6,65,613991
chr1,40126824,1,65,0,65,613992
chr1,40126829,1,67,0,67,613993
chr1,40126834,0.88,61,8,69,613994
chr1,40126838,0.92,65,6,71,613995
chr1,40126849,0.99,81,1,82,613996
chr1,40126852,0.96,67,3,70,613997
chr1,40126861,0.95,77,4,81,613998
chr1,40126870,0.93,76,6,82,613999
chr1,40126872,0.97,77,2,79,614000
chr1,40126930,0.9,65,7,72,614001
chr1,40127332,0.88,50,7,57,614002
chr1,40127345,0.92,56,5,61,614003
chr1,40127380,0.83,55,11,66,614004
chr1,40127525,0.86,74,12,86,614005
chr1,40127540,0.88,74,10,84,614006
chr1,40127590,0.9,73,8,81,614007
chr1,40127791,0.46,32,38,70,614008
chr1,40128041,0.37,26,45,71,614009
chr1,40128398,0.89,50,6,56,614010
chr1,40128405,0.74,42,15,57,614011
chr1,40128449,0.9,60,7,67,614012
chr1,40128904,0.92,47,4,51,614013
chr1,40129001,0.98,58,1,59,614014
chr1,40129012,0.95,62,3,65,614015
chr1,40129017,0.94,61,4,65,614016
chr1,40129063,0.92,73,6,79,614017
chr1,40129095,0.96,69,3,72,614018
chr1,40129209,0.92,71,6,77,614019
chr1,40129220,0.91,64,6,70,614020
chr1,40129286,0.87,74,11,85,614021
chr1,40129369,0.98,94,2,96,614022
chr1,40129458,0.81,69,16,85,614023
chr1,40129508,0.49,31,32,63,614024
chr1,40129538,0.95,55,3,58,614025
chr1,40129547,0.95,59,3,62,614026
chr1,40129598,1,78,0,78,614027
chr1,40129613,0.86,70,11,81,614028
chr1,40129670,0.96,85,4,89,614029
chr1,40129708,0.91,70,7,77,614030
chr1,40129838,0.93,28,2,30,614031
chr1,40129864,0.83,15,3,18,614032
chr1,40129886,0.96,22,1,23,614033
chr1,40129894,0.81,22,5,27,614034
chr1,40129911,1,33,0,33,614035
chr1,40129918,1,40,0,40,614036
chr1,40129926,0.69,34,15,49,614037
chr1,40129950,0.95,62,3,65,614038
chr1,40129985,0.91,92,9,101,614039
chr1,40130016,0.87,68,10,78,614040
chr1,40130019,0.78,68,19,87,614041
chr1,40130026,0.7,57,24,81,614042
chr1,40130054,0.91,64,6,70,614043
chr1,40130064,1,67,0,67,614044
chr1,40130069,0.98,54,1,55,614045
chr1,40130107,0.72,41,16,57,614046
chr1,40130233,0.95,36,2,38,614047
chr1,40130257,0.88,53,7,60,614048
chr1,40130289,0.89,76,9,85,614049
chr1,40130313,0.95,84,4,88,614050
chr1,40130387,0.98,107,2,109,614051
chr1,40130407,0.97,109,3,112,614052
chr1,40130450,0.96,107,4,111,614053
chr1,40130476,0.96,99,4,103,614054
chr1,40130595,0.98,43,1,44,614055
chr1,40130872,0.87,73,11,84,614056
chr1,40131060,0.88,59,8,67,614057
chr1,40131219,0.98,53,1,54,614058
chr1,40131256,0.94,49,3,52,614059
chr1,40131262,0.91,48,5,53,614060
chr1,40131268,0.81,42,10,52,614061
chr1,40131294,0.96,48,2,50,614062
chr1,40131300,0.93,54,4,58,614063
chr1,40131310,0.81,47,11,58,614064
chr1,40131487,0.94,44,3,47,614065
chr1,40131500,0.96,44,2,46,614066
chr1,40131518,0.98,50,1,51,614067
chr1,40131548,0.82,46,10,56,614068
chr1,40131700,0.78,47,13,60,614069
chr1,40131706,0.96,47,2,49,614070
chr1,40131764,0.58,41,30,71,614071
chr1,40131779,0.88,74,10,84,614072
chr1,40131802,0.97,99,3,102,614073
chr1,40131806,0.95,103,5,108,614074
chr1,40131818,0.98,112,2,114,614075
chr1,40131828,0.94,108,7,115,614076
chr1,40131848,0.92,102,9,111,614077
chr1,40131856,0.95,105,5,110,614078
chr1,40131868,0.92,102,9,111,614079
chr1,40131881,0.94,93,6,99,614080
chr1,40132080,0.79,77,21,98,614081
chr1,40132223,0.62,51,31,82,614082
chr1,40132565,0.92,110,9,119,614083
chr1,40132572,0.93,113,8,121,614084
chr1,40132611,0.83,93,19,112,614085
chr1,40132972,0.94,77,5,82,614086
chr1,40133022,0.96,73,3,76,614087
chr1,40133238,0.84,100,19,119,614088
chr1,40133333,0.91,96,10,106,614089
chr1,40133581,0.79,71,19,90,614090
chr1,40134029,0.49,19,20,39,614091
chr1,40134120,0.43,26,34,60,614092
chr1,40134144,0.21,20,76,96,614093
chr1,40134264,0.71,49,20,69,614094
chr1,40134354,0.92,67,6,73,614095
chr1,40134416,0.9,94,10,104,614096
chr1,40134441,0.78,95,27,122,614097
chr1,40134695,0.22,13,47,60,614098
chr1,40134880,0.21,20,74,94,614099
chr1,40134962,0.6,58,39,97,614100
chr1,40135127,0.64,50,28,78,614101
chr1,40135347,0.98,42,1,43,614102
chr1,40135513,0.94,81,5,86,614103
chr1,40135858,0.95,126,7,133,614104
chr1,40135895,0.91,131,13,144,614105
chr1,40136027,0.96,94,4,98,614106
chr1,40136189,0.85,56,10,66,614107
chr1,40136494,0.27,25,66,91,614108
chr1,40136763,0.28,22,57,79,614109
chr1,40136786,0.27,23,63,86,614110
chr1,40136907,0.03,2,69,71,614111
chr1,40136928,0,0,70,70,614112
chr1,40136967,0.04,2,54,56,614113
chr1,40136989,0.1,4,38,42,614114
chr1,40137002,0.05,2,41,43,614115
chr1,40137012,0.06,1,17,18,614116
chr1,40137015,0.07,3,42,45,614117
chr1,40137019,0.03,1,34,35,614118
chr1,40137029,0.06,3,46,49,614119
chr1,40137080,0,0,43,43,614120
chr1,40137082,0.02,1,44,45,614121
chr1,40137089,0.03,1,34,35,614122
chr1,40137136,0,0,69,69,614123
chr1,40137152,0.01,1,76,77,614124
chr1,40137159,0.03,2,77,79,614125
chr1,40137173,0.04,3,67,70,614126
chr1,40137180,0.04,3,72,75,614127
chr1,40137185,0.02,1,54,55,614128
chr1,40137200,0,0,70,70,614129
chr1,40137223,0.03,2,57,59,614130
chr1,40137225,0,0,51,51,614131
chr1,40137234,0.03,1,30,31,614132
chr1,40137246,0,0,50,50,614133
chr1,40137251,0.03,2,56,58,614134
chr1,40137262,0,0,49,49,614135
chr1,40137279,0.04,2,46,48,614136
chr1,40137281,0,0,39,39,614137
chr1,40137288,0,0,60,60,614138
chr1,40137291,0,0,47,47,614139
chr1,40137296,0,0,57,57,614140
chr1,40137319,0.02,1,40,41,614141
chr1,40137368,0,0,28,28,614142
chr1,40137377,0,0,41,41,614143
chr1,40137384,0,0,36,36,614144
chr1,40137425,0,0,24,24,614145
chr1,40137431,0,0,25,25,614146
chr1,40137433,0,0,24,24,614147
chr1,40137447,0,0,21,21,614148
chr1,40137470,0,0,26,26,614149
chr1,40137488,0,0,19,19,614150
chr1,40137493,0,0,33,33,614151
chr1,40137528,0,0,48,48,614152
chr1,40137545,0,0,56,56,614153
chr1,40137552,0.02,1,55,56,614154
chr1,40137560,0.02,1,61,62,614155
chr1,40137576,0,0,71,71,614156
chr1,40137597,0,0,52,52,614157
chr1,40137599,0.03,2,60,62,614158
chr1,40137608,0,0,73,73,614159
chr1,40137636,0,0,80,80,614160
chr1,40137642,0.01,1,67,68,614161
chr1,40137647,0,0,74,74,614162
chr1,40137654,0,0,65,65,614163
chr1,40137665,0,0,72,72,614164
chr1,40137671,0,0,73,73,614165
chr1,40137673,0,0,70,70,614166
chr1,40137691,0,0,80,80,614167
chr1,40137715,0,0,66,66,614168
chr1,40137726,0,0,60,60,614169
chr1,40137731,0,0,58,58,614170
chr1,40137744,0,0,40,40,614171
chr1,40137747,0.03,1,30,31,614172
chr1,40137750,0,0,28,28,614173
chr1,40137756,0,0,38,38,614174
chr1,40137758,0,0,42,42,614175
chr1,40137792,0,0,4,4,614176
chr1,40137799,0,0,16,16,614177
chr1,40137802,0,0,9,9,614178
chr1,40137815,0,0,11,11,614179
chr1,40137822,0,0,20,20,614180
chr1,40137825,0.11,2,16,18,614181
chr1,40137838,0,0,27,27,614182
chr1,40137856,0,0,29,29,614183
chr1,40137860,0,0,34,34,614184
chr1,40137863,0.03,1,37,38,614185
chr1,40137867,0,0,25,25,614186
chr1,40137892,0.05,2,42,44,614187
chr1,40137896,0.03,1,36,37,614188
chr1,40137900,0,0,47,47,614189
chr1,40137907,0,0,50,50,614190
chr1,40137913,0,0,44,44,614191
chr1,40137935,0,0,41,41,614192
chr1,40137966,0,0,33,33,614193
chr1,40137970,0.04,1,26,27,614194
chr1,40137977,0.04,1,23,24,614195
chr1,40137987,0.03,1,30,31,614196
chr1,40138038,0.03,1,38,39,614197
chr1,40138052,0.03,1,38,39,614198
chr1,40138068,0,0,48,48,614199
chr1,40138074,0,0,30,30,614200
chr1,40138084,0.07,2,27,29,614201
chr1,40138086,0.05,2,36,38,614202
chr1,40138162,0.69,27,12,39,614203
chr1,40138225,0.18,11,50,61,614204
chr1,40138242,0.1,7,65,72,614205
chr1,40138257,0.11,7,54,61,614206
chr1,40138264,0.07,4,57,61,614207
chr1,40138319,0.35,26,48,74,614208
chr1,40138344,0.33,21,43,64,614209
chr1,40138402,0.38,27,44,71,614210
chr1,40138417,0.2,15,59,74,614211
chr1,40138475,0.41,33,48,81,614212
chr1,40138511,0.85,51,9,60,614213
chr1,40138513,0.78,52,15,67,614214
chr1,40138602,0.68,54,25,79,614215
chr1,40139111,0.79,76,20,96,614216
chr1,40139201,0.95,99,5,104,614217
chr1,40139240,0.99,88,1,89,614218
chr1,40139346,0.96,82,3,85,614219
chr1,40139620,0.97,104,3,107,614220
chr1,40139763,0.98,106,2,108,614221
chr1,40139816,0.98,82,2,84,614222
chr1,40139819,0.98,81,2,83,614223
chr1,40139926,1,42,0,42,614224
chr1,40140078,0.97,71,2,73,614225
chr1,40140176,0.98,107,2,109,614226
chr1,40140498,0.95,39,2,41,614227
chr1,40140627,0.91,84,8,92,614228
chr1,40140632,0.8,71,18,89,614229
chr1,40140638,0.98,82,2,84,614230
chr1,40140676,0.91,64,6,70,614231
chr1,40140783,0.97,65,2,67,614232
chr1,40140835,0.29,23,55,78,614233
chr1,40140859,0.17,10,50,60,614234
chr1,40140868,0.16,8,41,49,614235
chr1,40140878,0.33,14,29,43,614236
chr1,40140900,0.36,16,29,45,614237
chr1,40141323,0.97,77,2,79,614238
chr1,40141428,0.79,34,9,43,614239
chr1,40141434,0.79,31,8,39,614240
chr1,40141451,1,21,0,21,614241
chr1,40141458,1,16,0,16,614242
chr1,40141466,0.88,7,1,8,614243
chr1,40141556,1,4,0,4,614244
chr1,40141567,1,8,0,8,614245
chr1,40141587,1,13,0,13,614246
chr1,40141612,0.96,23,1,24,614247
chr1,40141617,1,30,0,30,614248
chr1,40141655,0.91,49,5,54,614249
chr1,40141665,0.88,57,8,65,614250
chr1,40141712,0.78,80,23,103,614251
chr1,40141839,0.96,49,2,51,614252
chr1,40141845,0.8,41,10,51,614253
chr1,40141883,0.97,59,2,61,614254
chr1,40141888,0.97,58,2,60,614255
chr1,40141907,0.93,57,4,61,614256
chr1,40141915,0.96,53,2,55,614257
chr1,40141917,0.94,51,3,54,614258
chr1,40141985,0.95,36,2,38,614259
chr1,40142009,0.84,31,6,37,614260
chr1,40142041,0.68,46,22,68,614261
chr1,40142048,0.95,62,3,65,614262
chr1,40142071,0.4,27,40,67,614263
chr1,40142104,0.76,25,8,33,614264
chr1,40142240,0.23,25,83,108,614265
chr1,40142254,0.19,22,93,115,614266
chr1,40142445,0.67,64,32,96,614267
chr1,40142456,0.85,88,16,104,614268
chr1,40142734,0.95,37,2,39,614269
chr1,40142811,0.24,13,41,54,614270
chr1,40142887,0.87,61,9,70,614271
chr1,40143072,0.98,82,2,84,614272
chr1,40143089,0.94,81,5,86,614273
chr1,40143213,1,73,0,73,614274
chr1,40143233,0.97,74,2,76,614275
chr1,40143291,0.99,83,1,84,614276
chr1,40143302,0.86,82,13,95,614277
chr1,40143335,0.94,73,5,78,614278
chr1,40143407,0.89,90,11,101,614279
chr1,40143520,0.97,117,4,121,614280
chr1,40143617,0.69,73,33,106,614281
chr1,40143868,0.54,46,39,85,614282
chr1,40143874,0.97,85,3,88,614283
chr1,40143891,1,94,0,94,614284
chr1,40143949,0.93,84,6,90,614285
chr1,40143969,1,78,0,78,614286
chr1,40144027,0.99,67,1,68,614287
chr1,40144033,0.91,59,6,65,614288
chr1,40144093,0.88,50,7,57,614289
chr1,40144620,0.76,78,24,102,614290
chr1,40144890,1,46,0,46,614291
chr1,40145297,0.41,35,51,86,614292
chr1,40145326,0.92,65,6,71,614293
chr1,40145583,0.78,83,23,106,614294
chr1,40145650,0.48,45,49,94,614295
chr1,40146102,0.95,96,5,101,614296
chr1,40146228,0.95,108,6,114,614297
chr1,40146593,0.83,95,20,115,614298
chr1,40146660,0.87,118,17,135,614299
chr1,40146693,0.83,120,25,145,614300
chr1,40146760,0.9,137,15,152,614301
chr1,40146929,0.84,72,14,86,614302
chr1,40147050,0.85,93,17,110,614303
chr1,40147065,0.93,106,8,114,614304
chr1,40147132,0.83,99,20,119,614305
chr1,40147465,0.65,68,37,105,614306
chr1,40147498,0.7,67,29,96,614307
chr1,40147597,0.88,81,11,92,614308
chr1,40147723,0.95,75,4,79,614309
chr1,40148294,0.94,102,6,108,614310
chr1,40148335,0.9,107,12,119,614311
chr1,40148346,0.98,107,2,109,614312
chr1,40148354,0.95,105,6,111,614313
chr1,40148368,0.99,105,1,106,614314
chr1,40148381,0.95,89,5,94,614315
chr1,40148452,0.99,75,1,76,614316
chr1,40148462,0.93,69,5,74,614317
chr1,40148585,0.94,50,3,53,614318
chr1,40148616,0.95,52,3,55,614319
chr1,40148618,0.51,24,23,47,614320
chr1,40148624,0.98,56,1,57,614321
chr1,40148712,0.95,86,5,91,614322
chr1,40148717,0.98,89,2,91,614323
chr1,40148744,0.97,75,2,77,614324
chr1,40148764,0.98,78,2,80,614325
chr1,40148775,0.99,75,1,76,614326
chr1,40148801,0.93,54,4,58,614327
chr1,40148835,0.9,46,5,51,614328
chr1,40148847,0.96,47,2,49,614329
chr1,40148922,0.74,37,13,50,614330
chr1,40148956,0.98,50,1,51,614331
chr1,40149006,0.47,24,27,51,614332
chr1,40149046,0.87,53,8,61,614333
chr1,40149077,0.97,73,2,75,614334
chr1,40149166,0.87,91,14,105,614335
chr1,40149168,0.97,100,3,103,614336
chr1,40149213,0.21,27,100,127,614337
chr1,40149224,0.22,29,104,133,614338
chr1,40149301,0.45,56,68,124,614339
chr1,40149381,0.04,4,100,104,614340
chr1,40149385,0.04,4,101,105,614341
chr1,40149432,0.2,11,45,56,614342
chr1,40149437,0.04,4,85,89,614343
chr1,40149440,0.02,2,81,83,614344
chr1,40149447,0.01,1,77,78,614345
chr1,40149465,0.06,4,68,72,614346
chr1,40149476,0.27,18,48,66,614347
chr1,40149491,0.79,41,11,52,614348
chr1,40149497,0.56,34,27,61,614349
chr1,40149525,0.56,27,21,48,614350
chr1,40149532,0.59,26,18,44,614351
chr1,40149541,0.68,28,13,41,614352
chr1,40149543,0.76,32,10,42,614353
chr1,40149555,0.84,21,4,25,614354
chr1,40149564,0.66,21,11,32,614355
chr1,40149569,0.75,27,9,36,614356
chr1,40149578,0.31,15,33,48,614357
chr1,40149590,0.72,36,14,50,614358
chr1,40149594,0.58,34,25,59,614359
chr1,40149596,0.32,18,38,56,614360
chr1,40149598,0.65,37,20,57,614361
chr1,40149604,0.59,41,28,69,614362
chr1,40149611,0.17,14,67,81,614363
chr1,40149634,0.7,52,22,74,614364
chr1,40149636,0.54,42,36,78,614365
chr1,40149643,0.83,66,14,80,614366
chr1,40149647,0.63,50,29,79,614367
chr1,40149650,0.53,43,38,81,614368
chr1,40149653,0.54,48,41,89,614369
chr1,40149662,0.41,36,51,87,614370
chr1,40149695,0.41,37,54,91,614371
chr1,40149704,0.35,30,55,85,614372
chr1,40149706,0.41,34,49,83,614373
chr1,40149717,0.7,59,25,84,614374
chr1,40149725,0.91,74,7,81,614375
chr1,40149739,0.58,52,38,90,614376
chr1,40149746,0.35,29,55,84,614377
chr1,40149755,0.49,37,39,76,614378
chr1,40149758,0.62,39,24,63,614379
chr1,40149761,0.32,22,47,69,614380
chr1,40149770,0.38,24,40,64,614381
chr1,40149778,0.86,49,8,57,614382
chr1,40149785,0.92,45,4,49,614383
chr1,40149792,0.78,31,9,40,614384
chr1,40149794,0.78,32,9,41,614385
chr1,40149806,0.74,25,9,34,614386
chr1,40149809,0.71,20,8,28,614387
chr1,40149812,0.4,14,21,35,614388
chr1,40149837,0.29,4,10,14,614389
chr1,40149850,0.73,11,4,15,614390
chr1,40149855,0.44,8,10,18,614391
chr1,40149864,0.4,4,6,10,614392
chr1,40149873,0.57,4,3,7,614393
chr1,40149905,0,0,8,8,614394
chr1,40149914,0.88,7,1,8,614395
chr1,40149929,0,0,7,7,614396
chr1,40149944,0.88,7,1,8,614397
chr1,40149952,0.33,3,6,9,614398
chr1,40149977,0.13,2,13,15,614399
chr1,40149986,1,14,0,14,614400
chr1,40150003,0.74,17,6,23,614401
chr1,40150012,0.96,24,1,25,614402
chr1,40150052,0.85,39,7,46,614403
chr1,40150060,0.98,46,1,47,614404
chr1,40150074,0.65,43,23,66,614405
chr1,40150103,0.97,77,2,79,614406
chr1,40150107,1,80,0,80,614407
chr1,40150155,0.9,82,9,91,614408
chr1,40150206,0.97,86,3,89,614409
chr1,40150245,0.88,68,9,77,614410
chr1,40150278,0.95,54,3,57,614411
chr1,40150306,0.95,41,2,43,614412
chr1,40150468,0.78,51,14,65,614413
chr1,40150479,1,63,0,63,614414
chr1,40150513,0.96,67,3,70,614415
chr1,40150522,0.95,39,2,41,614416
chr1,40150987,0.81,59,14,73,614417
chr1,40151076,0.61,57,37,94,614418
chr1,40151134,0.99,83,1,84,614419
chr1,40151267,0.98,58,1,59,614420
chr1,40151269,0.98,57,1,58,614421
chr1,40151273,0.98,62,1,63,614422
chr1,40151279,0.94,61,4,65,614423
chr1,40151333,0.97,77,2,79,614424
chr1,40151367,0.87,74,11,85,614425
chr1,40151412,0.99,75,1,76,614426
chr1,40151415,0.91,69,7,76,614427
chr1,40151424,0.97,67,2,69,614428
chr1,40151444,0.98,65,1,66,614429
chr1,40151468,0.96,53,2,55,614430
chr1,40151506,0.97,29,1,30,614431
chr1,40151508,1,29,0,29,614432
chr1,40151575,0.94,29,2,31,614433
chr1,40151579,0.94,29,2,31,614434
chr1,40151591,0.94,31,2,33,614435
chr1,40151635,0.92,22,2,24,614436
chr1,40151721,1,65,0,65,614437
chr1,40151725,0.75,41,14,55,614438
chr1,40151784,0.99,82,1,83,614439
chr1,40151793,0.62,40,25,65,614440
chr1,40151801,0.98,55,1,56,614441
chr1,40151807,1,52,0,52,614442
chr1,40151831,0.95,35,2,37,614443
chr1,40151847,0.96,22,1,23,614444
chr1,40152001,0.94,72,5,77,614445
chr1,40152116,0.64,58,32,90,614446
chr1,40152153,0.92,88,8,96,614447
chr1,40152163,0.9,86,10,96,614448
chr1,40152179,0.74,73,25,98,614449
chr1,40152347,0.92,60,5,65,614450
chr1,40152627,0.86,66,11,77,614451
chr1,40152904,0.98,39,1,40,614452
chr1,40153088,0.88,53,7,60,614453
chr1,40153179,0.48,23,25,48,614454
chr1,40153523,0.89,80,10,90,614455
chr1,40153543,0.81,61,14,75,614456
chr1,40153625,0.88,66,9,75,614457
chr1,40153746,0.92,49,4,53,614458
chr1,40153767,0.81,44,10,54,614459
chr1,40153860,0.94,68,4,72,614460
chr1,40153961,0.96,66,3,69,614461
chr1,40154021,0.88,51,7,58,614462
chr1,40154162,0.73,80,29,109,614463
chr1,40154268,0.96,51,2,53,614464
chr1,40154363,0.94,60,4,64,614465
chr1,40154392,0.94,72,5,77,614466
chr1,40154431,0.93,75,6,81,614467
chr1,40154614,0.56,62,49,111,614468
chr1,40154803,0.95,75,4,79,614469
chr1,40154993,0.9,63,7,70,614470
chr1,40155049,0.87,41,6,47,614471
chr1,40155811,0.95,21,1,22,614472
chr1,40156108,0.68,58,27,85,614473
chr1,40156256,0.82,50,11,61,614474
chr1,40156301,0.89,57,7,64,614475
chr1,40156367,0.96,64,3,67,614476
chr1,40156486,1,38,0,38,614477
chr1,40156554,0.43,20,26,46,614478
chr1,40156623,0.51,21,20,41,614479
chr1,40156642,0.64,28,16,44,614480
chr1,40156698,0.84,58,11,69,614481
chr1,40156700,0.6,41,27,68,614482
chr1,40156757,0.63,37,22,59,614483
chr1,40156840,0.06,2,30,32,614484
chr1,40156849,0.07,2,25,27,614485
chr1,40156857,0,0,40,40,614486
chr1,40156931,0.03,1,36,37,614487
chr1,40156935,0.03,1,35,36,614488
chr1,40156960,0,0,36,36,614489
chr1,40156970,0,0,32,32,614490
chr1,40156985,0.03,1,29,30,614491
chr1,40156989,0,0,26,26,614492
chr1,40156992,0,0,33,33,614493
chr1,40156997,0.03,1,32,33,614494
chr1,40157010,0,0,44,44,614495
chr1,40157017,0.02,1,46,47,614496
chr1,40157020,0,0,39,39,614497
chr1,40157025,0,0,45,45,614498
chr1,40157027,0.02,1,43,44,614499
chr1,40157034,0,0,49,49,614500
chr1,40157045,0.02,1,50,51,614501
chr1,40157047,0,0,53,53,614502
chr1,40157052,0,0,53,53,614503
chr1,40157077,0,0,55,55,614504
chr1,40157080,0,0,61,61,614505
chr1,40157086,0,0,43,43,614506
chr1,40157119,0,0,74,74,614507
chr1,40157125,0,0,66,66,614508
chr1,40157146,0.02,1,48,49,614509
chr1,40157156,0.01,1,72,73,614510
chr1,40157169,0.01,1,67,68,614511
chr1,40157190,0.02,1,61,62,614512
chr1,40157202,0,0,39,39,614513
chr1,40157221,0.02,1,53,54,614514
chr1,40157229,0,0,51,51,614515
chr1,40157232,0,0,40,40,614516
chr1,40157239,0,0,56,56,614517
chr1,40157243,0,0,54,54,614518
chr1,40157251,0,0,26,26,614519
chr1,40157253,0,0,19,19,614520
chr1,40157258,0,0,50,50,614521
chr1,40157266,0,0,56,56,614522
chr1,40157268,0,0,55,55,614523
chr1,40157280,0,0,66,66,614524
chr1,40157286,0,0,53,53,614525
chr1,40157289,0,0,70,70,614526
chr1,40157296,0.02,1,57,58,614527
chr1,40157344,0,0,60,60,614528
chr1,40157372,0,0,51,51,614529
chr1,40157375,0.04,2,50,52,614530
chr1,40157407,0,0,44,44,614531
chr1,40157421,0,0,36,36,614532
chr1,40157436,0.04,1,27,28,614533
chr1,40157480,0,0,6,6,614534
chr1,40157534,0,0,16,16,614535
chr1,40157618,0,0,16,16,614536
chr1,40157633,0,0,13,13,614537
chr1,40157650,0,0,9,9,614538
chr1,40157653,0,0,12,12,614539
chr1,40157681,0.13,2,13,15,614540
chr1,40157683,0.05,1,18,19,614541
chr1,40157685,0,0,19,19,614542
chr1,40157692,0,0,16,16,614543
chr1,40157694,0,0,23,23,614544
chr1,40157706,0,0,23,23,614545
chr1,40157731,0,0,27,27,614546
chr1,40157733,0.04,1,26,27,614547
chr1,40157740,0.03,1,31,32,614548
chr1,40157778,0,0,41,41,614549
chr1,40157793,0,0,37,37,614550
chr1,40157833,0,0,46,46,614551
chr1,40157835,0,0,52,52,614552
chr1,40157845,0.03,2,59,61,614553
chr1,40157892,0.03,2,64,66,614554
chr1,40157900,0.02,1,62,63,614555
chr1,40157905,0,0,62,62,614556
chr1,40157911,0.01,1,67,68,614557
chr1,40157917,0,0,67,67,614558
chr1,40157928,0,0,53,53,614559
chr1,40157931,0,0,60,60,614560
chr1,40157941,0,0,71,71,614561
chr1,40157947,0,0,74,74,614562
chr1,40157965,0,0,85,85,614563
chr1,40157970,0,0,71,71,614564
chr1,40157984,0.02,2,82,84,614565
chr1,40158008,0.01,1,84,85,614566
chr1,40158025,0.01,1,83,84,614567
chr1,40158050,0,0,87,87,614568
chr1,40158055,0,0,79,79,614569
chr1,40158059,0,0,69,69,614570
chr1,40158076,0.02,1,61,62,614571
chr1,40158157,0.01,1,92,93,614572
chr1,40158169,0,0,90,90,614573
chr1,40158173,0,0,86,86,614574
chr1,40158199,0,0,84,84,614575
chr1,40158206,0,0,81,81,614576
chr1,40158211,0.05,2,40,42,614577
chr1,40158215,0.03,2,70,72,614578
chr1,40158235,0.01,1,67,68,614579
chr1,40158240,0.02,1,57,58,614580
chr1,40158242,0.05,3,57,60,614581
chr1,40158246,0.02,1,62,63,614582
chr1,40158259,0.06,3,51,54,614583
chr1,40158269,0.08,3,33,36,614584
chr1,40158282,0.02,1,53,54,614585
chr1,40158284,0,0,50,50,614586
chr1,40158286,0.04,2,50,52,614587
chr1,40158289,0,0,45,45,614588
chr1,40158310,0.17,4,20,24,614589
chr1,40158315,0.07,1,14,15,614590
chr1,40158340,0,0,43,43,614591
chr1,40158342,0.03,1,39,40,614592
chr1,40158352,0.1,2,19,21,614593
chr1,40158394,0.11,5,41,46,614594
chr1,40158410,0.04,2,51,53,614595
chr1,40158416,0.02,1,50,51,614596
chr1,40158441,0.3,19,45,64,614597
chr1,40158456,0.21,13,49,62,614598
chr1,40158476,0.24,16,50,66,614599
chr1,40158484,0.66,41,21,62,614600
chr1,40158504,0.64,37,21,58,614601
chr1,40158513,0.47,28,32,60,614602
chr1,40158556,0.63,32,19,51,614603
chr1,40158558,0.67,26,13,39,614604
chr1,40158669,1,47,0,47,614605
chr1,40158708,0.98,49,1,50,614606
chr1,40158828,0.96,94,4,98,614607
chr1,40158832,0.95,91,5,96,614608
chr1,40159028,0.93,64,5,69,614609
chr1,40159186,0.99,74,1,75,614610
chr1,40159539,0.96,47,2,49,614611
chr1,40159658,0.96,49,2,51,614612
chr1,40159684,0.98,50,1,51,614613
chr1,40159700,0.94,44,3,47,614614
chr1,40160144,0.94,113,7,120,614615
chr1,40160447,0.98,86,2,88,614616
chr1,40160658,0.48,46,49,95,614617
chr1,40161043,0.22,16,56,72,614618
chr1,40161432,0.92,65,6,71,614619
chr1,40161438,0.93,57,4,61,614620
chr1,40161578,0.73,41,15,56,614621
chr1,40161580,0.91,51,5,56,614622
chr1,40161613,0.93,50,4,54,614623
chr1,40161700,0.88,72,10,82,614624
chr1,40161768,0.98,43,1,44,614625
chr1,40161775,1,44,0,44,614626
chr1,40161792,0.96,49,2,51,614627
chr1,40161800,0.94,51,3,54,614628
chr1,40161822,0.9,61,7,68,614629
chr1,40161830,0.9,65,7,72,614630
chr1,40161895,0.91,75,7,82,614631
chr1,40161907,0.95,73,4,77,614632
chr1,40161964,0.83,68,14,82,614633
chr1,40162374,0.82,58,13,71,614634
chr1,40162649,0.73,61,23,84,614635
chr1,40162713,0.85,70,12,82,614636
chr1,40162878,0.5,54,54,108,614637
chr1,40163162,0.9,104,11,115,614638
chr1,40163207,0.71,68,28,96,614639
chr1,40163565,0.8,52,13,65,614640
chr1,40163757,0.89,67,8,75,614641
chr1,40164011,0.88,59,8,67,614642
chr1,40164078,0.83,92,19,111,614643
chr1,40164090,0.8,89,22,111,614644
chr1,40164196,0.95,86,5,91,614645
chr1,40164297,0.95,54,3,57,614646
chr1,40164304,1,49,0,49,614647
chr1,40164387,0.94,61,4,65,614648
chr1,40164393,0.96,69,3,72,614649
chr1,40164858,0.85,52,9,61,614650
chr1,40165216,0.99,91,1,92,614651
chr1,40165290,0.96,91,4,95,614652
chr1,40165479,0.75,3,1,4,614653
chr1,40165555,1,61,0,61,614654
chr1,40165557,0.94,60,4,64,614655
chr1,40165647,1,65,0,65,614656
chr1,40165661,0.98,55,1,56,614657
chr1,40165699,0.9,55,6,61,614658
chr1,40165818,0.81,71,17,88,614659
chr1,40165875,0.97,88,3,91,614660
chr1,40166015,0.8,44,11,55,614661
chr1,40166020,0.93,55,4,59,614662
chr1,40166322,0.96,66,3,69,614663
chr1,40166382,0.35,22,41,63,614664
chr1,40166542,0.31,28,62,90,614665
chr1,40166787,0.03,2,71,73,614666
chr1,40166871,0.03,2,76,78,614667
chr1,40166889,0.02,1,51,52,614668
chr1,40166910,0.03,2,67,69,614669
chr1,40166978,0.03,2,71,73,614670
chr1,40167002,0,0,68,68,614671
chr1,40167015,0.05,3,53,56,614672
chr1,40167023,0.04,2,50,52,614673
chr1,40167038,0.05,2,36,38,614674
chr1,40167058,0,0,28,28,614675
chr1,40167092,0.14,3,19,22,614676
chr1,40167102,0.12,3,22,25,614677
chr1,40167156,0.08,2,23,25,614678
chr1,40167317,0.24,8,26,34,614679
chr1,40167590,0.1,6,57,63,614680
chr1,40167614,0.09,6,60,66,614681
chr1,40167634,0.07,5,68,73,614682
chr1,40167690,0.36,27,49,76,614683
chr1,40167967,0.99,71,1,72,614684
chr1,40168005,0.61,50,32,82,614685
chr1,40168008,0.73,62,23,85,614686
chr1,40168926,0.98,79,2,81,614687
chr1,40169045,0.88,78,11,89,614688
chr1,40169088,0.93,108,8,116,614689
chr1,40169163,0.88,113,15,128,614690
chr1,40169203,0.34,40,76,116,614691
chr1,40169258,0.99,90,1,91,614692
chr1,40169380,0.98,49,1,50,614693
chr1,40169392,0.95,54,3,57,614694
chr1,40169412,0.95,59,3,62,614695
chr1,40169442,1,83,0,83,614696
chr1,40169494,0.99,82,1,83,614697
chr1,40169594,0.99,68,1,69,614698
chr1,40169638,1,68,0,68,614699
chr1,40170357,0.64,67,37,104,614700
chr1,40170569,0,0,58,58,614701
chr1,40170808,0.94,81,5,86,614702
chr1,40170840,0.95,80,4,84,614703
chr1,40170870,0.92,69,6,75,614704
chr1,40170878,0.92,73,6,79,614705
chr1,40170926,0.98,57,1,58,614706
chr1,40170968,0.72,58,23,81,614707
chr1,40170999,1,79,0,79,614708
chr1,40171012,0.95,71,4,75,614709
chr1,40171050,0.97,63,2,65,614710
chr1,40171052,1,61,0,61,614711
chr1,40171056,0.97,56,2,58,614712
chr1,40171060,0.98,59,1,60,614713
chr1,40171086,1,54,0,54,614714
chr1,40171120,0.93,42,3,45,614715
chr1,40171317,0.93,76,6,82,614716
chr1,40171400,0.85,79,14,93,614717
chr1,40171814,0.86,43,7,50,614718
chr1,40171870,0.89,56,7,63,614719
chr1,40172018,0.97,115,4,119,614720
chr1,40172038,0.97,112,3,115,614721
chr1,40172102,0.94,84,5,89,614722
chr1,40172219,0.99,79,1,80,614723
chr1,40172567,0.95,98,5,103,614724
chr1,40172576,0.98,106,2,108,614725
chr1,40172646,1,94,0,94,614726
chr1,40173017,0.72,64,25,89,614727
chr1,40173108,0.87,82,12,94,614728
chr1,40173116,0.94,92,6,98,614729
chr1,40173167,0.68,53,25,78,614730
chr1,40173373,0.86,90,15,105,614731
chr1,40173379,0.82,89,19,108,614732
chr1,40173384,0.9,100,11,111,614733
chr1,40173398,0.84,93,18,111,614734
chr1,40173581,0.89,85,11,96,614735
chr1,40173621,0.93,97,7,104,614736
chr1,40173751,0.91,63,6,69,614737
chr1,40173843,0.91,89,9,98,614738
chr1,40173884,0.76,70,22,92,614739
chr1,40174400,0.83,89,18,107,614740
chr1,40174499,0.88,83,11,94,614741
chr1,40174594,0.71,48,20,68,614742
chr1,40174978,0.95,80,4,84,614743
chr1,40175074,0.94,103,7,110,614744
chr1,40175125,0.92,97,9,106,614745
chr1,40175228,0.88,46,6,52,614746
chr1,40175310,0.98,46,1,47,614747
chr1,40175350,1,50,0,50,614748
chr1,40175420,0.94,64,4,68,614749
chr1,40175498,0.98,64,1,65,614750
chr1,40175522,0.98,50,1,51,614751
chr1,40175623,0.97,67,2,69,614752
chr1,40175686,0.99,68,1,69,614753
chr1,40175725,0.89,58,7,65,614754
chr1,40175747,0.97,72,2,74,614755
chr1,40175757,0.95,73,4,77,614756
chr1,40175790,1,81,0,81,614757
chr1,40175801,0.92,81,7,88,614758
chr1,40176031,0.83,45,9,54,614759
chr1,40176131,0.82,42,9,51,614760
chr1,40176153,0.95,60,3,63,614761
chr1,40176239,0.84,68,13,81,614762
chr1,40176249,0.9,72,8,80,614763
chr1,40176330,1,71,0,71,614764
chr1,40176372,0.92,67,6,73,614765
chr1,40176488,0.97,84,3,87,614766
chr1,40176566,0.98,93,2,95,614767
chr1,40176579,0.95,94,5,99,614768
chr1,40176643,0.92,73,6,79,614769
chr1,40176795,0.78,53,15,68,614770
chr1,40177024,0.85,90,16,106,614771
chr1,40177061,0.56,60,48,108,614772
chr1,40177116,0.58,54,39,93,614773
chr1,40177181,0.46,44,52,96,614774
chr1,40177263,0.31,35,77,112,614775
chr1,40177295,0.28,33,87,120,614776
chr1,40177322,0.34,38,73,111,614777
chr1,40177444,0.69,98,44,142,614778
chr1,40177469,0.37,54,91,145,614779
chr1,40177613,0.51,56,53,109,614780
chr1,40177619,0.57,51,38,89,614781
chr1,40177729,0.82,84,19,103,614782
chr1,40177778,0.97,105,3,108,614783
chr1,40177803,0.97,92,3,95,614784
chr1,40177891,0.88,73,10,83,614785
chr1,40177935,0.95,95,5,100,614786
chr1,40177988,0.63,51,30,81,614787
chr1,40178126,0.91,39,4,43,614788
chr1,40178663,0.97,37,1,38,614789
chr1,40178671,0.94,30,2,32,614790
chr1,40178724,0.91,39,4,43,614791
chr1,40178745,0.76,41,13,54,614792
chr1,40178999,0.98,82,2,84,614793
chr1,40179007,0.95,77,4,81,614794
chr1,40179061,0.98,46,1,47,614795
chr1,40179071,1,42,0,42,614796
chr1,40179117,1,24,0,24,614797
chr1,40179156,1,16,0,16,614798
chr1,40179195,0.83,34,7,41,614799
chr1,40179205,0.91,48,5,53,614800
chr1,40179219,0.95,57,3,60,614801
chr1,40179247,0.92,77,7,84,614802
chr1,40179256,0.93,82,6,88,614803
chr1,40179279,0.91,85,8,93,614804
chr1,40179290,0.97,94,3,97,614805
chr1,40179332,0.83,101,20,121,614806
chr1,40179694,0.83,97,20,117,614807
chr1,40179754,0.99,94,1,95,614808
chr1,40180078,0.95,59,3,62,614809
chr1,40180181,0.94,61,4,65,614810
chr1,40180198,0.95,56,3,59,614811
chr1,40180253,0.95,75,4,79,614812
chr1,40180395,0.93,53,4,57,614813
chr1,40180565,0.78,93,26,119,614814
chr1,40180738,0.89,73,9,82,614815
chr1,40180888,0.95,71,4,75,614816
chr1,40180910,0.99,73,1,74,614817
chr1,40180912,0.97,71,2,73,614818
chr1,40180920,0.97,77,2,79,614819
chr1,40180953,0.96,80,3,83,614820
chr1,40181042,0.97,74,2,76,614821
chr1,40181057,0.94,81,5,86,614822
chr1,40181062,0.98,84,2,86,614823
chr1,40181434,0.9,87,10,97,614824
chr1,40181444,0.9,87,10,97,614825
chr1,40181736,0.88,65,9,74,614826
chr1,40181758,0.91,61,6,67,614827
chr1,40181790,0.92,69,6,75,614828
chr1,40181842,1,54,0,54,614829
chr1,40181844,0.85,45,8,53,614830
chr1,40181903,0.32,8,17,25,614831
chr1,40181948,0.81,22,5,27,614832
chr1,40181953,0.86,32,5,37,614833
chr1,40181981,0.85,40,7,47,614834
chr1,40182288,0.94,89,6,95,614835
chr1,40182355,0.96,81,3,84,614836
chr1,40182491,0.96,92,4,96,614837
chr1,40182841,0.79,90,24,114,614838
chr1,40183030,0.83,91,18,109,614839
chr1,40183066,0.95,99,5,104,614840
chr1,40183423,0.95,83,4,87,614841
chr1,40183443,0.97,83,3,86,614842
chr1,40183524,0.77,59,18,77,614843
chr1,40183577,0.73,33,12,45,614844
chr1,40183657,0.87,53,8,61,614845
chr1,40183690,0.91,51,5,56,614846
chr1,40183693,0.83,45,9,54,614847
chr1,40183795,0.76,76,24,100,614848
chr1,40183905,0.73,96,36,132,614849
chr1,40183922,0.92,122,11,133,614850
chr1,40183925,0.92,122,11,133,614851
chr1,40184101,0.58,67,48,115,614852
chr1,40184690,0.86,76,12,88,614853
chr1,40184784,0.88,52,7,59,614854
chr1,40184792,0.86,59,10,69,614855
chr1,40184849,0.83,66,14,80,614856
chr1,40185140,0.87,61,9,70,614857
chr1,40185459,0.98,103,2,105,614858
chr1,40185614,0.82,75,17,92,614859
chr1,40185638,0.9,78,9,87,614860
chr1,40185924,0.02,2,85,87,614861
chr1,40186071,0.1,9,79,88,614862
chr1,40186123,0.44,49,63,112,614863
chr1,40186144,0.78,83,23,106,614864
chr1,40186183,0.16,14,71,85,614865
chr1,40186391,0.76,55,17,72,614866
chr1,40186435,0.97,88,3,91,614867
chr1,40188203,0.48,40,43,83,614868
chr1,40188363,0.2,16,64,80,614869
chr1,40188668,0.97,35,1,36,614870
chr1,40188673,1,36,0,36,614871
chr1,40188731,0.81,25,6,31,614872
chr1,40188771,0.83,50,10,60,614873
chr1,40188775,0.88,43,6,49,614874
chr1,40188834,0.98,62,1,63,614875
chr1,40188851,0.98,56,1,57,614876
chr1,40188857,0.98,55,1,56,614877
chr1,40188881,0.97,66,2,68,614878
chr1,40188896,0.95,70,4,74,614879
chr1,40189441,0.77,81,24,105,614880
chr1,40189724,0.83,91,18,109,614881
chr1,40189767,0.63,60,35,95,614882
chr1,40189805,0.94,85,5,90,614883
chr1,40189950,0.94,73,5,78,614884
chr1,40190039,0.97,67,2,69,614885
chr1,40190072,0.93,66,5,71,614886
chr1,40190384,0.84,87,16,103,614887
chr1,40190508,0.49,61,63,124,614888
chr1,40190938,0.55,22,18,40,614889
chr1,40191069,0.9,47,5,52,614890
chr1,40191121,0.85,52,9,61,614891
chr1,40191126,0.87,54,8,62,614892
chr1,40191146,0.95,69,4,73,614893
chr1,40191300,0.94,61,4,65,614894
chr1,40191343,0.94,58,4,62,614895
chr1,40191347,0.98,64,1,65,614896
chr1,40191354,0.91,63,6,69,614897
chr1,40191481,0.91,52,5,57,614898
chr1,40191541,0.94,59,4,63,614899
chr1,40191551,0.89,56,7,63,614900
chr1,40191553,0.98,61,1,62,614901
chr1,40192091,1,74,0,74,614902
chr1,40192108,0.94,84,5,89,614903
chr1,40192115,0.87,83,12,95,614904
chr1,40192258,0.93,70,5,75,614905
chr1,40192300,0.95,59,3,62,614906
chr1,40192308,0.98,59,1,60,614907
chr1,40192330,0.95,53,3,56,614908
chr1,40192988,0.69,88,39,127,614909
chr1,40193052,0.77,82,24,106,614910
chr1,40193145,0.44,24,31,55,614911
chr1,40193344,0.48,53,57,110,614912
chr1,40193376,0.91,92,9,101,614913
chr1,40193412,0.92,85,7,92,614914
chr1,40193443,0.93,74,6,80,614915
chr1,40193462,0.62,45,28,73,614916
chr1,40193545,0.72,60,23,83,614917
chr1,40193595,0.86,86,14,100,614918
chr1,40193615,0.91,85,8,93,614919
chr1,40193644,0.93,88,7,95,614920
chr1,40193662,0.52,48,45,93,614921
chr1,40193746,0.87,58,9,67,614922
chr1,40193749,0.93,66,5,71,614923
chr1,40193755,0.84,58,11,69,614924
chr1,40193795,0.61,39,25,64,614925
chr1,40193824,0.49,34,35,69,614926
chr1,40193853,0.48,38,42,80,614927
chr1,40193865,0.84,69,13,82,614928
chr1,40193875,0.9,73,8,81,614929
chr1,40193912,0.81,83,20,103,614930
chr1,40193922,0.99,100,1,101,614931
chr1,40193952,0.72,63,24,87,614932
chr1,40193992,0.72,34,13,47,614933
chr1,40194014,0.75,36,12,48,614934
chr1,40194035,0.6,27,18,45,614935
chr1,40194063,0.33,17,35,52,614936
chr1,40194131,0.81,47,11,58,614937
chr1,40194156,0.84,53,10,63,614938
chr1,40194165,0.84,54,10,64,614939
chr1,40194167,0.67,43,21,64,614940
chr1,40194177,0.7,40,17,57,614941
chr1,40194205,0.86,56,9,65,614942
chr1,40194210,0.86,56,9,65,614943
chr1,40194221,0.73,46,17,63,614944
chr1,40194299,1,77,0,77,614945
chr1,40194307,0.99,75,1,76,614946
chr1,40194311,1,70,0,70,614947
chr1,40194331,0.95,72,4,76,614948
chr1,40194376,1,66,0,66,614949
chr1,40194392,0.95,60,3,63,614950
chr1,40194414,0.93,51,4,55,614951
chr1,40194488,0.91,52,5,57,614952
chr1,40194519,0.95,58,3,61,614953
chr1,40194581,0.95,87,5,92,614954
chr1,40194629,0.99,103,1,104,614955
chr1,40194780,0.31,35,77,112,614956
chr1,40195043,0.97,113,3,116,614957
chr1,40195095,0.69,72,33,105,614958
chr1,40195110,0.92,96,8,104,614959
chr1,40195509,0.94,66,4,70,614960
chr1,40195582,0.85,83,15,98,614961
chr1,40195717,0.89,101,13,114,614962
chr1,40195818,0.48,39,42,81,614963
chr1,40196051,0.88,90,12,102,614964
chr1,40196079,0.79,97,26,123,614965
chr1,40196174,0.77,99,30,129,614966
chr1,40196205,0.9,101,11,112,614967
chr1,40196226,0.92,97,9,106,614968
chr1,40196798,0.94,95,6,101,614969
chr1,40196963,0.25,23,69,92,614970
chr1,40197417,0.8,107,27,134,614971
chr1,40197868,0.83,59,12,71,614972
chr1,40198012,0.98,48,1,49,614973
chr1,40198333,0.94,88,6,94,614974
chr1,40198360,0.93,79,6,85,614975
chr1,40198370,0.95,78,4,82,614976
chr1,40198445,0.51,36,35,71,614977
chr1,40198576,0.81,81,19,100,614978
chr1,40198629,0.61,59,38,97,614979
chr1,40198838,0.55,35,29,64,614980
chr1,40198953,0.39,30,47,77,614981
chr1,40198969,0.22,15,53,68,614982
chr1,40199017,0.28,15,39,54,614983
chr1,40199047,0.13,8,53,61,614984
chr1,40199093,0.04,4,90,94,614985
chr1,40199109,0.02,2,93,95,614986
chr1,40199350,0.48,38,41,79,614987
chr1,40199454,0.72,39,15,54,614988
chr1,40199464,0.41,21,30,51,614989
chr1,40199548,0.78,68,19,87,614990
chr1,40199572,0.79,79,21,100,614991
chr1,40199633,0.78,57,16,73,614992
chr1,40199819,0.84,68,13,81,614993
chr1,40199853,0.83,79,16,95,614994
chr1,40200244,0.9,71,8,79,614995
chr1,40200436,0.87,58,9,67,614996
chr1,40200455,0.94,62,4,66,614997
chr1,40200468,0.94,76,5,81,614998
chr1,40200486,0.71,63,26,89,614999
chr1,40200500,0.87,88,13,101,615000
chr1,40200515,0.88,88,12,100,615001
chr1,40200586,0.96,74,3,77,615002
chr1,40200595,0.88,69,9,78,615003
chr1,40200696,0.96,72,3,75,615004
chr1,40200710,0.97,68,2,70,615005
chr1,40200727,0.97,73,2,75,615006
chr1,40200888,1,43,0,43,615007
chr1,40200894,0.69,20,9,29,615008
chr1,40200921,1,50,0,50,615009
chr1,40200935,0.98,57,1,58,615010
chr1,40200937,0.94,58,4,62,615011
chr1,40200986,1,86,0,86,615012
chr1,40201022,0.98,82,2,84,615013
chr1,40201054,1,89,0,89,615014
chr1,40201088,0.84,81,16,97,615015
chr1,40201197,0.92,61,5,66,615016
chr1,40201245,0.86,51,8,59,615017
chr1,40201247,0.93,54,4,58,615018
chr1,40201253,0.91,60,6,66,615019
chr1,40201285,0.9,76,8,84,615020
chr1,40201311,0.87,79,12,91,615021
chr1,40201521,0.75,38,13,51,615022
chr1,40201634,1,42,0,42,615023
chr1,40201703,0.75,62,21,83,615024
chr1,40201886,0.89,96,12,108,615025
chr1,40201935,0.98,90,2,92,615026
chr1,40202033,0.97,77,2,79,615027
chr1,40202074,0.86,78,13,91,615028
chr1,40202448,0.91,77,8,85,615029
chr1,40202492,0.97,67,2,69,615030
chr1,40202506,0.98,63,1,64,615031
chr1,40202603,0.9,37,4,41,615032
chr1,40202630,0.96,54,2,56,615033
chr1,40203059,0.96,88,4,92,615034
chr1,40203334,0.84,59,11,70,615035
chr1,40203443,0.94,74,5,79,615036
chr1,40203513,0.9,75,8,83,615037
chr1,40203613,0.69,38,17,55,615038
chr1,40203623,0.44,19,24,43,615039
chr1,40203628,0.93,37,3,40,615040
chr1,40203703,0.43,29,38,67,615041
chr1,40203715,0.28,21,53,74,615042
chr1,40203823,0.96,76,3,79,615043
chr1,40203853,0.89,68,8,76,615044
chr1,40203930,0.97,65,2,67,615045
chr1,40203936,0.99,73,1,74,615046
chr1,40203958,0.99,68,1,69,615047
chr1,40203961,1,71,0,71,615048
chr1,40203963,0.99,74,1,75,615049
chr1,40203986,0.97,87,3,90,615050
chr1,40204003,0.89,85,10,95,615051
chr1,40204035,0.94,91,6,97,615052
chr1,40204045,0.99,92,1,93,615053
chr1,40204049,0.95,90,5,95,615054
chr1,40204057,0.96,90,4,94,615055
chr1,40204089,0.88,52,7,59,615056
chr1,40204120,0.8,33,8,41,615057
chr1,40204143,0.9,26,3,29,615058
chr1,40204147,0.64,30,17,47,615059
chr1,40204192,0.66,42,22,64,615060
chr1,40204196,0.46,37,43,80,615061
chr1,40204283,0.09,8,81,89,615062
chr1,40204285,0.17,16,78,94,615063
chr1,40204313,0.02,2,89,91,615064
chr1,40204330,0.02,2,87,89,615065
chr1,40204340,0.02,2,87,89,615066
chr1,40204365,0.02,2,83,85,615067
chr1,40204370,0,0,65,65,615068
chr1,40204382,0,0,71,71,615069
chr1,40204384,0,0,73,73,615070
chr1,40204393,0.01,1,79,80,615071
chr1,40204413,0,0,78,78,615072
chr1,40204427,0,0,54,54,615073
chr1,40204440,0,0,83,83,615074
chr1,40204447,0,0,79,79,615075
chr1,40204455,0,0,78,78,615076
chr1,40204467,0.03,2,63,65,615077
chr1,40204469,0.02,1,62,63,615078
chr1,40204479,0,0,40,40,615079
chr1,40204497,0.02,1,50,51,615080
chr1,40204506,0,0,21,21,615081
chr1,40204511,0,0,18,18,615082
chr1,40204531,0,0,58,58,615083
chr1,40204536,0,0,54,54,615084
chr1,40204550,0.02,1,60,61,615085
chr1,40204553,0,0,38,38,615086
chr1,40204561,0,0,48,48,615087
chr1,40204563,0,0,52,52,615088
chr1,40204565,0,0,51,51,615089
chr1,40204588,0,0,54,54,615090
chr1,40204590,0,0,55,55,615091
chr1,40204599,0,0,59,59,615092
chr1,40204626,0,0,38,38,615093
chr1,40204641,0,0,54,54,615094
chr1,40204643,0,0,48,48,615095
chr1,40204657,0.02,1,51,52,615096
chr1,40204662,0,0,28,28,615097
chr1,40204674,0,0,53,53,615098
chr1,40204695,0,0,51,51,615099
chr1,40204698,0.02,1,40,41,615100
chr1,40204715,0,0,49,49,615101
chr1,40204726,0,0,38,38,615102
chr1,40204738,0,0,40,40,615103
chr1,40204816,0.02,1,49,50,615104
chr1,40204847,0.01,1,82,83,615105
chr1,40204852,0.01,1,97,98,615106
chr1,40204864,0,0,96,96,615107
chr1,40204927,0,0,104,104,615108
chr1,40204969,0.01,1,97,98,615109
chr1,40204977,0,0,103,103,615110
chr1,40204982,0.01,1,103,104,615111
chr1,40205009,0.02,2,101,103,615112
chr1,40205022,0,0,106,106,615113
chr1,40205029,0,0,111,111,615114
chr1,40205036,0.01,1,95,96,615115
chr1,40205060,0,0,117,117,615116
chr1,40205070,0.02,2,108,110,615117
chr1,40205101,0.05,5,88,93,615118
chr1,40205104,0,0,95,95,615119
chr1,40205195,0.19,17,73,90,615120
chr1,40205236,0.18,19,86,105,615121
chr1,40205266,0.27,28,74,102,615122
chr1,40205285,0.69,82,36,118,615123
chr1,40205288,0.68,82,38,120,615124
chr1,40205320,0.35,48,88,136,615125
chr1,40205326,0.44,60,75,135,615126
chr1,40205343,0.19,26,111,137,615127
chr1,40205361,0.37,51,88,139,615128
chr1,40205410,0.49,63,65,128,615129
chr1,40205521,0.97,97,3,100,615130
chr1,40205531,0.9,93,10,103,615131
chr1,40205660,0.91,74,7,81,615132
chr1,40205859,0.85,79,14,93,615133
chr1,40205879,0.93,77,6,83,615134
chr1,40205954,0.75,60,20,80,615135
chr1,40206084,0.77,79,24,103,615136
chr1,40206297,0.94,63,4,67,615137
chr1,40206334,0.94,58,4,62,615138
chr1,40206375,0.74,55,19,74,615139
chr1,40206687,0.95,113,6,119,615140
chr1,40206783,0.93,99,8,107,615141
chr1,40206948,0.87,69,10,79,615142
chr1,40207046,0.69,79,36,115,615143
chr1,40207228,0.86,71,12,83,615144
chr1,40207584,0.96,97,4,101,615145
chr1,40207776,0.98,90,2,92,615146
chr1,40207880,0.93,138,10,148,615147
chr1,40208313,0.91,86,9,95,615148
chr1,40208426,0.86,78,13,91,615149
chr1,40208481,0.65,68,37,105,615150
chr1,40208909,0.67,80,39,119,615151
chr1,40208918,0.96,111,5,116,615152
chr1,40209288,0.9,83,9,92,615153
chr1,40209538,0.9,85,9,94,615154
chr1,40209631,0.64,69,38,107,615155
chr1,40209634,0.9,93,10,103,615156
chr1,40209776,0.91,79,8,87,615157
chr1,40209792,0.95,70,4,74,615158
chr1,40209957,0.78,29,8,37,615159
chr1,40210053,0.98,48,1,49,615160
chr1,40210116,0.88,38,5,43,615161
chr1,40210342,0.98,104,2,106,615162
chr1,40210415,0.92,91,8,99,615163
chr1,40210638,0.87,90,14,104,615164
chr1,40210811,0.86,44,7,51,615165
chr1,40210852,0.92,56,5,61,615166
chr1,40210876,0.79,55,15,70,615167
chr1,40210926,1,64,0,64,615168
chr1,40210948,0.95,60,3,63,615169
chr1,40210987,0.96,54,2,56,615170
chr1,40211004,0.91,52,5,57,615171
chr1,40211071,0.99,79,1,80,615172
chr1,40211117,0.93,99,7,106,615173
chr1,40211125,0.96,110,5,115,615174
chr1,40211143,0.95,106,5,111,615175
chr1,40211154,0.93,93,7,100,615176
chr1,40211181,0.98,84,2,86,615177
chr1,40211195,0.93,76,6,82,615178
chr1,40211198,0.93,75,6,81,615179
chr1,40211203,0.88,60,8,68,615180
chr1,40211379,0.88,73,10,83,615181
chr1,40211648,0.69,56,25,81,615182
chr1,40211708,0.98,83,2,85,615183
chr1,40212171,0.97,70,2,72,615184
chr1,40212423,0.92,88,8,96,615185
chr1,40212571,0.88,70,10,80,615186
chr1,40212744,0.97,107,3,110,615187
chr1,40212837,0.94,101,7,108,615188
chr1,40213165,0.97,36,1,37,615189
chr1,40213177,0.88,43,6,49,615190
chr1,40213195,0.97,67,2,69,615191
chr1,40213220,0.99,76,1,77,615192
chr1,40213259,0.95,91,5,96,615193
chr1,40213279,0.91,80,8,88,615194
chr1,40213324,0.78,64,18,82,615195
chr1,40213380,1,65,0,65,615196
chr1,40213389,0.97,67,2,69,615197
chr1,40213417,0.94,61,4,65,615198
chr1,40213748,0.99,73,1,74,615199
chr1,40213875,0.92,84,7,91,615200
chr1,40213890,0.81,74,17,91,615201
chr1,40214081,0.93,80,6,86,615202
chr1,40214184,0.99,90,1,91,615203
chr1,40214402,0.98,42,1,43,615204
chr1,40214515,0.95,72,4,76,615205
chr1,40214551,0.93,68,5,73,615206
chr1,40214583,0.94,77,5,82,615207
chr1,40214637,0.99,113,1,114,615208
chr1,40214666,0.99,131,1,132,615209
chr1,40214723,0.97,114,4,118,615210
chr1,40214752,0.81,88,21,109,615211
chr1,40214786,0.89,77,10,87,615212
chr1,40214852,0.98,49,1,50,615213
chr1,40214961,0.88,36,5,41,615214
chr1,40214985,0.98,47,1,48,615215
chr1,40215078,0.85,64,11,75,615216
chr1,40215215,0.92,85,7,92,615217
chr1,40215236,0.9,86,10,96,615218
chr1,40215311,0.82,81,18,99,615219
chr1,40215520,0.92,98,8,106,615220
chr1,40215527,0.92,96,8,104,615221
chr1,40215580,0.97,85,3,88,615222
chr1,40215661,0.92,77,7,84,615223
chr1,40215665,0.93,74,6,80,615224
chr1,40215673,0.99,79,1,80,615225
chr1,40215675,0.97,77,2,79,615226
chr1,40215697,0.96,67,3,70,615227
chr1,40215736,0.95,40,2,42,615228
chr1,40215759,1,33,0,33,615229
chr1,40215792,1,35,0,35,615230
chr1,40215800,0.97,34,1,35,615231
chr1,40215805,0.96,46,2,48,615232
chr1,40215939,0.95,103,5,108,615233
chr1,40215941,0.92,100,9,109,615234
chr1,40215983,0.93,99,8,107,615235
chr1,40216012,0.82,89,20,109,615236
chr1,40216030,0.93,99,8,107,615237
chr1,40216207,0.9,69,8,77,615238
chr1,40216243,0.89,64,8,72,615239
chr1,40216492,0.67,78,38,116,615240
chr1,40216576,0.92,92,8,100,615241
chr1,40216639,0.52,70,64,134,615242
chr1,40216656,0.57,84,63,147,615243
chr1,40216722,0.73,104,38,142,615244
chr1,40216742,0.36,45,80,125,615245
chr1,40216763,0.33,35,72,107,615246
chr1,40216809,0.2,18,71,89,615247
chr1,40217099,0.95,62,3,65,615248
chr1,40217176,0.92,69,6,75,615249
chr1,40217323,0.96,64,3,67,615250
chr1,40217484,0.96,91,4,95,615251
chr1,40217487,0.98,88,2,90,615252
chr1,40217551,0.93,89,7,96,615253
chr1,40217567,0.96,85,4,89,615254
chr1,40217647,0.96,69,3,72,615255
chr1,40217663,0.97,69,2,71,615256
chr1,40217856,0.86,88,14,102,615257
chr1,40217874,0.96,90,4,94,615258
chr1,40217982,0.85,69,12,81,615259
chr1,40218088,0.97,92,3,95,615260
chr1,40218188,0.83,109,22,131,615261
chr1,40218450,0.95,70,4,74,615262
chr1,40218477,0.83,72,15,87,615263
chr1,40218524,0.38,32,53,85,615264
chr1,40218552,0.77,60,18,78,615265
chr1,40218694,0.98,84,2,86,615266
chr1,40218713,0.92,69,6,75,615267
chr1,40218836,0.93,40,3,43,615268
chr1,40218863,0.83,29,6,35,615269
chr1,40218924,0.79,27,7,34,615270
chr1,40218976,0.67,32,16,48,615271
chr1,40219003,0.96,49,2,51,615272
chr1,40219006,0.65,36,19,55,615273
chr1,40219021,0.55,27,22,49,615274
chr1,40219030,0.9,38,4,42,615275
chr1,40219054,0.95,42,2,44,615276
chr1,40219109,0.19,12,51,63,615277
chr1,40219337,0.16,13,70,83,615278
chr1,40219502,0.17,9,45,54,615279
chr1,40219545,0.23,16,54,70,615280
chr1,40219559,0.21,16,59,75,615281
chr1,40219583,0.25,20,61,81,615282
chr1,40219619,0.2,21,85,106,615283
chr1,40219838,0.11,12,100,112,615284
chr1,40219893,0.25,25,74,99,615285
chr1,40220444,0.97,63,2,65,615286
chr1,40220805,0.21,20,76,96,615287
chr1,40221045,0.29,20,48,68,615288
chr1,40221273,0.89,51,6,57,615289
chr1,40221523,0.96,88,4,92,615290
chr1,40221643,0.98,65,1,66,615291
chr1,40221806,0.97,71,2,73,615292
chr1,40221812,0.96,70,3,73,615293
chr1,40221843,0.83,58,12,70,615294
chr1,40221891,0.93,54,4,58,615295
chr1,40221920,0.93,51,4,55,615296
chr1,40222091,0.64,66,37,103,615297
chr1,40222175,0.98,102,2,104,615298
chr1,40222220,0.98,88,2,90,615299
chr1,40222729,0.94,101,7,108,615300
chr1,40222783,0.95,75,4,79,615301
chr1,40223174,0.85,84,15,99,615302
chr1,40223214,0.97,94,3,97,615303
chr1,40223260,0.92,71,6,77,615304
chr1,40223357,0.71,55,22,77,615305
chr1,40223460,0.89,105,13,118,615306
chr1,40223642,0.92,65,6,71,615307
chr1,40223647,0.92,65,6,71,615308
chr1,40224228,0.92,87,8,95,615309
chr1,40224356,0.98,63,1,64,615310
chr1,40224469,0.97,63,2,65,615311
chr1,40224495,1,39,0,39,615312
chr1,40224544,0.94,34,2,36,615313
chr1,40224616,0.87,46,7,53,615314
chr1,40224633,0.91,59,6,65,615315
chr1,40224671,0.87,60,9,69,615316
chr1,40224693,0.99,67,1,68,615317
chr1,40224697,1,55,0,55,615318
chr1,40224720,0.74,39,14,53,615319
chr1,40224835,1,76,0,76,615320
chr1,40225012,1,101,0,101,615321
chr1,40225023,0.97,103,3,106,615322
chr1,40225046,0.99,104,1,105,615323
chr1,40225057,0.92,91,8,99,615324
chr1,40225618,0.93,68,5,73,615325
chr1,40225745,0.83,62,13,75,615326
chr1,40225828,0.91,107,11,118,615327
chr1,40225837,0.87,87,13,100,615328
chr1,40225965,0.89,58,7,65,615329
chr1,40225997,0.9,56,6,62,615330
chr1,40226045,0.93,56,4,60,615331
chr1,40226078,0.95,52,3,55,615332
chr1,40226082,0.96,52,2,54,615333
chr1,40226102,0.98,48,1,49,615334
chr1,40226125,0.98,46,1,47,615335
chr1,40226134,1,48,0,48,615336
chr1,40226180,0.98,51,1,52,615337
chr1,40226205,0.96,46,2,48,615338
chr1,40226219,0.91,39,4,43,615339
chr1,40226434,0.91,67,7,74,615340
chr1,40226487,0.96,53,2,55,615341
chr1,40226633,0.94,16,1,17,615342
chr1,40226700,1,43,0,43,615343
chr1,40226768,0.85,56,10,66,615344
chr1,40226774,0.98,65,1,66,615345
chr1,40226846,0.95,75,4,79,615346
chr1,40226882,0.97,76,2,78,615347
chr1,40226901,0.94,65,4,69,615348
chr1,40226921,0.95,58,3,61,615349
chr1,40227022,0.68,40,19,59,615350
chr1,40227189,0.77,51,15,66,615351
chr1,40227253,0.67,28,14,42,615352
chr1,40227284,1,50,0,50,615353
chr1,40227491,0.84,86,16,102,615354
chr1,40227502,0.31,35,78,113,615355
chr1,40227533,0.43,46,60,106,615356
chr1,40227551,0.87,84,13,97,615357
chr1,40227556,0.94,87,6,93,615358
chr1,40227585,0.93,81,6,87,615359
chr1,40227672,0.87,59,9,68,615360
chr1,40227674,0.64,43,24,67,615361
chr1,40227708,0.61,41,26,67,615362
chr1,40227734,0.98,57,1,58,615363
chr1,40227741,0.77,44,13,57,615364
chr1,40227743,0.89,49,6,55,615365
chr1,40227886,0.99,73,1,74,615366
chr1,40227890,0.59,44,30,74,615367
chr1,40227972,0.91,62,6,68,615368
chr1,40227981,0.94,66,4,70,615369
chr1,40228000,0.99,78,1,79,615370
chr1,40228021,0.83,66,14,80,615371
chr1,40228104,0.82,42,9,51,615372
chr1,40228311,0.94,72,5,77,615373
chr1,40228316,0.95,75,4,79,615374
chr1,40228339,0.96,75,3,78,615375
chr1,40228370,0.96,75,3,78,615376
chr1,40228374,0.94,74,5,79,615377
chr1,40228390,0.97,74,2,76,615378
chr1,40228396,0.85,64,11,75,615379
chr1,40228399,0.9,64,7,71,615380
chr1,40228404,0.86,66,11,77,615381
chr1,40228469,0.95,114,6,120,615382
chr1,40228484,0.95,126,6,132,615383
chr1,40228509,0.96,131,6,137,615384
chr1,40228535,0.94,119,7,126,615385
chr1,40228545,0.93,106,8,114,615386
chr1,40228553,0.95,109,6,115,615387
chr1,40228565,0.96,88,4,92,615388
chr1,40228573,0.98,84,2,86,615389
chr1,40228625,0.98,39,1,40,615390
chr1,40228628,0.68,27,13,40,615391
chr1,40228661,0.94,31,2,33,615392
chr1,40228663,0.94,30,2,32,615393
chr1,40228781,0.93,39,3,42,615394
chr1,40228845,0.88,28,4,32,615395
chr1,40228862,0.97,32,1,33,615396
chr1,40228961,1,18,0,18,615397
chr1,40228999,0.82,18,4,22,615398
chr1,40229055,0.92,23,2,25,615399
chr1,40229070,0.75,15,5,20,615400
chr1,40229087,0.95,19,1,20,615401
chr1,40229106,0.75,12,4,16,615402
chr1,40229392,0.61,43,27,70,615403
chr1,40229410,0.88,66,9,75,615404
chr1,40229419,0.89,72,9,81,615405
chr1,40229424,0.85,71,13,84,615406
chr1,40229427,0.76,64,20,84,615407
chr1,40229439,0.69,67,30,97,615408
chr1,40229443,0.85,86,15,101,615409
chr1,40229452,0.81,86,20,106,615410
chr1,40229458,0.91,92,9,101,615411
chr1,40229749,1,1,0,1,615412
chr1,40229822,0.77,47,14,61,615413
chr1,40229840,0.82,70,15,85,615414
chr1,40229860,0.86,87,14,101,615415
chr1,40229882,0.88,107,15,122,615416
chr1,40229942,0.97,36,1,37,615417
chr1,40229954,1,21,0,21,615418
chr1,40230270,0.7,7,3,10,615419
chr1,40230285,0.89,16,2,18,615420
chr1,40230312,0.74,31,11,42,615421
chr1,40230323,0.81,43,10,53,615422
chr1,40230331,0.62,37,23,60,615423
chr1,40230344,0.97,65,2,67,615424
chr1,40230375,0.87,48,7,55,615425
chr1,40230384,0.98,48,1,49,615426
chr1,40230395,0.77,30,9,39,615427
chr1,40230421,0.82,14,3,17,615428
chr1,40230438,1,7,0,7,615429
chr1,40230463,1,1,0,1,615430
chr1,40230481,1,1,0,1,615431
chr1,40230520,0.92,34,3,37,615432
chr1,40230550,0.95,37,2,39,615433
chr1,40230562,0.89,31,4,35,615434
chr1,40230585,0.95,21,1,22,615435
chr1,40230886,0.95,88,5,93,615436
chr1,40230896,0.98,105,2,107,615437
chr1,40230921,0.94,146,10,156,615438
chr1,40230942,0.95,121,7,128,615439
chr1,40230947,0.87,105,16,121,615440
chr1,40230982,0.84,59,11,70,615441
chr1,40230992,0.79,42,11,53,615442
chr1,40231016,0.5,1,1,2,615443
chr1,40231482,1,11,0,11,615444
chr1,40231599,0.88,28,4,32,615445
chr1,40231684,0.79,27,7,34,615446
chr1,40231803,0.8,4,1,5,615447
chr1,40231850,0.92,33,3,36,615448
chr1,40231895,0.79,82,22,104,615449
chr1,40231991,0.93,43,3,46,615450
chr1,40232083,0.89,16,2,18,615451
chr1,40232124,0.72,23,9,32,615452
chr1,40232334,0.67,2,1,3,615453
chr1,40232434,0.81,35,8,43,615454
chr1,40232516,1,2,0,2,615455
chr1,40232889,0.95,127,6,133,615456
chr1,40233003,1,4,0,4,615457
chr1,40233737,0.92,65,6,71,615458
chr1,40233745,0.99,66,1,67,615459
chr1,40233747,0.91,58,6,64,615460
chr1,40233841,0.8,43,11,54,615461
chr1,40234041,0.87,46,7,53,615462
chr1,40234076,0.94,33,2,35,615463
chr1,40234114,0.88,15,2,17,615464
chr1,40234231,0.93,14,1,15,615465
chr1,40234241,0.3,6,14,20,615466
chr1,40234519,0.91,77,8,85,615467
chr1,40234630,0.85,40,7,47,615468
chr1,40234734,0.48,26,28,54,615469
chr1,40234837,0.11,5,39,44,615470
chr1,40234903,0.2,9,37,46,615471
chr1,40234947,0.77,20,6,26,615472
chr1,40235015,0.56,5,4,9,615473
chr1,40235049,0.57,13,10,23,615474
chr1,40235058,1,20,0,20,615475
chr1,40235099,0.78,25,7,32,615476
chr1,40235127,0.82,18,4,22,615477
chr1,40235158,1,10,0,10,615478
chr1,40235172,1,1,0,1,615479
chr1,40235323,0.6,30,20,50,615480
chr1,40235333,0.79,45,12,57,615481
chr1,40235345,0.97,57,2,59,615482
chr1,40235355,0.97,60,2,62,615483
chr1,40235372,0.93,63,5,68,615484
chr1,40235407,0.89,54,7,61,615485
chr1,40235431,0.88,42,6,48,615486
chr1,40235448,0.74,35,12,47,615487
chr1,40235455,0.82,42,9,51,615488
chr1,40235482,0.76,41,13,54,615489
chr1,40235505,0.88,45,6,51,615490
chr1,40235514,0.86,36,6,42,615491
chr1,40235523,1,39,0,39,615492
chr1,40235534,0.97,29,1,30,615493
chr1,40235541,1,26,0,26,615494
chr1,40235546,1,22,0,22,615495
chr1,40235553,1,21,0,21,615496
chr1,40235560,1,15,0,15,615497
chr1,40235982,0,0,3,3,615498
chr1,40235991,0,0,7,7,615499
chr1,40236012,0.11,1,8,9,615500
chr1,40236014,0.08,1,11,12,615501
chr1,40236026,0.08,1,12,13,615502
chr1,40236028,0.18,3,14,17,615503
chr1,40236036,0.17,3,15,18,615504
chr1,40236054,0.07,2,27,29,615505
chr1,40236079,0,0,39,39,615506
chr1,40236086,0.32,10,21,31,615507
chr1,40236095,0.03,1,37,38,615508
chr1,40236102,0.05,2,35,37,615509
chr1,40236123,0.13,5,35,40,615510
chr1,40236125,0.24,10,31,41,615511
chr1,40236147,0.05,2,40,42,615512
chr1,40236183,0.13,7,46,53,615513
chr1,40236202,0.14,5,30,35,615514
chr1,40236205,0.12,5,38,43,615515
chr1,40236210,0,0,41,41,615516
chr1,40236234,0.03,1,30,31,615517
chr1,40236245,0,0,25,25,615518
chr1,40236249,0.05,1,18,19,615519
chr1,40236267,0,0,15,15,615520
chr1,40236278,0,0,5,5,615521
chr1,40236282,0,0,2,2,615522
chr1,40236726,0.33,1,2,3,615523
chr1,40236735,0.33,1,2,3,615524
chr1,40236744,0,0,4,4,615525
chr1,40236753,0,0,5,5,615526
chr1,40236757,0,0,6,6,615527
chr1,40236762,0,0,12,12,615528
chr1,40236790,0,0,24,24,615529
chr1,40236796,0.07,2,26,28,615530
chr1,40236798,0.03,1,30,31,615531
chr1,40236812,0.03,1,34,35,615532
chr1,40236818,0,0,34,34,615533
chr1,40236839,0,0,27,27,615534
chr1,40236843,0,0,7,7,615535
chr1,40236859,0,0,19,19,615536
chr1,40236861,0.05,1,18,19,615537
chr1,40236873,0,0,15,15,615538
chr1,40236876,0,0,15,15,615539
chr1,40236879,0,0,8,8,615540
chr1,40236888,0,0,16,16,615541
chr1,40236890,0,0,13,13,615542
chr1,40236894,0,0,14,14,615543
chr1,40236904,0,0,13,13,615544
chr1,40236914,0,0,13,13,615545
chr1,40236919,0,0,13,13,615546
chr1,40236922,0,0,15,15,615547
chr1,40236931,0,0,17,17,615548
chr1,40236936,0,0,20,20,615549
chr1,40236941,0,0,19,19,615550
chr1,40236971,0,0,21,21,615551
chr1,40236975,0,0,17,17,615552
chr1,40236980,0,0,21,21,615553
chr1,40236985,0,0,20,20,615554
chr1,40236987,0,0,19,19,615555
chr1,40236989,0,0,17,17,615556
chr1,40237004,0,0,2,2,615557
chr1,40237008,0,0,2,2,615558
chr1,40237012,0,0,13,13,615559
chr1,40237014,0,0,11,11,615560
chr1,40237022,0,0,11,11,615561
chr1,40237047,0,0,15,15,615562
chr1,40237055,0,0,15,15,615563
chr1,40237075,0,0,17,17,615564
chr1,40237077,0,0,26,26,615565
chr1,40237082,0,0,25,25,615566
chr1,40237099,0.03,1,37,38,615567
chr1,40237105,0.04,1,27,28,615568
chr1,40237125,0.06,3,49,52,615569
chr1,40237138,0.05,2,41,43,615570
chr1,40237147,0,0,38,38,615571
chr1,40237157,0.02,1,46,47,615572
chr1,40237161,0.11,4,34,38,615573
chr1,40237187,0.15,7,39,46,615574
chr1,40237189,0.14,7,42,49,615575
chr1,40237255,0.09,1,10,11,615576
chr1,40237401,0.47,8,9,17,615577
chr1,40237459,0.39,17,27,44,615578
chr1,40237521,0.21,6,23,29,615579
chr1,40237543,0.75,12,4,16,615580
chr1,40237931,0.75,9,3,12,615581
chr1,40238140,0.8,8,2,10,615582
chr1,40238161,0.92,12,1,13,615583
chr1,40238370,0.71,5,2,7,615584
chr1,40238402,0.86,12,2,14,615585
chr1,40238440,0.84,16,3,19,615586
chr1,40238449,0.5,8,8,16,615587
chr1,40238480,0.9,9,1,10,615588
chr1,40239009,0.75,3,1,4,615589
chr1,40239022,1,5,0,5,615590
chr1,40239040,0.7,7,3,10,615591
chr1,40239070,0.39,7,11,18,615592
chr1,40239079,0.67,14,7,21,615593
chr1,40239106,0.86,18,3,21,615594
chr1,40239171,0.4,2,3,5,615595
chr1,40239176,0.5,2,2,4,615596
chr1,40240154,0.6,3,2,5,615597
chr1,40240157,0.67,4,2,6,615598
chr1,40240161,0.5,4,4,8,615599
chr1,40240176,0.56,5,4,9,615600
chr1,40240191,0.88,14,2,16,615601
chr1,40240207,1,21,0,21,615602
chr1,40240235,1,16,0,16,615603
chr1,40240394,1,1,0,1,615604
chr1,40240698,1,2,0,2,615605
chr1,40240704,1,6,0,6,615606
chr1,40240727,0.84,16,3,19,615607
chr1,40240752,0.85,28,5,33,615608
chr1,40240787,0.98,45,1,46,615609
chr1,40240818,0.93,54,4,58,615610
chr1,40240844,0.92,59,5,64,615611
chr1,40240863,0.47,35,39,74,615612
chr1,40240884,0.64,54,31,85,615613
chr1,40240935,0.87,79,12,91,615614
chr1,40240984,0.85,68,12,80,615615
chr1,40240989,0.96,72,3,75,615616
chr1,40241000,0.97,72,2,74,615617
chr1,40241005,0.9,73,8,81,615618
chr1,40241146,0.58,57,42,99,615619
chr1,40241158,0.91,86,9,95,615620
chr1,40241215,0.88,59,8,67,615621
chr1,40241266,0.89,17,2,19,615622
chr1,40241291,0,0,1,1,615623
chr1,40241398,0.61,45,29,74,615624
chr1,40241439,0.63,66,39,105,615625
chr1,40241511,0.9,64,7,71,615626
chr1,40241632,1,23,0,23,615627
chr1,40241651,1,24,0,24,615628
chr1,40241665,0.97,28,1,29,615629
chr1,40241677,0.96,24,1,25,615630
chr1,40241696,1,17,0,17,615631
chr1,40241716,0.75,9,3,12,615632
chr1,40241723,1,9,0,9,615633
chr1,40241743,1,4,0,4,615634
chr1,40241871,0.63,5,3,8,615635
chr1,40241914,0.93,37,3,40,615636
chr1,40241944,0.87,54,8,62,615637
chr1,40241959,0.93,67,5,72,615638
chr1,40241996,0.85,74,13,87,615639
chr1,40242044,0.89,62,8,70,615640
chr1,40242140,0.82,75,16,91,615641
chr1,40242170,0.93,86,6,92,615642
chr1,40242175,0.81,71,17,88,615643
chr1,40242180,0.98,87,2,89,615644
chr1,40242206,0.68,64,30,94,615645
chr1,40242224,0.93,86,6,92,615646
chr1,40242238,0.97,89,3,92,615647
chr1,40242250,0.94,74,5,79,615648
chr1,40242272,0.79,55,15,70,615649
chr1,40242296,0.92,45,4,49,615650
chr1,40242315,0.98,53,1,54,615651
chr1,40242330,0.88,46,6,52,615652
chr1,40242556,0.87,90,14,104,615653
chr1,40242564,0.93,104,8,112,615654
chr1,40242697,0.92,85,7,92,615655
chr1,40242752,0.88,73,10,83,615656
chr1,40242874,0.49,35,37,72,615657
chr1,40242973,0.98,84,2,86,615658
chr1,40243126,0.68,65,30,95,615659
chr1,40243140,0.71,57,23,80,615660
chr1,40243178,0.9,76,8,84,615661
chr1,40243242,0.25,18,55,73,615662
chr1,40243476,0.97,69,2,71,615663
chr1,40243500,0.96,86,4,90,615664
chr1,40243527,0.99,69,1,70,615665
chr1,40243534,0.97,65,2,67,615666
chr1,40243564,0.88,36,5,41,615667
chr1,40243574,0.9,28,3,31,615668
chr1,40243588,0.91,10,1,11,615669
chr1,40243645,0.82,9,2,11,615670
chr1,40243697,0.98,56,1,57,615671
chr1,40243713,0.89,66,8,74,615672
chr1,40243718,0.95,70,4,74,615673
chr1,40243726,0.93,66,5,71,615674
chr1,40243747,0.96,70,3,73,615675
chr1,40243751,0.93,70,5,75,615676
chr1,40243762,0.99,69,1,70,615677
chr1,40243776,1,77,0,77,615678
chr1,40243789,0.99,72,1,73,615679
chr1,40243800,0.95,61,3,64,615680
chr1,40243839,1,60,0,60,615681
chr1,40243851,0.89,56,7,63,615682
chr1,40243935,0.87,13,2,15,615683
chr1,40243944,0.67,6,3,9,615684
chr1,40244130,1,6,0,6,615685
chr1,40244155,1,14,0,14,615686
chr1,40244194,0.98,45,1,46,615687
chr1,40244204,1,55,0,55,615688
chr1,40244238,0.87,62,9,71,615689
chr1,40244301,0.9,38,4,42,615690
chr1,40244372,0.99,71,1,72,615691
chr1,40244416,0.94,97,6,103,615692
chr1,40244438,0.77,75,22,97,615693
chr1,40244488,0.98,60,1,61,615694
chr1,40244520,0.9,47,5,52,615695
chr1,40244566,0.73,56,21,77,615696
chr1,40244703,0.91,59,6,65,615697
chr1,40244804,1,14,0,14,615698
chr1,40244835,1,7,0,7,615699
chr1,40244845,1,14,0,14,615700
chr1,40244928,0.86,24,4,28,615701
chr1,40244933,0.95,35,2,37,615702
chr1,40244953,0.93,27,2,29,615703
chr1,40245008,0.97,57,2,59,615704
chr1,40245184,0.93,67,5,72,615705
chr1,40245236,0.95,60,3,63,615706
chr1,40245240,0.98,63,1,64,615707
chr1,40245362,0.97,59,2,61,615708
chr1,40245428,0.8,45,11,56,615709
chr1,40245435,0.94,50,3,53,615710
chr1,40245659,0.78,43,12,55,615711
chr1,40245673,0.84,46,9,55,615712
chr1,40245675,0.93,52,4,56,615713
chr1,40245743,0.89,50,6,56,615714
chr1,40245752,0.95,54,3,57,615715
chr1,40245899,0.82,86,19,105,615716
chr1,40245917,1,90,0,90,615717
chr1,40246090,0.77,76,23,99,615718
chr1,40246130,0.95,109,6,115,615719
chr1,40246148,0.93,115,8,123,615720
chr1,40246178,0.78,110,31,141,615721
chr1,40246289,0.97,109,3,112,615722
chr1,40246301,0.95,104,6,110,615723
chr1,40246392,0.62,62,38,100,615724
chr1,40246522,1,58,0,58,615725
chr1,40246524,1,57,0,57,615726
chr1,40246554,0.95,56,3,59,615727
chr1,40246572,0.88,46,6,52,615728
chr1,40246619,0.79,44,12,56,615729
chr1,40246636,0.89,56,7,63,615730
chr1,40246975,0.81,66,15,81,615731
chr1,40247226,0.85,115,20,135,615732
chr1,40247275,0.96,106,4,110,615733
chr1,40247554,0.5,25,25,50,615734
chr1,40247566,0.94,50,3,53,615735
chr1,40247684,0.92,56,5,61,615736
chr1,40247688,0.94,59,4,63,615737
chr1,40247696,0.95,58,3,61,615738
chr1,40247777,0.85,29,5,34,615739
chr1,40247882,0.77,43,13,56,615740
chr1,40247905,0.89,59,7,66,615741
chr1,40247909,0.97,61,2,63,615742
chr1,40248078,0.95,55,3,58,615743
chr1,40248169,0.75,33,11,44,615744
chr1,40248200,0.79,27,7,34,615745
chr1,40248284,0.98,55,1,56,615746
chr1,40248300,0.91,63,6,69,615747
chr1,40248328,0.74,56,20,76,615748
chr1,40248382,0.96,52,2,54,615749
chr1,40248388,0.98,56,1,57,615750
chr1,40248420,0.81,50,12,62,615751
chr1,40248430,0.88,52,7,59,615752
chr1,40248577,0.93,55,4,59,615753
chr1,40248586,0.98,62,1,63,615754
chr1,40248612,0.92,71,6,77,615755
chr1,40248614,0.88,69,9,78,615756
chr1,40248711,0.96,90,4,94,615757
chr1,40248731,0.89,74,9,83,615758
chr1,40248781,0.96,67,3,70,615759
chr1,40248965,0.81,91,21,112,615760
chr1,40249057,0.9,66,7,73,615761
chr1,40249265,0.77,81,24,105,615762
chr1,40249298,0.73,83,31,114,615763
chr1,40249408,0.97,95,3,98,615764
chr1,40249630,0.72,72,28,100,615765
chr1,40249677,0.6,53,36,89,615766
chr1,40249880,0.93,27,2,29,615767
chr1,40249889,0.97,30,1,31,615768
chr1,40250017,1,2,0,2,615769
chr1,40250357,0.63,12,7,19,615770
chr1,40250386,0.9,19,2,21,615771
chr1,40250411,0.92,12,1,13,615772
chr1,40250423,0.75,6,2,8,615773
chr1,40250460,0.5,1,1,2,615774
chr1,40251070,1,7,0,7,615775
chr1,40251120,0.96,48,2,50,615776
chr1,40251154,0.87,84,13,97,615777
chr1,40251192,0.97,87,3,90,615778
chr1,40251235,0.93,71,5,76,615779
chr1,40251291,0.81,47,11,58,615780
chr1,40251316,0.92,48,4,52,615781
chr1,40251324,1,50,0,50,615782
chr1,40251397,0.73,22,8,30,615783
chr1,40251489,0.96,53,2,55,615784
chr1,40251597,0.93,94,7,101,615785
chr1,40251647,0.9,102,11,113,615786
chr1,40251652,0.93,102,8,110,615787
chr1,40251725,0.91,87,9,96,615788
chr1,40251739,0.93,97,7,104,615789
chr1,40251747,0.95,86,5,91,615790
chr1,40251965,0.82,46,10,56,615791
chr1,40252123,0.87,62,9,71,615792
chr1,40252243,0.5,6,6,12,615793
chr1,40252264,0.67,4,2,6,615794
chr1,40252278,0,0,1,1,615795
chr1,40252448,0.83,66,14,80,615796
chr1,40252476,0.94,67,4,71,615797
chr1,40252511,0.95,55,3,58,615798
chr1,40252536,0.92,47,4,51,615799
chr1,40252615,0.94,79,5,84,615800
chr1,40252756,1,62,0,62,615801
chr1,40252767,1,46,0,46,615802
chr1,40252784,1,35,0,35,615803
chr1,40252835,1,26,0,26,615804
chr1,40252856,1,28,0,28,615805
chr1,40252905,0.91,30,3,33,615806
chr1,40252948,0.92,24,2,26,615807
chr1,40253155,0.87,54,8,62,615808
chr1,40253288,0.49,28,29,57,615809
chr1,40253314,0.92,34,3,37,615810
chr1,40253329,0.95,53,3,56,615811
chr1,40253347,0.87,48,7,55,615812
chr1,40253381,0.75,41,14,55,615813
chr1,40253383,0.82,50,11,61,615814
chr1,40253403,0.81,56,13,69,615815
chr1,40253424,0.7,44,19,63,615816
chr1,40253477,0.55,30,25,55,615817
chr1,40253523,0.25,13,39,52,615818
chr1,40253596,0.59,10,7,17,615819
chr1,40253640,0.38,3,5,8,615820
chr1,40253684,0,0,10,10,615821
chr1,40253687,0.09,1,10,11,615822
chr1,40253708,0.37,7,12,19,615823
chr1,40253710,0.3,6,14,20,615824
chr1,40253717,0.29,7,17,24,615825
chr1,40253731,0.07,2,25,27,615826
chr1,40253735,0.17,5,25,30,615827
chr1,40253746,0.08,3,37,40,615828
chr1,40253756,0.05,2,39,41,615829
chr1,40253758,0.05,2,37,39,615830
chr1,40253764,0.03,1,28,29,615831
chr1,40253766,0.12,3,22,25,615832
chr1,40253793,0.02,1,53,54,615833
chr1,40253803,0.04,2,50,52,615834
chr1,40253805,0,0,47,47,615835
chr1,40253807,0.02,1,47,48,615836
chr1,40253833,0.02,1,57,58,615837
chr1,40253851,0.01,1,66,67,615838
chr1,40253854,0.05,3,52,55,615839
chr1,40253856,0,0,59,59,615840
chr1,40253865,0,0,49,49,615841
chr1,40253868,0.04,2,52,54,615842
chr1,40253873,0,0,71,71,615843
chr1,40253875,0,0,74,74,615844
chr1,40253879,0,0,50,50,615845
chr1,40253881,0.04,2,55,57,615846
chr1,40253884,0,0,66,66,615847
chr1,40253890,0.01,1,66,67,615848
chr1,40253893,0,0,63,63,615849
chr1,40253896,0.02,1,58,59,615850
chr1,40253899,0.04,2,47,49,615851
chr1,40253902,0.05,3,54,57,615852
chr1,40253911,0.09,4,41,45,615853
chr1,40253936,0.07,3,38,41,615854
chr1,40253939,0.05,2,35,37,615855
chr1,40253941,0.05,2,39,41,615856
chr1,40253945,0.03,1,38,39,615857
chr1,40253947,0.02,1,40,41,615858
chr1,40253955,0,0,43,43,615859
chr1,40253962,0.04,1,25,26,615860
chr1,40253965,0.04,1,24,25,615861
chr1,40253972,0.04,1,23,24,615862
chr1,40253974,0,0,35,35,615863
chr1,40253976,0,0,37,37,615864
chr1,40253982,0,0,40,40,615865
chr1,40253988,0.19,5,22,27,615866
chr1,40254001,0.02,1,45,46,615867
chr1,40254008,0.06,2,34,36,615868
chr1,40254019,0,0,34,34,615869
chr1,40254021,0.07,2,26,28,615870
chr1,40254028,0.03,1,33,34,615871
chr1,40254033,0,0,32,32,615872
chr1,40254036,0.04,1,22,23,615873
chr1,40254040,0,0,28,28,615874
chr1,40254042,0,0,27,27,615875
chr1,40254044,0,0,23,23,615876
chr1,40254046,0,0,22,22,615877
chr1,40254054,0.04,1,25,26,615878
chr1,40254057,0,0,26,26,615879
chr1,40254070,0.04,1,27,28,615880
chr1,40254074,0.06,1,16,17,615881
chr1,40254081,0,0,19,19,615882
chr1,40254088,0,0,24,24,615883
chr1,40254094,0,0,11,11,615884
chr1,40254100,0,0,22,22,615885
chr1,40254107,0,0,29,29,615886
chr1,40254109,0.06,2,29,31,615887
chr1,40254116,0.08,2,24,26,615888
chr1,40254137,0.03,1,30,31,615889
chr1,40254142,0.05,2,39,41,615890
chr1,40254149,0.09,2,20,22,615891
chr1,40254151,0,0,31,31,615892
chr1,40254165,0.03,1,34,35,615893
chr1,40254171,0.13,2,14,16,615894
chr1,40254184,0.13,2,14,16,615895
chr1,40254191,0.12,3,22,25,615896
chr1,40254195,0.06,1,16,17,615897
chr1,40254197,0,0,22,22,615898
chr1,40254202,0.04,1,25,26,615899
chr1,40254208,0,0,28,28,615900
chr1,40254210,0,0,27,27,615901
chr1,40254214,0.04,1,27,28,615902
chr1,40254232,0,0,15,15,615903
chr1,40254237,0,0,30,30,615904
chr1,40254240,0,0,29,29,615905
chr1,40254258,0,0,30,30,615906
chr1,40254261,0,0,28,28,615907
chr1,40254265,0,0,17,17,615908
chr1,40254268,0,0,19,19,615909
chr1,40254272,0,0,18,18,615910
chr1,40254275,0,0,19,19,615911
chr1,40254280,0,0,19,19,615912
chr1,40254285,0,0,19,19,615913
chr1,40254290,0,0,26,26,615914
chr1,40254294,0,0,21,21,615915
chr1,40254297,0,0,20,20,615916
chr1,40254301,0.03,1,28,29,615917
chr1,40254303,0,0,31,31,615918
chr1,40254312,0,0,33,33,615919
chr1,40254314,0.03,1,33,34,615920
chr1,40254326,0,0,22,22,615921
chr1,40254330,0.03,1,31,32,615922
chr1,40254333,0,0,38,38,615923
chr1,40254335,0,0,38,38,615924
chr1,40254337,0.03,1,36,37,615925
chr1,40254360,0,0,46,46,615926
chr1,40254368,0,0,45,45,615927
chr1,40254370,0.07,3,40,43,615928
chr1,40254374,0.03,1,36,37,615929
chr1,40254380,0.05,2,38,40,615930
chr1,40254385,0,0,48,48,615931
chr1,40254391,0.04,2,47,49,615932
chr1,40254404,0.05,2,39,41,615933
chr1,40254418,0,0,49,49,615934
chr1,40254427,0,0,51,51,615935
chr1,40254434,0.03,1,36,37,615936
chr1,40254437,0,0,39,39,615937
chr1,40254440,0.02,1,52,53,615938
chr1,40254446,0,0,48,48,615939
chr1,40254454,0,0,51,51,615940
chr1,40254464,0,0,48,48,615941
chr1,40254466,0,0,44,44,615942
chr1,40254471,0.04,2,46,48,615943
chr1,40254478,0,0,39,39,615944
chr1,40254486,0,0,30,30,615945
chr1,40254493,0.03,1,28,29,615946
chr1,40254511,0.06,2,31,33,615947
chr1,40254520,0,0,26,26,615948
chr1,40254527,0,0,33,33,615949
chr1,40254529,0,0,33,33,615950
chr1,40254554,0.03,1,29,30,615951
chr1,40254559,0,0,32,32,615952
chr1,40254561,0,0,31,31,615953
chr1,40254564,0,0,22,22,615954
chr1,40254568,0.05,1,20,21,615955
chr1,40254579,0,0,32,32,615956
chr1,40254600,0,0,16,16,615957
chr1,40254606,0,0,17,17,615958
chr1,40254619,0,0,21,21,615959
chr1,40254628,0,0,24,24,615960
chr1,40254634,0.03,1,30,31,615961
chr1,40254644,0.03,1,30,31,615962
chr1,40254652,0,0,32,32,615963
chr1,40254656,0.03,1,29,30,615964
chr1,40254662,0.04,1,27,28,615965
chr1,40254664,0,0,29,29,615966
chr1,40254679,0.03,1,36,37,615967
chr1,40254695,0.03,1,29,30,615968
chr1,40254700,0,0,25,25,615969
chr1,40254712,0.06,1,17,18,615970
chr1,40254717,0,0,32,32,615971
chr1,40254721,0,0,18,18,615972
chr1,40254730,0,0,30,30,615973
chr1,40254741,0,0,21,21,615974
chr1,40254747,0,0,31,31,615975
chr1,40254759,0,0,36,36,615976
chr1,40254762,0,0,37,37,615977
chr1,40254771,0,0,30,30,615978
chr1,40254774,0,0,31,31,615979
chr1,40254776,0,0,32,32,615980
chr1,40254783,0,0,34,34,615981
chr1,40254786,0,0,21,21,615982
chr1,40254803,0,0,28,28,615983
chr1,40254805,0,0,35,35,615984
chr1,40254808,0,0,17,17,615985
chr1,40254816,0,0,37,37,615986
chr1,40254822,0,0,29,29,615987
chr1,40254838,0.03,1,37,38,615988
chr1,40254842,0,0,24,24,615989
chr1,40254847,0.03,1,34,35,615990
chr1,40254850,0.03,1,39,40,615991
chr1,40254853,0,0,42,42,615992
chr1,40254855,0.02,1,41,42,615993
chr1,40254859,0,0,38,38,615994
chr1,40254861,0,0,40,40,615995
chr1,40254866,0,0,26,26,615996
chr1,40254885,0,0,14,14,615997
chr1,40254896,0.03,1,38,39,615998
chr1,40254921,0.03,1,30,31,615999
chr1,40254923,0,0,15,15,616000
chr1,40254940,0,0,39,39,616001
chr1,40254942,0,0,34,34,616002
chr1,40254957,0,0,10,10,616003
chr1,40254971,0,0,14,14,616004
chr1,40254977,0.03,1,30,31,616005
chr1,40254987,0,0,43,43,616006
chr1,40254992,0,0,43,43,616007
chr1,40254994,0,0,44,44,616008
chr1,40254997,0,0,40,40,616009
chr1,40255001,0,0,19,19,616010
chr1,40255010,0,0,26,26,616011
chr1,40255033,0,0,45,45,616012
chr1,40255035,0.04,2,48,50,616013
chr1,40255044,0.02,1,44,45,616014
chr1,40255046,0.11,4,34,38,616015
chr1,40255052,0.1,3,27,30,616016
chr1,40255069,0.02,1,47,48,616017
chr1,40255103,0,0,44,44,616018
chr1,40255129,0,0,35,35,616019
chr1,40255134,0,0,36,36,616020
chr1,40255140,0,0,49,49,616021
chr1,40255169,0,0,52,52,616022
chr1,40255171,0.02,1,56,57,616023
chr1,40255225,0.03,1,32,33,616024
chr1,40255227,0.21,6,23,29,616025
chr1,40255233,0.15,5,29,34,616026
chr1,40255261,0.23,6,20,26,616027
chr1,40255266,0.27,13,35,48,616028
chr1,40255321,0.15,6,33,39,616029
chr1,40255391,0.45,30,36,66,616030
chr1,40255394,0.37,23,40,63,616031
chr1,40255436,0.54,37,31,68,616032
chr1,40255438,0.75,50,17,67,616033
chr1,40255440,0.72,50,19,69,616034
chr1,40255492,0.42,31,42,73,616035
chr1,40255555,0.72,68,27,95,616036
chr1,40255570,0.87,95,14,109,616037
chr1,40255641,0.44,36,46,82,616038
chr1,40255653,0.74,57,20,77,616039
chr1,40255709,0.39,24,38,62,616040
chr1,40255768,0.63,44,26,70,616041
chr1,40255903,0.06,5,79,84,616042
chr1,40256127,0.98,104,2,106,616043
chr1,40256310,0.46,50,58,108,616044
chr1,40256368,0.75,92,30,122,616045
chr1,40256616,0.93,68,5,73,616046
chr1,40256667,0.58,42,30,72,616047
chr1,40256802,0.68,52,25,77,616048
chr1,40256885,0.52,33,30,63,616049
chr1,40257065,0.44,4,5,9,616050
chr1,40257157,0.48,26,28,54,616051
chr1,40257195,0.73,58,22,80,616052
chr1,40257275,0.53,49,44,93,616053
chr1,40257313,0.69,55,25,80,616054
chr1,40257323,0.44,36,46,82,616055
chr1,40257398,0.85,57,10,67,616056
chr1,40257495,0.95,87,5,92,616057
chr1,40257617,0.96,112,5,117,616058
chr1,40257833,0.93,84,6,90,616059
chr1,40257927,0.92,66,6,72,616060
chr1,40257943,0.93,53,4,57,616061
chr1,40257965,0.96,55,2,57,616062
chr1,40257973,0.91,52,5,57,616063
chr1,40257997,0.83,35,7,42,616064
chr1,40258005,0.97,35,1,36,616065
chr1,40258049,1,12,0,12,616066
chr1,40258053,1,10,0,10,616067
chr1,40258061,1,9,0,9,616068
chr1,40258159,1,6,0,6,616069
chr1,40258163,1,18,0,18,616070
chr1,40258206,0.94,44,3,47,616071
chr1,40258208,0.98,48,1,49,616072
chr1,40258591,0.77,33,10,43,616073
chr1,40258695,0.56,76,59,135,616074
chr1,40258702,0.85,111,19,130,616075
chr1,40258759,0.47,51,57,108,616076
chr1,40258830,0.85,62,11,73,616077
chr1,40258841,0.76,53,17,70,616078
chr1,40259011,0.89,74,9,83,616079
chr1,40259056,0.95,56,3,59,616080
chr1,40259083,0.93,53,4,57,616081
chr1,40259114,0.8,57,14,71,616082
chr1,40259209,0.83,83,17,100,616083
chr1,40259216,0.93,85,6,91,616084
chr1,40259233,0.57,49,37,86,616085
chr1,40259239,0.46,37,44,81,616086
chr1,40259424,0.87,61,9,70,616087
chr1,40259542,0.88,68,9,77,616088
chr1,40259654,0.7,61,26,87,616089
chr1,40259772,0.92,58,5,63,616090
chr1,40259776,1,63,0,63,616091
chr1,40259778,0.93,57,4,61,616092
chr1,40259788,0.91,60,6,66,616093
chr1,40259816,0.95,56,3,59,616094
chr1,40259823,1,62,0,62,616095
chr1,40259825,0.97,60,2,62,616096
chr1,40259832,0.98,59,1,60,616097
chr1,40259846,0.95,56,3,59,616098
chr1,40259877,0.97,56,2,58,616099
chr1,40259906,0.95,59,3,62,616100
chr1,40259910,0.97,58,2,60,616101
chr1,40259966,0.8,40,10,50,616102
chr1,40259974,0.87,45,7,52,616103
chr1,40259981,1,48,0,48,616104
chr1,40260028,1,35,0,35,616105
chr1,40260036,1,35,0,35,616106
chr1,40260044,0.97,32,1,33,616107
chr1,40260073,0.83,30,6,36,616108
chr1,40260124,0.84,54,10,64,616109
chr1,40260142,0.98,65,1,66,616110
chr1,40260157,0.92,69,6,75,616111
chr1,40260204,0.99,75,1,76,616112
chr1,40260279,0.94,67,4,71,616113
chr1,40260976,1,61,0,61,616114
chr1,40261035,0.85,66,12,78,616115
chr1,40261103,0.84,74,14,88,616116
chr1,40261110,0.97,85,3,88,616117
chr1,40261492,0.52,38,35,73,616118
chr1,40261742,0.94,65,4,69,616119
chr1,40261771,0.95,57,3,60,616120
chr1,40261779,0.91,59,6,65,616121
chr1,40261835,0.84,37,7,44,616122
chr1,40261941,0.98,51,1,52,616123
chr1,40261966,0.97,69,2,71,616124
chr1,40262436,0.65,39,21,60,616125
chr1,40262511,1,42,0,42,616126
chr1,40262529,0.66,29,15,44,616127
chr1,40262647,0.97,76,2,78,616128
chr1,40262670,0.99,75,1,76,616129
chr1,40262694,0.93,69,5,74,616130
chr1,40263015,0.96,79,3,82,616131
chr1,40263232,1,69,0,69,616132
chr1,40263266,1,59,0,59,616133
chr1,40263443,0.92,71,6,77,616134
chr1,40263583,0.99,73,1,74,616135
chr1,40263678,0.91,72,7,79,616136
chr1,40263701,0.99,73,1,74,616137
chr1,40263788,0.98,53,1,54,616138
chr1,40264070,0.97,68,2,70,616139
chr1,40264112,0.94,73,5,78,616140
chr1,40264127,0.93,71,5,76,616141
chr1,40264183,0.99,85,1,86,616142
chr1,40264391,0.93,40,3,43,616143
chr1,40264396,0.98,44,1,45,616144
chr1,40264452,0.96,49,2,51,616145
chr1,40264612,0.96,43,2,45,616146
chr1,40264687,0.97,66,2,68,616147
chr1,40264694,0.97,65,2,67,616148
chr1,40264804,0.98,51,1,52,616149
chr1,40264872,0.95,55,3,58,616150
chr1,40264885,0.85,51,9,60,616151
chr1,40264943,0.84,67,13,80,616152
chr1,40264963,0.33,28,56,84,616153
chr1,40264978,0.57,47,35,82,616154
chr1,40265028,0.27,23,62,85,616155
chr1,40265046,0.1,10,87,97,616156
chr1,40265070,0.12,10,76,86,616157
chr1,40265084,0.52,27,25,52,616158
chr1,40265093,0.25,23,70,93,616159
chr1,40265131,0.53,49,43,92,616160
chr1,40265136,0.64,49,27,76,616161
chr1,40265143,0.51,37,35,72,616162
chr1,40265185,0.24,6,19,25,616163
chr1,40265187,0.27,6,16,22,616164
chr1,40265216,1,2,0,2,616165
chr1,40265324,0.17,3,15,18,616166
chr1,40265328,0.43,9,12,21,616167
chr1,40265356,0.19,6,26,32,616168
chr1,40265465,0.1,4,35,39,616169
chr1,40265475,0.05,2,41,43,616170
chr1,40265484,0,0,44,44,616171
chr1,40265521,0,0,30,30,616172
chr1,40265524,0.02,1,43,44,616173
chr1,40265539,0,0,50,50,616174
chr1,40265555,0.09,5,49,54,616175
chr1,40265609,0.06,4,65,69,616176
chr1,40266304,0.9,102,11,113,616177
chr1,40266323,0.66,71,36,107,616178
chr1,40266437,0.96,73,3,76,616179
chr1,40266631,0.82,75,16,91,616180
chr1,40266644,0.79,73,19,92,616181
chr1,40266884,0.99,70,1,71,616182
chr1,40266886,0.95,69,4,73,616183
chr1,40266896,0.91,67,7,74,616184
chr1,40266930,0.95,52,3,55,616185
chr1,40267016,0.85,44,8,52,616186
chr1,40267091,1,57,0,57,616187
chr1,40267100,0.98,52,1,53,616188
chr1,40267116,1,43,0,43,616189
chr1,40267262,0.47,46,52,98,616190
chr1,40267422,0.64,71,40,111,616191
chr1,40267428,0.79,88,24,112,616192
chr1,40267469,1,94,0,94,616193
chr1,40267563,0.93,70,5,75,616194
chr1,40267599,0.88,67,9,76,616195
chr1,40267677,0.98,56,1,57,616196
chr1,40267758,0.83,39,8,47,616197
chr1,40267811,0.94,51,3,54,616198
chr1,40267823,1,59,0,59,616199
chr1,40267874,0.9,46,5,51,616200
chr1,40267878,0.96,46,2,48,616201
chr1,40267880,0.96,45,2,47,616202
chr1,40267890,0.98,40,1,41,616203
chr1,40267918,0.81,30,7,37,616204
chr1,40267923,1,31,0,31,616205
chr1,40268013,0.97,64,2,66,616206
chr1,40268077,0.94,58,4,62,616207
chr1,40268085,0.97,56,2,58,616208
chr1,40268101,0.96,49,2,51,616209
chr1,40268107,0.98,43,1,44,616210
chr1,40268109,0.91,39,4,43,616211
chr1,40268119,0.95,37,2,39,616212
chr1,40268214,0.67,49,24,73,616213
chr1,40268332,0.76,64,20,84,616214
chr1,40268367,0.95,78,4,82,616215
chr1,40268385,0.81,70,16,86,616216
chr1,40268392,0.9,78,9,87,616217
chr1,40268430,0.9,76,8,84,616218
chr1,40268438,0.78,67,19,86,616219
chr1,40268701,0.96,125,5,130,616220
chr1,40268719,0.96,128,5,133,616221
chr1,40268728,0.94,111,7,118,616222
chr1,40268730,0.95,113,6,119,616223
chr1,40268757,0.98,113,2,115,616224
chr1,40268763,0.97,101,3,104,616225
chr1,40268891,0.86,65,11,76,616226
chr1,40268945,0.92,33,3,36,616227
chr1,40268982,0.82,9,2,11,616228
chr1,40269022,0.96,27,1,28,616229
chr1,40269028,0.91,30,3,33,616230
chr1,40269045,1,44,0,44,616231
chr1,40269060,0.91,48,5,53,616232
chr1,40269083,0.9,66,7,73,616233
chr1,40269108,0.97,75,2,77,616234
chr1,40269116,0.98,82,2,84,616235
chr1,40269120,0.95,83,4,87,616236
chr1,40269149,0.78,66,19,85,616237
chr1,40269180,0.98,52,1,53,616238
chr1,40269201,0.89,31,4,35,616239
chr1,40269205,1,48,0,48,616240
chr1,40269210,0.94,50,3,53,616241
chr1,40269248,0.5,37,37,74,616242
chr1,40269416,0.67,47,23,70,616243
chr1,40269489,0.93,70,5,75,616244
chr1,40269809,0.94,65,4,69,616245
chr1,40269847,0.78,67,19,86,616246
chr1,40269869,0.93,69,5,74,616247
chr1,40269903,0.96,72,3,75,616248
chr1,40269944,0.91,86,9,95,616249
chr1,40269974,0.92,92,8,100,616250
chr1,40270046,0.83,62,13,75,616251
chr1,40270229,0.93,74,6,80,616252
chr1,40270658,0.69,59,26,85,616253
chr1,40270789,0.93,63,5,68,616254
chr1,40271234,0.94,67,4,71,616255
chr1,40271426,0.96,70,3,73,616256
chr1,40271458,0.85,73,13,86,616257
chr1,40271763,0.96,81,3,84,616258
chr1,40271802,0.97,77,2,79,616259
chr1,40271939,0.74,32,11,43,616260
chr1,40272003,0.97,36,1,37,616261
chr1,40272120,0.95,42,2,44,616262
chr1,40272131,1,44,0,44,616263
chr1,40272136,0.95,41,2,43,616264
chr1,40272164,0.95,35,2,37,616265
chr1,40272176,1,32,0,32,616266
chr1,40272180,1,37,0,37,616267
chr1,40272222,0.96,27,1,28,616268
chr1,40272238,0.93,26,2,28,616269
chr1,40272260,0.93,26,2,28,616270
chr1,40272268,0.9,27,3,30,616271
chr1,40272285,1,33,0,33,616272
chr1,40272292,0.97,38,1,39,616273
chr1,40272300,0.94,34,2,36,616274
chr1,40272323,0.98,45,1,46,616275
chr1,40272348,1,59,0,59,616276
chr1,40272356,0.97,61,2,63,616277
chr1,40272443,0.94,67,4,71,616278
chr1,40272452,0.94,65,4,69,616279
chr1,40272492,0.94,67,4,71,616280
chr1,40272973,0.91,106,10,116,616281
chr1,40273110,0.92,77,7,84,616282
chr1,40273164,0.96,45,2,47,616283
chr1,40273198,0.93,40,3,43,616284
chr1,40273206,0.9,37,4,41,616285
chr1,40273309,0.78,7,2,9,616286
chr1,40273316,0.83,10,2,12,616287
chr1,40273325,0.92,11,1,12,616288
chr1,40273343,0.69,9,4,13,616289
chr1,40273375,1,11,0,11,616290
chr1,40273410,1,7,0,7,616291
chr1,40273429,1,3,0,3,616292
chr1,40273437,1,3,0,3,616293
chr1,40273502,1,7,0,7,616294
chr1,40273504,1,5,0,5,616295
chr1,40273506,0.83,5,1,6,616296
chr1,40273509,1,10,0,10,616297
chr1,40273547,0.89,24,3,27,616298
chr1,40273555,0.93,25,2,27,616299
chr1,40273558,0.97,31,1,32,616300
chr1,40273567,0.89,34,4,38,616301
chr1,40273590,1,49,0,49,616302
chr1,40273592,0.87,47,7,54,616303
chr1,40273610,0.92,48,4,52,616304
chr1,40273618,0.97,56,2,58,616305
chr1,40273626,0.98,51,1,52,616306
chr1,40273638,0.91,53,5,58,616307
chr1,40273646,0.93,52,4,56,616308
chr1,40273689,0.96,45,2,47,616309
chr1,40273697,0.97,36,1,37,616310
chr1,40273725,0.92,33,3,36,616311
chr1,40273750,0.82,27,6,33,616312
chr1,40273773,0.97,36,1,37,616313
chr1,40273781,0.84,37,7,44,616314
chr1,40273799,0.96,53,2,55,616315
chr1,40273809,0.96,43,2,45,616316
chr1,40273813,0.98,46,1,47,616317
chr1,40273821,0.91,40,4,44,616318
chr1,40273849,0.93,28,2,30,616319
chr1,40273853,0.97,29,1,30,616320
chr1,40273879,1,16,0,16,616321
chr1,40273889,1,7,0,7,616322
chr1,40273893,0.88,7,1,8,616323
chr1,40273898,0.75,9,3,12,616324
chr1,40273926,1,22,0,22,616325
chr1,40273933,0.92,24,2,26,616326
chr1,40273962,0.97,34,1,35,616327
chr1,40273966,0.94,34,2,36,616328
chr1,40273978,0.96,46,2,48,616329
chr1,40274002,0.96,53,2,55,616330
chr1,40274006,0.96,53,2,55,616331
chr1,40274018,0.81,47,11,58,616332
chr1,40274042,0.95,59,3,62,616333
chr1,40274046,0.81,48,11,59,616334
chr1,40274058,0.95,56,3,59,616335
chr1,40274076,0.79,31,8,39,616336
chr1,40274086,0.78,42,12,54,616337
chr1,40274090,0.74,37,13,50,616338
chr1,40274098,0.71,41,17,58,616339
chr1,40274132,0.92,49,4,53,616340
chr1,40274151,0.93,57,4,61,616341
chr1,40274160,0.95,62,3,65,616342
chr1,40274319,0.71,12,5,17,616343
chr1,40274582,0.97,76,2,78,616344
chr1,40274753,0.94,82,5,87,616345
chr1,40274927,0.53,51,45,96,616346
chr1,40274932,0.89,87,11,98,616347
chr1,40275068,0.66,55,28,83,616348
chr1,40275187,0.95,69,4,73,616349
chr1,40275291,0.74,50,18,68,616350
chr1,40275346,0.97,58,2,60,616351
chr1,40275442,0.76,34,11,45,616352
chr1,40275474,0.75,44,15,59,616353
chr1,40275582,0.94,82,5,87,616354
chr1,40275646,0.73,64,24,88,616355
chr1,40275755,0.99,91,1,92,616356
chr1,40275897,0.79,90,24,114,616357
chr1,40275968,0.92,90,8,98,616358
chr1,40276065,0.81,63,15,78,616359
chr1,40276165,0.93,62,5,67,616360
chr1,40276193,0.94,60,4,64,616361
chr1,40276251,0.87,58,9,67,616362
chr1,40276256,0.78,54,15,69,616363
chr1,40276324,0.95,90,5,95,616364
chr1,40276367,0.92,86,7,93,616365
chr1,40276510,0.92,109,9,118,616366
chr1,40276568,0.95,100,5,105,616367
chr1,40276684,0.89,77,10,87,616368
chr1,40276755,0.99,66,1,67,616369
chr1,40276759,0.97,63,2,65,616370
chr1,40276779,0.76,48,15,63,616371
chr1,40276841,0.98,61,1,62,616372
chr1,40276846,0.98,64,1,65,616373
chr1,40276865,0.94,62,4,66,616374
chr1,40276912,0.82,60,13,73,616375
chr1,40277291,0.83,52,11,63,616376
chr1,40277423,0.73,68,25,93,616377
chr1,40277454,0.85,81,14,95,616378
chr1,40277544,0.56,34,27,61,616379
chr1,40277757,0.94,44,3,47,616380
chr1,40277819,0.94,101,7,108,616381
chr1,40277829,0.95,108,6,114,616382
chr1,40277836,0.95,108,6,114,616383
chr1,40277873,0.77,86,25,111,616384
chr1,40277883,0.88,87,12,99,616385
chr1,40277940,0.94,85,5,90,616386
chr1,40277969,0.95,76,4,80,616387
chr1,40277978,0.94,72,5,77,616388
chr1,40278016,0.84,43,8,51,616389
chr1,40278113,0.88,35,5,40,616390
chr1,40278200,0.87,45,7,52,616391
chr1,40278277,0.83,34,7,41,616392
chr1,40278289,0.9,35,4,39,616393
chr1,40278291,1,37,0,37,616394
chr1,40278297,0.97,37,1,38,616395
chr1,40278314,1,42,0,42,616396
chr1,40278330,0.86,37,6,43,616397
chr1,40278390,0.94,50,3,53,616398
chr1,40278410,0.98,51,1,52,616399
chr1,40278414,0.93,51,4,55,616400
chr1,40278426,0.95,56,3,59,616401
chr1,40278456,0.98,63,1,64,616402
chr1,40278476,0.97,68,2,70,616403
chr1,40278487,0.97,65,2,67,616404
chr1,40278501,0.88,60,8,68,616405
chr1,40278508,0.95,59,3,62,616406
chr1,40278628,0.86,49,8,57,616407
chr1,40278710,0.84,66,13,79,616408
chr1,40278917,0.68,67,31,98,616409
chr1,40279003,0.94,78,5,83,616410
chr1,40279035,0.81,66,15,81,616411
chr1,40279262,1,22,0,22,616412
chr1,40279270,0.96,25,1,26,616413
chr1,40279309,0.98,54,1,55,616414
chr1,40279317,1,54,0,54,616415
chr1,40279333,0.95,56,3,59,616416
chr1,40279365,0.87,58,9,67,616417
chr1,40279423,0.88,60,8,68,616418
chr1,40279486,0.86,44,7,51,616419
chr1,40279526,1,31,0,31,616420
chr1,40279530,1,28,0,28,616421
chr1,40279680,0.9,78,9,87,616422
chr1,40279704,0.95,75,4,79,616423
chr1,40279716,0.9,70,8,78,616424
chr1,40279777,0.89,59,7,66,616425
chr1,40279804,0.94,58,4,62,616426
chr1,40279837,0.86,42,7,49,616427
chr1,40279857,0.98,58,1,59,616428
chr1,40279989,0.9,61,7,68,616429
chr1,40280099,0.94,103,6,109,616430
chr1,40280102,0.91,104,10,114,616431
chr1,40280111,0.87,94,14,108,616432
chr1,40280139,0.96,89,4,93,616433
chr1,40280148,0.98,81,2,83,616434
chr1,40280155,0.93,71,5,76,616435
chr1,40280169,0.9,56,6,62,616436
chr1,40280187,0.72,46,18,64,616437
chr1,40280200,0.87,46,7,53,616438
chr1,40280242,0.83,65,13,78,616439
chr1,40280257,0.94,79,5,84,616440
chr1,40280303,0.97,64,2,66,616441
chr1,40280320,0.92,48,4,52,616442
chr1,40280328,0.89,39,5,44,616443
chr1,40280349,0.88,22,3,25,616444
chr1,40280471,0.43,46,60,106,616445
chr1,40280586,0.68,57,27,84,616446
chr1,40280685,0.68,63,30,93,616447
chr1,40280991,0.34,22,42,64,616448
chr1,40281031,0.81,51,12,63,616449
chr1,40281176,0.81,110,25,135,616450
chr1,40281188,0.74,106,37,143,616451
chr1,40281284,0.94,74,5,79,616452
chr1,40281286,0.99,76,1,77,616453
chr1,40281527,0.9,64,7,71,616454
chr1,40281632,0.82,41,9,50,616455
chr1,40281694,0.9,36,4,40,616456
chr1,40281696,0.95,38,2,40,616457
chr1,40282314,0.02,1,64,65,616458
chr1,40282338,0.13,4,28,32,616459
chr1,40282399,0.88,23,3,26,616460
chr1,40282444,0.69,25,11,36,616461
chr1,40282556,0.03,2,65,67,616462
chr1,40282621,0.02,2,96,98,616463
chr1,40282633,0,0,99,99,616464
chr1,40282677,0.01,1,80,81,616465
chr1,40282689,0,0,81,81,616466
chr1,40282698,0,0,74,74,616467
chr1,40282708,0,0,62,62,616468
chr1,40282845,0.43,15,20,35,616469
chr1,40282849,0.2,7,28,35,616470
chr1,40283030,0.81,25,6,31,616471
chr1,40283037,0.86,32,5,37,616472
chr1,40283042,0.85,35,6,41,616473
chr1,40283048,0.82,37,8,45,616474
chr1,40283089,0.9,69,8,77,616475
chr1,40283103,0.44,38,49,87,616476
chr1,40283127,0.1,9,79,88,616477
chr1,40283209,0.67,48,24,72,616478
chr1,40283238,0.88,57,8,65,616479
chr1,40283287,0.9,54,6,60,616480
chr1,40283293,0.78,45,13,58,616481
chr1,40283300,0.67,39,19,58,616482
chr1,40283330,0.88,37,5,42,616483
chr1,40283380,1,38,0,38,616484
chr1,40283396,0.98,43,1,44,616485
chr1,40283599,0.98,86,2,88,616486
chr1,40283642,0.93,92,7,99,616487
chr1,40283739,1,75,0,75,616488
chr1,40283815,0.92,46,4,50,616489
chr1,40283912,0.87,53,8,61,616490
chr1,40284003,0.81,68,16,84,616491
chr1,40284043,0.97,84,3,87,616492
chr1,40284090,0.91,91,9,100,616493
chr1,40284252,0.99,80,1,81,616494
chr1,40284404,0.9,84,9,93,616495
chr1,40284613,0.98,65,1,66,616496
chr1,40284701,0.51,43,41,84,616497
chr1,40284859,0.96,94,4,98,616498
chr1,40284888,1,83,0,83,616499
chr1,40284903,0.97,75,2,77,616500
chr1,40284911,0.96,77,3,80,616501
chr1,40284917,0.92,70,6,76,616502
chr1,40284977,0.86,60,10,70,616503
chr1,40285139,0.91,62,6,68,616504
chr1,40285159,0.96,55,2,57,616505
chr1,40285179,0.95,41,2,43,616506
chr1,40285199,0.96,46,2,48,616507
chr1,40285239,0.92,34,3,37,616508
chr1,40285285,0.64,29,16,45,616509
chr1,40285318,0.86,32,5,37,616510
chr1,40285320,0.81,29,7,36,616511
chr1,40285334,0.81,34,8,42,616512
chr1,40285354,0.85,35,6,41,616513
chr1,40285370,0.64,30,17,47,616514
chr1,40285389,0.92,46,4,50,616515
chr1,40285391,0.9,44,5,49,616516
chr1,40285397,0.93,43,3,46,616517
chr1,40285409,0.78,43,12,55,616518
chr1,40285438,0.96,44,2,46,616519
chr1,40285656,0.91,79,8,87,616520
chr1,40285707,0.92,61,5,66,616521
chr1,40285773,0.51,64,62,126,616522
chr1,40285789,0.97,112,4,116,616523
chr1,40285822,0.87,103,16,119,616524
chr1,40285861,0.96,110,5,115,616525
chr1,40285958,0.85,82,15,97,616526
chr1,40285984,0.82,62,14,76,616527
chr1,40286046,1,53,0,53,616528
chr1,40286060,0.93,55,4,59,616529
chr1,40286134,0.87,77,12,89,616530
chr1,40286300,0.91,79,8,87,616531
chr1,40286316,0.92,87,8,95,616532
chr1,40286324,0.97,85,3,88,616533
chr1,40286441,0.96,68,3,71,616534
chr1,40286642,0.91,92,9,101,616535
chr1,40286682,0.9,91,10,101,616536
chr1,40286687,0.88,88,12,100,616537
chr1,40286811,0.93,113,8,121,616538
chr1,40286824,0.98,110,2,112,616539
chr1,40286869,0.99,77,1,78,616540
chr1,40286985,0.93,81,6,87,616541
chr1,40287101,0.81,64,15,79,616542
chr1,40287266,0.95,69,4,73,616543
chr1,40287279,0.93,64,5,69,616544
chr1,40287349,0.62,39,24,63,616545
chr1,40287371,0.91,53,5,58,616546
chr1,40287469,0.9,54,6,60,616547
chr1,40287479,0.94,62,4,66,616548
chr1,40287523,0.97,77,2,79,616549
chr1,40287563,0.78,38,11,49,616550
chr1,40287602,0.69,31,14,45,616551
chr1,40287668,0.48,25,27,52,616552
chr1,40287690,0.55,30,25,55,616553
chr1,40287697,0.81,43,10,53,616554
chr1,40287719,0.7,38,16,54,616555
chr1,40287740,0.81,44,10,54,616556
chr1,40287752,0.87,48,7,55,616557
chr1,40287757,0.91,53,5,58,616558
chr1,40287852,0.28,26,66,92,616559
chr1,40287885,0.45,45,54,99,616560
chr1,40287917,0.69,56,25,81,616561
chr1,40288049,0.56,57,45,102,616562
chr1,40288171,0.51,40,38,78,616563
chr1,40288333,0.98,88,2,90,616564
chr1,40288436,0.97,70,2,72,616565
chr1,40288464,0.99,66,1,67,616566
chr1,40288682,0.99,83,1,84,616567
chr1,40288706,0.88,72,10,82,616568
chr1,40288754,0.96,69,3,72,616569
chr1,40288837,1,70,0,70,616570
chr1,40288852,0.97,72,2,74,616571
chr1,40288955,0.94,51,3,54,616572
chr1,40288971,1,56,0,56,616573
chr1,40289000,1,56,0,56,616574
chr1,40289047,0.86,57,9,66,616575
chr1,40289086,0.92,79,7,86,616576
chr1,40289100,0.95,79,4,83,616577
chr1,40289154,0.98,97,2,99,616578
chr1,40289471,0.92,66,6,72,616579
chr1,40289481,0.95,59,3,62,616580
chr1,40289536,0.96,67,3,70,616581
chr1,40289552,0.99,67,1,68,616582
chr1,40289703,0.95,36,2,38,616583
chr1,40289741,0.95,38,2,40,616584
chr1,40289956,0.91,82,8,90,616585
chr1,40290027,0.99,82,1,83,616586
chr1,40290319,0.85,69,12,81,616587
chr1,40290356,0.89,65,8,73,616588
chr1,40290390,1,70,0,70,616589
chr1,40290433,0.94,81,5,86,616590
chr1,40290436,0.67,41,20,61,616591
chr1,40290464,0.74,69,24,93,616592
chr1,40290498,0.99,88,1,89,616593
chr1,40290664,0.97,103,3,106,616594
chr1,40290757,0.9,125,14,139,616595
chr1,40290970,0.82,69,15,84,616596
chr1,40291260,0.85,94,17,111,616597
chr1,40291314,0.69,75,34,109,616598
chr1,40291356,0.87,100,15,115,616599
chr1,40291415,0.82,110,24,134,616600
chr1,40291425,0.94,120,8,128,616601
chr1,40291431,0.79,99,26,125,616602
chr1,40291569,0.86,56,9,65,616603
chr1,40291679,0.95,61,3,64,616604
chr1,40291710,0.89,49,6,55,616605
chr1,40291740,0.94,50,3,53,616606
chr1,40291863,0.94,64,4,68,616607
chr1,40291867,0.99,66,1,67,616608
chr1,40291879,0.93,68,5,73,616609
chr1,40291894,0.99,66,1,67,616610
chr1,40291921,0.97,64,2,66,616611
chr1,40291939,0.97,67,2,69,616612
chr1,40292026,0.82,61,13,74,616613
chr1,40292058,0.95,81,4,85,616614
chr1,40292065,0.98,78,2,80,616615
chr1,40292088,0.91,67,7,74,616616
chr1,40292228,0.85,61,11,72,616617
chr1,40292489,0.79,79,21,100,616618
chr1,40292492,0.85,87,15,102,616619
chr1,40292506,0.86,89,14,103,616620
chr1,40292568,0.88,59,8,67,616621
chr1,40292642,0.85,39,7,46,616622
chr1,40292648,0.83,39,8,47,616623
chr1,40292790,0.58,61,44,105,616624
chr1,40292902,0.87,88,13,101,616625
chr1,40293051,0.57,26,20,46,616626
chr1,40293062,0.8,35,9,44,616627
chr1,40293085,0.9,47,5,52,616628
chr1,40293172,0.63,61,36,97,616629
chr1,40293207,0.25,28,86,114,616630
chr1,40293264,0.97,95,3,98,616631
chr1,40293276,0.92,81,7,88,616632
chr1,40293304,0.73,67,25,92,616633
chr1,40293336,0.91,83,8,91,616634
chr1,40293399,0.86,69,11,80,616635
chr1,40293403,0.88,65,9,74,616636
chr1,40293435,0.82,54,12,66,616637
chr1,40293497,0.93,66,5,71,616638
chr1,40293906,0.86,75,12,87,616639
chr1,40293988,0.91,68,7,75,616640
chr1,40294083,0.88,46,6,52,616641
chr1,40294091,0.93,40,3,43,616642
chr1,40294097,0.51,22,21,43,616643
chr1,40294127,0.92,36,3,39,616644
chr1,40294157,0.96,53,2,55,616645
chr1,40294420,1,109,0,109,616646
chr1,40294438,0.68,71,34,105,616647
chr1,40294855,0.3,30,71,101,616648
chr1,40295741,0.56,70,54,124,616649
chr1,40295760,0.47,63,70,133,616650
chr1,40295773,0.61,72,46,118,616651
chr1,40295834,0.56,57,44,101,616652
chr1,40296147,0.69,75,33,108,616653
chr1,40296162,0.69,79,35,114,616654
chr1,40296226,0.83,71,15,86,616655
chr1,40296391,0.53,32,28,60,616656
chr1,40296435,0.8,66,16,82,616657
chr1,40296453,0.74,70,25,95,616658
chr1,40296495,0.59,62,43,105,616659
chr1,40296571,0.55,73,59,132,616660
chr1,40296603,0.72,90,35,125,616661
chr1,40296832,0.67,62,30,92,616662
chr1,40297069,0.29,18,44,62,616663
chr1,40297076,0.92,44,4,48,616664
chr1,40297256,0.63,31,18,49,616665
chr1,40297306,0.71,50,20,70,616666
chr1,40297332,0.79,62,16,78,616667
chr1,40297338,0.74,59,21,80,616668
chr1,40297348,0.83,74,15,89,616669
chr1,40297381,0.81,72,17,89,616670
chr1,40297410,0.96,73,3,76,616671
chr1,40297433,0.99,74,1,75,616672
chr1,40297469,0.91,70,7,77,616673
chr1,40297486,0.88,65,9,74,616674
chr1,40297492,0.94,65,4,69,616675
chr1,40297494,0.97,63,2,65,616676
chr1,40297516,0.72,36,14,50,616677
chr1,40297752,0.9,91,10,101,616678
chr1,40297801,0.9,75,8,83,616679
chr1,40297810,0.99,76,1,77,616680
chr1,40297947,0.94,72,5,77,616681
chr1,40298026,0.85,74,13,87,616682
chr1,40298174,0.21,23,84,107,616683
chr1,40298218,0.8,78,20,98,616684
chr1,40298227,0.85,78,14,92,616685
chr1,40298232,0.87,73,11,84,616686
chr1,40298363,0.56,51,40,91,616687
chr1,40298425,0.95,103,5,108,616688
chr1,40298478,0.94,119,8,127,616689
chr1,40298574,0.81,60,14,74,616690
chr1,40298580,0.63,45,27,72,616691
chr1,40298611,0.76,53,17,70,616692
chr1,40298619,0.94,64,4,68,616693
chr1,40298624,0.92,60,5,65,616694
chr1,40298760,0.47,47,52,99,616695
chr1,40298875,0.2,17,68,85,616696
chr1,40299132,0.87,66,10,76,616697
chr1,40299384,0.86,61,10,71,616698
chr1,40299629,0.83,29,6,35,616699
chr1,40299645,0.98,45,1,46,616700
chr1,40299674,0.87,47,7,54,616701
chr1,40299705,0.78,45,13,58,616702
chr1,40299832,0.96,49,2,51,616703
chr1,40299836,0.98,51,1,52,616704
chr1,40299885,0.91,63,6,69,616705
chr1,40300012,0.94,68,4,72,616706
chr1,40300195,0.49,33,34,67,616707
chr1,40300311,0.98,47,1,48,616708
chr1,40300333,0.94,60,4,64,616709
chr1,40300341,0.96,67,3,70,616710
chr1,40300371,1,80,0,80,616711
chr1,40300421,0.97,89,3,92,616712
chr1,40300489,0.98,61,1,62,616713
chr1,40300516,0.98,58,1,59,616714
chr1,40300565,0.98,90,2,92,616715
chr1,40300627,0.98,84,2,86,616716
chr1,40300720,0.99,85,1,86,616717
chr1,40300896,0.79,95,25,120,616718
chr1,40300940,0.95,113,6,119,616719
chr1,40301617,0.63,60,36,96,616720
chr1,40301751,1,93,0,93,616721
chr1,40301783,0.89,102,12,114,616722
chr1,40301867,0.64,67,38,105,616723
chr1,40301892,0.78,71,20,91,616724
chr1,40301957,0.78,60,17,77,616725
chr1,40301995,0.71,57,23,80,616726
chr1,40302359,0.89,76,9,85,616727
chr1,40302600,0.93,63,5,68,616728
chr1,40302608,0.83,58,12,70,616729
chr1,40302840,0.94,122,8,130,616730
chr1,40303392,0.61,44,28,72,616731
chr1,40303428,0.94,64,4,68,616732
chr1,40303476,0.86,50,8,58,616733
chr1,40303508,0.92,44,4,48,616734
chr1,40303627,0.93,94,7,101,616735
chr1,40303724,0.99,88,1,89,616736
chr1,40304270,0.98,56,1,57,616737
chr1,40304304,0.97,62,2,64,616738
chr1,40304437,0.96,94,4,98,616739
chr1,40304452,0.99,92,1,93,616740
chr1,40304468,0.95,88,5,93,616741
chr1,40305133,0.96,69,3,72,616742
chr1,40305177,0.87,71,11,82,616743
chr1,40305512,0.94,92,6,98,616744
chr1,40305591,0.99,86,1,87,616745
chr1,40305696,0.97,92,3,95,616746
chr1,40305803,0.44,40,51,91,616747
chr1,40305851,0.83,67,14,81,616748
chr1,40306154,0.96,66,3,69,616749
chr1,40306324,0.94,93,6,99,616750
chr1,40306362,0.54,59,51,110,616751
chr1,40306382,0.89,98,12,110,616752
chr1,40306573,0.8,81,20,101,616753
chr1,40306590,0.96,96,4,100,616754
chr1,40306819,0.94,81,5,86,616755
chr1,40307257,0.75,66,22,88,616756
chr1,40307320,0.96,82,3,85,616757
chr1,40307421,0.81,62,15,77,616758
chr1,40307584,0.98,49,1,50,616759
chr1,40308146,0.29,21,51,72,616760
chr1,40308217,0.81,60,14,74,616761
chr1,40308220,0.91,69,7,76,616762
chr1,40308552,0.81,71,17,88,616763
chr1,40308700,0.56,50,40,90,616764
chr1,40308782,0.74,64,23,87,616765
chr1,40308815,0.89,84,10,94,616766
chr1,40308968,0.81,61,14,75,616767
chr1,40309782,0.98,111,2,113,616768
chr1,40309784,0.96,108,4,112,616769
chr1,40309802,0.99,111,1,112,616770
chr1,40310220,0.99,92,1,93,616771
chr1,40310260,0.97,77,2,79,616772
chr1,40310622,0.92,109,10,119,616773
chr1,40310693,0.99,129,1,130,616774
chr1,40310744,0.95,133,7,140,616775
chr1,40310767,0.99,131,1,132,616776
chr1,40310833,0.98,121,2,123,616777
chr1,40310844,0.98,120,3,123,616778
chr1,40311113,0.93,89,7,96,616779
chr1,40311142,0.91,96,9,105,616780
chr1,40311152,0.72,76,30,106,616781
chr1,40311392,0.03,2,77,79,616782
chr1,40311501,0.22,18,65,83,616783
chr1,40311553,0.02,2,84,86,616784
chr1,40311559,0.19,15,63,78,616785
chr1,40311570,0.05,4,71,75,616786
chr1,40311953,0.72,58,23,81,616787
chr1,40312236,0.34,33,64,97,616788
chr1,40312471,0.95,71,4,75,616789
chr1,40312903,0.87,87,13,100,616790
chr1,40312918,0.98,94,2,96,616791
chr1,40312930,0.99,94,1,95,616792
chr1,40313064,0.92,101,9,110,616793
chr1,40313127,0.98,87,2,89,616794
chr1,40313280,0.95,106,6,112,616795
chr1,40313593,0.98,87,2,89,616796
chr1,40313666,0.95,73,4,77,616797
chr1,40313688,0.95,81,4,85,616798
chr1,40313757,0.97,98,3,101,616799
chr1,40313834,0.96,88,4,92,616800
chr1,40313875,0.92,100,9,109,616801
chr1,40313920,0.91,117,11,128,616802
chr1,40314215,0.91,69,7,76,616803
chr1,40314219,0.95,73,4,77,616804
chr1,40314235,0.98,78,2,80,616805
chr1,40314263,0.99,80,1,81,616806
chr1,40314279,0.99,74,1,75,616807
chr1,40314293,0.95,72,4,76,616808
chr1,40314355,1,67,0,67,616809
chr1,40314363,1,66,0,66,616810
chr1,40314365,0.98,62,1,63,616811
chr1,40314367,0.97,60,2,62,616812
chr1,40314409,1,32,0,32,616813
chr1,40314419,0.96,24,1,25,616814
chr1,40314443,1,33,0,33,616815
chr1,40314449,0.97,31,1,32,616816
chr1,40314481,0.85,41,7,48,616817
chr1,40314567,0.88,83,11,94,616818
chr1,40314818,0.98,114,2,116,616819
chr1,40315136,0.9,94,10,104,616820
chr1,40315297,0.98,95,2,97,616821
chr1,40315375,0.88,68,9,77,616822
chr1,40315536,0.97,92,3,95,616823
chr1,40315870,0.97,83,3,86,616824
chr1,40315880,0.99,69,1,70,616825
chr1,40316058,0.95,72,4,76,616826
chr1,40316473,0.94,88,6,94,616827
chr1,40316644,0.78,70,20,90,616828
chr1,40316778,0.86,90,15,105,616829
chr1,40317004,0.75,74,25,99,616830
chr1,40317012,0.81,73,17,90,616831
chr1,40317294,0.88,63,9,72,616832
chr1,40317372,0.92,68,6,74,616833
chr1,40317394,0.95,78,4,82,616834
chr1,40317496,0.91,85,8,93,616835
chr1,40317520,0.97,95,3,98,616836
chr1,40318038,0.71,80,33,113,616837
chr1,40318176,0.22,17,61,78,616838
chr1,40318385,0.92,67,6,73,616839
chr1,40318387,0.95,74,4,78,616840
chr1,40318415,0.92,77,7,84,616841
chr1,40318469,0.9,78,9,87,616842
chr1,40318514,0.95,92,5,97,616843
chr1,40318924,0.83,89,18,107,616844
chr1,40319008,0.91,91,9,100,616845
chr1,40319068,0.93,54,4,58,616846
chr1,40319099,0.98,45,1,46,616847
chr1,40319129,1,43,0,43,616848
chr1,40319154,1,53,0,53,616849
chr1,40319214,0.96,73,3,76,616850
chr1,40319256,0.95,76,4,80,616851
chr1,40319303,0.96,55,2,57,616852
chr1,40319375,0.98,58,1,59,616853
chr1,40319624,0.98,80,2,82,616854
chr1,40319721,1,99,0,99,616855
chr1,40319763,0.96,91,4,95,616856
chr1,40319864,0.94,81,5,86,616857
chr1,40320470,0.95,130,7,137,616858
chr1,40320499,0.97,112,4,116,616859
chr1,40320574,0.96,87,4,91,616860
chr1,40320576,0.96,87,4,91,616861
chr1,40320613,0.96,89,4,93,616862
chr1,40320638,0.96,81,3,84,616863
chr1,40320718,0.89,54,7,61,616864
chr1,40320803,1,69,0,69,616865
chr1,40320813,0.91,70,7,77,616866
chr1,40320823,0.97,74,2,76,616867
chr1,40320954,1,66,0,66,616868
chr1,40321445,0.95,36,2,38,616869
chr1,40321547,0.94,46,3,49,616870
chr1,40321575,1,66,0,66,616871
chr1,40321615,0.95,83,4,87,616872
chr1,40321700,0.95,97,5,102,616873
chr1,40321744,0.98,91,2,93,616874
chr1,40321760,0.97,85,3,88,616875
chr1,40321774,0.99,85,1,86,616876
chr1,40321805,0.98,81,2,83,616877
chr1,40321909,1,70,0,70,616878
chr1,40321932,0.97,59,2,61,616879
chr1,40321934,1,63,0,63,616880
chr1,40321972,0.97,63,2,65,616881
chr1,40322053,0.98,79,2,81,616882
chr1,40322109,0.93,43,3,46,616883
chr1,40322185,0.78,28,8,36,616884
chr1,40322476,0.97,116,4,120,616885
chr1,40322503,0.97,97,3,100,616886
chr1,40322668,1,98,0,98,616887
chr1,40323028,0.97,74,2,76,616888
chr1,40323249,0.98,39,1,40,616889
chr1,40323368,0.84,81,16,97,616890
chr1,40323740,0.61,82,52,134,616891
chr1,40323896,0.94,72,5,77,616892
chr1,40323935,0.83,49,10,59,616893
chr1,40323953,0.77,51,15,66,616894
chr1,40324005,0.99,70,1,71,616895
chr1,40324054,0.89,75,9,84,616896
chr1,40324383,0.89,85,10,95,616897
chr1,40324646,0.45,35,42,77,616898
chr1,40324650,0.93,65,5,70,616899
chr1,40324665,0.94,72,5,77,616900
chr1,40324699,0.96,73,3,76,616901
chr1,40324706,0.96,70,3,73,616902
chr1,40324720,0.97,74,2,76,616903
chr1,40324789,0.99,82,1,83,616904
chr1,40324794,0.94,79,5,84,616905
chr1,40324842,0.99,79,1,80,616906
chr1,40324884,0.92,56,5,61,616907
chr1,40324892,1,60,0,60,616908
chr1,40324921,0.96,49,2,51,616909
chr1,40324927,0.95,42,2,44,616910
chr1,40324969,0.86,24,4,28,616911
chr1,40324985,0.96,46,2,48,616912
chr1,40325086,0.96,75,3,78,616913
chr1,40325141,0.95,86,5,91,616914
chr1,40325186,0.99,69,1,70,616915
chr1,40325198,0.97,60,2,62,616916
chr1,40325203,0.95,53,3,56,616917
chr1,40325689,0.83,100,20,120,616918
chr1,40326048,0.93,91,7,98,616919
chr1,40326097,0.96,86,4,90,616920
chr1,40326106,0.97,85,3,88,616921
chr1,40326371,0.91,93,9,102,616922
chr1,40326473,0.97,59,2,61,616923
chr1,40326475,0.9,55,6,61,616924
chr1,40326517,0.97,72,2,74,616925
chr1,40326578,0.96,73,3,76,616926
chr1,40326610,1,84,0,84,616927
chr1,40326618,1,84,0,84,616928
chr1,40326622,0.99,87,1,88,616929
chr1,40326663,0.96,100,4,104,616930
chr1,40326673,1,105,0,105,616931
chr1,40326677,0.98,103,2,105,616932
chr1,40326727,0.96,80,3,83,616933
chr1,40326730,0.99,79,1,80,616934
chr1,40326896,0.97,86,3,89,616935
chr1,40326917,0.97,71,2,73,616936
chr1,40327008,0.99,81,1,82,616937
chr1,40327015,0.97,76,2,78,616938
chr1,40327271,0.99,112,1,113,616939
chr1,40327319,1,88,0,88,616940
chr1,40327323,0.97,83,3,86,616941
chr1,40327331,0.85,62,11,73,616942
chr1,40327393,0.98,44,1,45,616943
chr1,40327456,0.98,55,1,56,616944
chr1,40327550,0.95,54,3,57,616945
chr1,40327560,1,50,0,50,616946
chr1,40327722,0.99,84,1,85,616947
chr1,40327789,0.95,91,5,96,616948
chr1,40327951,0.94,64,4,68,616949
chr1,40328112,1,92,0,92,616950
chr1,40328791,0.94,92,6,98,616951
chr1,40328859,0.99,92,1,93,616952
chr1,40328892,0.89,74,9,83,616953
chr1,40328945,0.98,65,1,66,616954
chr1,40329007,0.98,56,1,57,616955
chr1,40329016,0.95,57,3,60,616956
chr1,40329341,0.98,93,2,95,616957
chr1,40329639,0.97,62,2,64,616958
chr1,40329720,0.96,76,3,79,616959
chr1,40329746,0.99,82,1,83,616960
chr1,40329777,0.96,78,3,81,616961
chr1,40329809,1,85,0,85,616962
chr1,40330007,1,33,0,33,616963
chr1,40330009,0.97,30,1,31,616964
chr1,40330063,0.94,17,1,18,616965
chr1,40330077,0.95,19,1,20,616966
chr1,40330137,1,35,0,35,616967
chr1,40330141,1,35,0,35,616968
chr1,40330153,1,38,0,38,616969
chr1,40330173,0.88,46,6,52,616970
chr1,40330205,0.94,44,3,47,616971
chr1,40330212,1,42,0,42,616972
chr1,40330237,1,45,0,45,616973
chr1,40330256,0.97,32,1,33,616974
chr1,40330296,0.92,23,2,25,616975
chr1,40330335,0.97,70,2,72,616976
chr1,40330381,0.95,88,5,93,616977
chr1,40330476,0.86,91,15,106,616978
chr1,40331246,0.98,95,2,97,616979
chr1,40331264,0.91,89,9,98,616980
chr1,40331507,0.94,76,5,81,616981
chr1,40331947,0.97,77,2,79,616982
chr1,40332001,0.98,102,2,104,616983
chr1,40332040,0.88,105,15,120,616984
chr1,40332164,0.93,75,6,81,616985
chr1,40332423,0.99,82,1,83,616986
chr1,40332534,0.8,78,19,97,616987
chr1,40332766,0.88,52,7,59,616988
chr1,40332847,0.98,59,1,60,616989
chr1,40332886,0.9,65,7,72,616990
chr1,40332894,0.96,66,3,69,616991
chr1,40332942,0.91,71,7,78,616992
chr1,40333005,0.91,41,4,45,616993
chr1,40333036,0.93,38,3,41,616994
chr1,40333059,0.97,30,1,31,616995
chr1,40333063,0.98,45,1,46,616996
chr1,40333108,1,70,0,70,616997
chr1,40333292,0.92,83,7,90,616998
chr1,40333387,0.51,54,51,105,616999
chr1,40333634,0.95,38,2,40,617000
chr1,40333647,0.98,39,1,40,617001
chr1,40333655,0.95,35,2,37,617002
chr1,40333685,0.74,34,12,46,617003
chr1,40333702,1,49,0,49,617004
chr1,40333709,0.95,58,3,61,617005
chr1,40333765,0.94,87,6,93,617006
chr1,40333808,0.86,79,13,92,617007
chr1,40333819,0.91,81,8,89,617008
chr1,40333839,0.97,72,2,74,617009
chr1,40333853,0.96,70,3,73,617010
chr1,40333979,0.95,72,4,76,617011
chr1,40334052,0.91,58,6,64,617012
chr1,40334112,0.97,67,2,69,617013
chr1,40334176,0.95,58,3,61,617014
chr1,40334240,0.91,31,3,34,617015
chr1,40334270,0.97,31,1,32,617016
chr1,40334272,0.96,27,1,28,617017
chr1,40334294,0.96,27,1,28,617018
chr1,40334372,0.88,59,8,67,617019
chr1,40334457,0.98,62,1,63,617020
chr1,40334469,0.98,57,1,58,617021
chr1,40334497,1,55,0,55,617022
chr1,40334502,0.98,52,1,53,617023
chr1,40334547,0.87,60,9,69,617024
chr1,40334560,0.96,66,3,69,617025
chr1,40334592,0.96,73,3,76,617026
chr1,40334624,0.98,62,1,63,617027
chr1,40334646,0.98,56,1,57,617028
chr1,40334655,0.95,54,3,57,617029
chr1,40334680,0.98,53,1,54,617030
chr1,40334686,1,50,0,50,617031
chr1,40334846,1,32,0,32,617032
chr1,40334854,1,32,0,32,617033
chr1,40334899,0.95,41,2,43,617034
chr1,40334919,1,35,0,35,617035
chr1,40334923,1,38,0,38,617036
chr1,40334926,0.97,37,1,38,617037
chr1,40334931,0.92,35,3,38,617038
chr1,40334973,0.97,32,1,33,617039
chr1,40334976,0.94,30,2,32,617040
chr1,40334985,1,21,0,21,617041
chr1,40335008,1,25,0,25,617042
chr1,40335010,1,25,0,25,617043
chr1,40335028,0.93,28,2,30,617044
chr1,40335036,0.95,38,2,40,617045
chr1,40335044,0.95,42,2,44,617046
chr1,40335056,0.94,50,3,53,617047
chr1,40335120,0.98,61,1,62,617048
chr1,40335143,1,54,0,54,617049
chr1,40335168,0.95,42,2,44,617050
chr1,40335187,0.9,27,3,30,617051
chr1,40335191,0.97,32,1,33,617052
chr1,40335199,0.94,33,2,35,617053
chr1,40335210,0.89,32,4,36,617054
chr1,40335238,0.93,25,2,27,617055
chr1,40335266,0.97,31,1,32,617056
chr1,40335270,1,30,0,30,617057
chr1,40335293,1,35,0,35,617058
chr1,40335303,0.93,25,2,27,617059
chr1,40335307,1,33,0,33,617060
chr1,40335333,0.87,39,6,45,617061
chr1,40335344,1,45,0,45,617062
chr1,40335347,1,47,0,47,617063
chr1,40335354,0.91,42,4,46,617064
chr1,40335372,0.97,35,1,36,617065
chr1,40335388,1,35,0,35,617066
chr1,40335422,1,28,0,28,617067
chr1,40335426,0.96,24,1,25,617068
chr1,40335452,0.95,20,1,21,617069
chr1,40335462,0.95,21,1,22,617070
chr1,40335466,0.96,23,1,24,617071
chr1,40335471,0.96,25,1,26,617072
chr1,40335495,1,27,0,27,617073
chr1,40335499,1,36,0,36,617074
chr1,40335506,0.95,37,2,39,617075
chr1,40335511,0.95,42,2,44,617076
chr1,40335529,0.95,39,2,41,617077
chr1,40335580,0.94,50,3,53,617078
chr1,40335588,0.96,48,2,50,617079
chr1,40335593,0.98,51,1,52,617080
chr1,40335597,1,51,0,51,617081
chr1,40335604,0.98,47,1,48,617082
chr1,40335611,1,40,0,40,617083
chr1,40335630,0.92,48,4,52,617084
chr1,40335658,0.98,49,1,50,617085
chr1,40335662,0.97,36,1,37,617086
chr1,40335670,0.94,49,3,52,617087
chr1,40335704,0.97,58,2,60,617088
chr1,40335717,1,58,0,58,617089
chr1,40335723,1,58,0,58,617090
chr1,40335943,0.92,12,1,13,617091
chr1,40335990,0.94,29,2,31,617092
chr1,40336044,0.92,11,1,12,617093
chr1,40336052,0.91,10,1,11,617094
chr1,40336154,0.98,46,1,47,617095
chr1,40336248,1,39,0,39,617096
chr1,40336277,0.95,41,2,43,617097
chr1,40336350,0.9,60,7,67,617098
chr1,40336591,0.98,92,2,94,617099
chr1,40336593,0.99,92,1,93,617100
chr1,40336603,0.96,86,4,90,617101
chr1,40336640,1,68,0,68,617102
chr1,40336725,0.99,91,1,92,617103
chr1,40336731,0.96,93,4,97,617104
chr1,40336757,0.93,99,7,106,617105
chr1,40336789,0.98,86,2,88,617106
chr1,40336796,1,83,0,83,617107
chr1,40336860,0.99,74,1,75,617108
chr1,40336943,0.99,115,1,116,617109
chr1,40336972,0.98,118,3,121,617110
chr1,40337002,0.98,117,2,119,617111
chr1,40337012,0.96,111,5,116,617112
chr1,40337069,0.96,98,4,102,617113
chr1,40337080,0.98,90,2,92,617114
chr1,40337200,0.95,52,3,55,617115
chr1,40337208,1,50,0,50,617116
chr1,40337974,0.43,42,56,98,617117
chr1,40338046,0.77,92,28,120,617118
chr1,40338708,1,81,0,81,617119
chr1,40338863,0.89,67,8,75,617120
chr1,40338885,0.97,86,3,89,617121
chr1,40339112,0.97,99,3,102,617122
chr1,40339412,0.94,45,3,48,617123
chr1,40339466,0.98,65,1,66,617124
chr1,40339485,0.97,71,2,73,617125
chr1,40339493,0.99,78,1,79,617126
chr1,40339563,0.96,79,3,82,617127
chr1,40339611,0.93,69,5,74,617128
chr1,40339635,0.96,74,3,77,617129
chr1,40339674,0.96,77,3,80,617130
chr1,40339777,0.96,85,4,89,617131
chr1,40339828,0.95,83,4,87,617132
chr1,40340048,0.66,50,26,76,617133
chr1,40340367,0.86,25,4,29,617134
chr1,40340398,0.94,30,2,32,617135
chr1,40340406,0.89,33,4,37,617136
chr1,40340423,0.98,43,1,44,617137
chr1,40340559,0.98,55,1,56,617138
chr1,40340586,1,46,0,46,617139
chr1,40340619,0.94,59,4,63,617140
chr1,40340635,0.92,47,4,51,617141
chr1,40340642,0.97,65,2,67,617142
chr1,40340899,0.99,109,1,110,617143
chr1,40340927,0.88,96,13,109,617144
chr1,40340943,0.97,103,3,106,617145
chr1,40340957,0.95,81,4,85,617146
chr1,40341020,0.92,58,5,63,617147
chr1,40341032,0.95,54,3,57,617148
chr1,40341084,0.87,62,9,71,617149
chr1,40341116,0.91,48,5,53,617150
chr1,40341146,0.95,56,3,59,617151
chr1,40341558,0.87,69,10,79,617152
chr1,40341571,0.92,72,6,78,617153
chr1,40342253,0.48,38,41,79,617154
chr1,40342336,0.87,53,8,61,617155
chr1,40342364,0.91,71,7,78,617156
chr1,40342373,0.98,79,2,81,617157
chr1,40342416,0.89,54,7,61,617158
chr1,40342460,0.93,41,3,44,617159
chr1,40342468,0.97,35,1,36,617160
chr1,40342472,1,33,0,33,617161
chr1,40342548,0.91,41,4,45,617162
chr1,40343052,0.78,51,14,65,617163
chr1,40343157,0.93,104,8,112,617164
chr1,40343222,0.53,57,50,107,617165
chr1,40343352,0.78,60,17,77,617166
chr1,40343411,0.85,91,16,107,617167
chr1,40344161,0.9,89,10,99,617168
chr1,40344441,0.41,48,69,117,617169
chr1,40344667,0.97,109,3,112,617170
chr1,40344707,0.94,108,7,115,617171
chr1,40344716,0.97,107,3,110,617172
chr1,40344723,0.91,105,10,115,617173
chr1,40344737,0.96,107,4,111,617174
chr1,40344768,0.69,76,34,110,617175
chr1,40344801,0.97,86,3,89,617176
chr1,40344813,0.89,75,9,84,617177
chr1,40344833,0.9,69,8,77,617178
chr1,40344855,0.95,76,4,80,617179
chr1,40344915,0.88,66,9,75,617180
chr1,40345271,0.98,92,2,94,617181
chr1,40345320,0.99,78,1,79,617182
chr1,40345374,0.96,78,3,81,617183
chr1,40345531,0.97,37,1,38,617184
chr1,40345623,1,35,0,35,617185
chr1,40345630,1,40,0,40,617186
chr1,40345653,0.88,52,7,59,617187
chr1,40345739,0.92,71,6,77,617188
chr1,40345778,1,67,0,67,617189
chr1,40345840,0.97,60,2,62,617190
chr1,40345915,0.62,34,21,55,617191
chr1,40346198,0.98,83,2,85,617192
chr1,40346243,0.95,62,3,65,617193
chr1,40346247,1,48,0,48,617194
chr1,40346327,0.9,70,8,78,617195
chr1,40346339,0.99,82,1,83,617196
chr1,40346343,0.93,71,5,76,617197
chr1,40346363,0.95,75,4,79,617198
chr1,40346427,0.96,52,2,54,617199
chr1,40346449,0.97,35,1,36,617200
chr1,40346465,0.87,27,4,31,617201
chr1,40346530,0.96,70,3,73,617202
chr1,40346660,0.97,76,2,78,617203
chr1,40346687,1,76,0,76,617204
chr1,40346710,0.94,73,5,78,617205
chr1,40346718,0.95,75,4,79,617206
chr1,40346852,0.98,52,1,53,617207
chr1,40346854,1,54,0,54,617208
chr1,40346885,0.97,34,1,35,617209
chr1,40347075,0.91,99,10,109,617210
chr1,40347455,0.92,100,9,109,617211
chr1,40347648,0.48,52,56,108,617212
chr1,40347913,0.86,96,15,111,617213
chr1,40347917,0.71,78,32,110,617214
chr1,40348235,0.37,35,60,95,617215
chr1,40348330,0.11,13,109,122,617216
chr1,40348351,0.19,24,100,124,617217
chr1,40348359,0.17,20,98,118,617218
chr1,40348397,0.41,52,76,128,617219
chr1,40348439,0.01,1,125,126,617220
chr1,40348451,0.01,1,128,129,617221
chr1,40348465,0.11,14,112,126,617222
chr1,40348578,0.02,2,99,101,617223
chr1,40348657,0.01,1,80,81,617224
chr1,40348695,0,0,90,90,617225
chr1,40348717,0,0,80,80,617226
chr1,40348785,0,0,58,58,617227
chr1,40348788,0,0,55,55,617228
chr1,40348806,0,0,51,51,617229
chr1,40348844,0,0,41,41,617230
chr1,40348847,0,0,36,36,617231
chr1,40348888,0,0,18,18,617232
chr1,40348903,0,0,39,39,617233
chr1,40348942,0,0,43,43,617234
chr1,40348944,0.02,1,49,50,617235
chr1,40348951,0,0,64,64,617236
chr1,40348964,0,0,40,40,617237
chr1,40348968,0,0,76,76,617238
chr1,40348977,0,0,78,78,617239
chr1,40349004,0,0,83,83,617240
chr1,40349010,0,0,92,92,617241
chr1,40349019,0,0,87,87,617242
chr1,40349022,0,0,95,95,617243
chr1,40349027,0,0,88,88,617244
chr1,40349044,0,0,83,83,617245
chr1,40349050,0.01,1,89,90,617246
chr1,40349061,0.01,1,87,88,617247
chr1,40349068,0,0,85,85,617248
chr1,40349076,0,0,88,88,617249
chr1,40349102,0,0,72,72,617250
chr1,40349130,0.01,1,80,81,617251
chr1,40349141,0,0,79,79,617252
chr1,40349149,0.01,1,71,72,617253
chr1,40349154,0,0,83,83,617254
chr1,40349158,0.03,2,73,75,617255
chr1,40349178,0.03,2,68,70,617256
chr1,40349184,0,0,71,71,617257
chr1,40349187,0.01,1,76,77,617258
chr1,40349211,0.01,1,67,68,617259
chr1,40349219,0,0,53,53,617260
chr1,40349225,0,0,49,49,617261
chr1,40349227,0,0,49,49,617262
chr1,40349246,0.02,1,45,46,617263
chr1,40349270,0,0,17,17,617264
chr1,40349284,0,0,25,25,617265
chr1,40349287,0,0,29,29,617266
chr1,40349329,0.06,1,17,18,617267
chr1,40349364,0,0,30,30,617268
chr1,40349380,0.03,1,31,32,617269
chr1,40349384,0.03,1,35,36,617270
chr1,40349402,0,0,28,28,617271
chr1,40349404,0.09,3,29,32,617272
chr1,40349427,0.82,36,8,44,617273
chr1,40349466,0.45,28,34,62,617274
chr1,40349486,0.68,44,21,65,617275
chr1,40349502,0.39,36,56,92,617276
chr1,40349530,0.08,7,82,89,617277
chr1,40349561,0.77,50,15,65,617278
chr1,40349588,0.98,50,1,51,617279
chr1,40349593,0.96,47,2,49,617280
chr1,40349625,1,59,0,59,617281
chr1,40349633,0.98,62,1,63,617282
chr1,40349648,0.96,72,3,75,617283
chr1,40349687,0.42,35,48,83,617284
chr1,40349894,0.78,58,16,74,617285
chr1,40349906,0.9,74,8,82,617286
chr1,40350001,0.77,57,17,74,617287
chr1,40350037,0.86,67,11,78,617288
chr1,40350052,0.9,74,8,82,617289
chr1,40350143,0.93,77,6,83,617290
chr1,40350171,0.95,73,4,77,617291
chr1,40350175,0.91,67,7,74,617292
chr1,40350183,0.99,72,1,73,617293
chr1,40350229,0.95,82,4,86,617294
chr1,40350237,0.93,79,6,85,617295
chr1,40350254,0.93,80,6,86,617296
chr1,40350260,0.99,84,1,85,617297
chr1,40350262,0.96,79,3,82,617298
chr1,40350294,0.97,87,3,90,617299
chr1,40350302,0.82,69,15,84,617300
chr1,40350420,0.97,74,2,76,617301
chr1,40350445,0.99,81,1,82,617302
chr1,40350471,0.96,71,3,74,617303
chr1,40350478,0.91,59,6,65,617304
chr1,40350487,0.96,65,3,68,617305
chr1,40350520,0.88,45,6,51,617306
chr1,40350547,0.95,42,2,44,617307
chr1,40350578,0.97,63,2,65,617308
chr1,40350672,0.99,91,1,92,617309
chr1,40350679,1,95,0,95,617310
chr1,40350688,0.99,85,1,86,617311
chr1,40350768,0.87,67,10,77,617312
chr1,40350770,0.86,63,10,73,617313
chr1,40350869,0.9,72,8,80,617314
chr1,40350899,0.94,101,6,107,617315
chr1,40350901,0.96,102,4,106,617316
chr1,40350934,0.75,89,29,118,617317
chr1,40350962,0.92,94,8,102,617318
chr1,40350969,0.94,92,6,98,617319
chr1,40350986,0.89,75,9,84,617320
chr1,40351015,0.85,44,8,52,617321
chr1,40351295,0.89,51,6,57,617322
chr1,40351369,0.93,76,6,82,617323
chr1,40351411,0.85,51,9,60,617324
chr1,40351474,0.95,38,2,40,617325
chr1,40351573,0.23,18,61,79,617326
chr1,40351840,1,35,0,35,617327
chr1,40351852,0.93,25,2,27,617328
chr1,40351885,0.97,32,1,33,617329
chr1,40351910,0.98,39,1,40,617330
chr1,40351941,0.67,39,19,58,617331
chr1,40351984,0.96,82,3,85,617332
chr1,40352008,0.82,70,15,85,617333
chr1,40352032,0.99,79,1,80,617334
chr1,40352040,0.93,79,6,85,617335
chr1,40352047,0.99,77,1,78,617336
chr1,40352070,0.93,53,4,57,617337
chr1,40352072,1,54,0,54,617338
chr1,40352094,0.94,34,2,36,617339
chr1,40352102,0.97,29,1,30,617340
chr1,40352334,0.79,82,22,104,617341
chr1,40352443,0.96,113,5,118,617342
chr1,40352771,0.45,39,48,87,617343
chr1,40353018,0.62,31,19,50,617344
chr1,40353110,0.73,66,24,90,617345
chr1,40353495,0.68,63,30,93,617346
chr1,40353504,0.9,90,10,100,617347
chr1,40353821,0.88,37,5,42,617348
chr1,40353954,0.96,54,2,56,617349
chr1,40353960,0.96,53,2,55,617350
chr1,40353970,0.94,60,4,64,617351
chr1,40353998,0.96,67,3,70,617352
chr1,40354004,0.95,63,3,66,617353
chr1,40354007,1,66,0,66,617354
chr1,40354030,0.93,69,5,74,617355
chr1,40354058,0.81,42,10,52,617356
chr1,40354085,0.92,36,3,39,617357
chr1,40354089,0.86,31,5,36,617358
chr1,40354121,0.86,19,3,22,617359
chr1,40354160,1,38,0,38,617360
chr1,40354169,1,48,0,48,617361
chr1,40354216,0.96,52,2,54,617362
chr1,40354586,0.83,57,12,69,617363
chr1,40354698,0.73,52,19,71,617364
chr1,40354818,0.92,59,5,64,617365
chr1,40354862,0.94,74,5,79,617366
chr1,40354898,0.85,70,12,82,617367
chr1,40354902,0.9,73,8,81,617368
chr1,40354957,0.88,51,7,58,617369
chr1,40354964,0.98,51,1,52,617370
chr1,40355262,0.86,70,11,81,617371
chr1,40355321,0.96,73,3,76,617372
chr1,40355335,0.91,73,7,80,617373
chr1,40355346,0.87,66,10,76,617374
chr1,40355391,0.97,66,2,68,617375
chr1,40355395,0.93,68,5,73,617376
chr1,40355508,0.95,89,5,94,617377
chr1,40355673,0.94,46,3,49,617378
chr1,40355732,0.94,33,2,35,617379
chr1,40355749,0.9,27,3,30,617380
chr1,40356943,0.9,54,6,60,617381
chr1,40356965,0.7,35,15,50,617382
chr1,40356976,0.87,39,6,45,617383
chr1,40357292,0.48,55,59,114,617384
chr1,40357321,0.58,46,33,79,617385
chr1,40357329,0.9,62,7,69,617386
chr1,40357359,0.72,52,20,72,617387
chr1,40357361,0.57,43,32,75,617388
chr1,40357367,0.49,38,40,78,617389
chr1,40357384,0.96,74,3,77,617390
chr1,40357391,0.8,64,16,80,617391
chr1,40357399,0.88,74,10,84,617392
chr1,40357423,0.74,71,25,96,617393
chr1,40357447,0.95,94,5,99,617394
chr1,40357485,0.82,68,15,83,617395
chr1,40357516,0.97,64,2,66,617396
chr1,40357530,0.91,52,5,57,617397
chr1,40357537,0.96,54,2,56,617398
chr1,40357541,0.96,69,3,72,617399
chr1,40357584,0.98,88,2,90,617400
chr1,40357586,0.98,89,2,91,617401
chr1,40357594,0.92,89,8,97,617402
chr1,40357832,0.95,61,3,64,617403
chr1,40358044,0.8,72,18,90,617404
chr1,40358406,0.89,55,7,62,617405
chr1,40358502,0.26,20,58,78,617406
chr1,40358649,0.23,24,80,104,617407
chr1,40358675,0.06,7,106,113,617408
chr1,40358820,0.23,19,63,82,617409
chr1,40358993,0.09,4,43,47,617410
chr1,40359319,0.33,22,44,66,617411
chr1,40359646,0.99,92,1,93,617412
chr1,40359669,0.88,72,10,82,617413
chr1,40359924,0.97,104,3,107,617414
chr1,40359934,0.74,78,27,105,617415
chr1,40359956,0.98,100,2,102,617416
chr1,40360322,0.98,48,1,49,617417
chr1,40360386,0.83,50,10,60,617418
chr1,40360406,0.91,60,6,66,617419
chr1,40360519,0.89,62,8,70,617420
chr1,40360792,0.49,43,44,87,617421
chr1,40360909,0.68,81,38,119,617422
chr1,40361053,0.62,63,39,102,617423
chr1,40361753,0.83,91,18,109,617424
chr1,40361775,0.88,96,13,109,617425
chr1,40361910,0.58,53,39,92,617426
chr1,40362045,0.76,69,22,91,617427
chr1,40362151,0.96,77,3,80,617428
chr1,40362223,0.89,84,10,94,617429
chr1,40362415,0.92,36,3,39,617430
chr1,40362561,0.77,49,15,64,617431
chr1,40362814,0.5,34,34,68,617432
chr1,40362907,0.75,41,14,55,617433
chr1,40363012,0.79,49,13,62,617434
chr1,40363090,0.77,49,15,64,617435
chr1,40363096,0.78,53,15,68,617436
chr1,40363230,0.99,82,1,83,617437
chr1,40363240,0.95,80,4,84,617438
chr1,40363242,0.89,75,9,84,617439
chr1,40363246,0.87,75,11,86,617440
chr1,40363258,0.98,79,2,81,617441
chr1,40363267,0.92,73,6,79,617442
chr1,40363489,0.92,54,5,59,617443
chr1,40363564,0.82,37,8,45,617444
chr1,40363569,0.77,34,10,44,617445
chr1,40363581,0.97,38,1,39,617446
chr1,40363588,0.95,39,2,41,617447
chr1,40363648,0.77,55,16,71,617448
chr1,40363722,0.9,78,9,87,617449
chr1,40363775,0.72,46,18,64,617450
chr1,40363955,0.48,13,14,27,617451
chr1,40363981,0.42,15,21,36,617452
chr1,40364021,0.5,28,28,56,617453
chr1,40364310,0.84,64,12,76,617454
chr1,40364363,0.38,30,49,79,617455
chr1,40364366,0.86,64,10,74,617456
chr1,40364397,0.76,52,16,68,617457
chr1,40364496,0.89,50,6,56,617458
chr1,40364626,0.86,44,7,51,617459
chr1,40364632,0.95,52,3,55,617460
chr1,40364648,0.76,55,17,72,617461
chr1,40364719,0.64,62,35,97,617462
chr1,40364790,0.73,65,24,89,617463
chr1,40364870,0.73,58,22,80,617464
chr1,40365026,0.86,56,9,65,617465
chr1,40365153,0.26,25,71,96,617466
chr1,40365187,0.75,75,25,100,617467
chr1,40365212,0.84,91,17,108,617468
chr1,40365282,0.79,85,22,107,617469
chr1,40365499,0.6,62,41,103,617470
chr1,40365606,0.79,93,24,117,617471
chr1,40365681,0.9,87,10,97,617472
chr1,40365812,0.85,52,9,61,617473
chr1,40366083,0.9,46,5,51,617474
chr1,40366110,0.82,40,9,49,617475
chr1,40366178,0.66,39,20,59,617476
chr1,40366208,0.76,35,11,46,617477
chr1,40366344,0.78,31,9,40,617478
chr1,40366413,0.62,48,29,77,617479
chr1,40366447,0.08,7,81,88,617480
chr1,40366462,0,0,92,92,617481
chr1,40366477,0.05,4,84,88,617482
chr1,40366501,0.5,39,39,78,617483
chr1,40366596,0.11,7,56,63,617484
chr1,40366612,0.04,2,52,54,617485
chr1,40366617,0.07,3,41,44,617486
chr1,40366629,0.07,3,39,42,617487
chr1,40366635,0.02,1,41,42,617488
chr1,40366659,0.03,1,38,39,617489
chr1,40366666,0.02,1,42,43,617490
chr1,40366677,0.08,2,23,25,617491
chr1,40366680,0.08,2,24,26,617492
chr1,40366684,0.06,1,17,18,617493
chr1,40366687,0,0,37,37,617494
chr1,40366695,0,0,41,41,617495
chr1,40366701,0,0,41,41,617496
chr1,40366720,0,0,43,43,617497
chr1,40366725,0,0,32,32,617498
chr1,40366728,0.03,1,31,32,617499
chr1,40366732,0,0,30,30,617500
chr1,40366741,0,0,32,32,617501
chr1,40366751,0,0,41,41,617502
chr1,40366756,0.05,1,19,20,617503
chr1,40366758,0,0,19,19,617504
chr1,40366767,0.03,1,30,31,617505
chr1,40366772,0.02,1,42,43,617506
chr1,40366776,0.03,1,30,31,617507
chr1,40366796,0,0,46,46,617508
chr1,40366802,0.02,1,53,54,617509
chr1,40366807,0.02,1,50,51,617510
chr1,40366815,0,0,47,47,617511
chr1,40366832,0,0,56,56,617512
chr1,40366835,0.02,1,47,48,617513
chr1,40366848,0,0,47,47,617514
chr1,40366870,0,0,68,68,617515
chr1,40366880,0,0,67,67,617516
chr1,40366888,0.02,1,57,58,617517
chr1,40366893,0,0,64,64,617518
chr1,40366899,0,0,72,72,617519
chr1,40366911,0,0,78,78,617520
chr1,40366918,0,0,76,76,617521
chr1,40366924,0,0,75,75,617522
chr1,40366938,0.01,1,79,80,617523
chr1,40366945,0.01,1,70,71,617524
chr1,40366956,0,0,59,59,617525
chr1,40366959,0,0,78,78,617526
chr1,40366978,0,0,60,60,617527
chr1,40366981,0,0,57,57,617528
chr1,40366984,0.01,1,80,81,617529
chr1,40366993,0,0,41,41,617530
chr1,40367007,0,0,76,76,617531
chr1,40367028,0.01,1,70,71,617532
chr1,40367035,0,0,51,51,617533
chr1,40367038,0,0,67,67,617534
chr1,40367045,0,0,50,50,617535
chr1,40367061,0.02,1,51,52,617536
chr1,40367073,0,0,44,44,617537
chr1,40367092,0,0,34,34,617538
chr1,40367097,0,0,29,29,617539
chr1,40367110,0.04,1,24,25,617540
chr1,40367119,0,0,27,27,617541
chr1,40367136,0,0,19,19,617542
chr1,40367145,0,0,26,26,617543
chr1,40367152,0,0,24,24,617544
chr1,40367156,0.03,1,28,29,617545
chr1,40367160,0,0,22,22,617546
chr1,40367175,0,0,30,30,617547
chr1,40367184,0,0,29,29,617548
chr1,40367193,0,0,36,36,617549
chr1,40367200,0,0,37,37,617550
chr1,40367208,0,0,34,34,617551
chr1,40367241,0,0,28,28,617552
chr1,40367252,0,0,48,48,617553
chr1,40367254,0.02,1,43,44,617554
chr1,40367259,0.02,1,45,46,617555
chr1,40367267,0,0,50,50,617556
chr1,40367274,0.02,1,48,49,617557
chr1,40367301,0,0,48,48,617558
chr1,40367306,0.03,1,39,40,617559
chr1,40367308,0.02,1,42,43,617560
chr1,40367310,0.03,1,39,40,617561
chr1,40367316,0,0,44,44,617562
chr1,40367329,0,0,34,34,617563
chr1,40367353,0.04,1,26,27,617564
chr1,40367356,0,0,26,26,617565
chr1,40367360,0,0,39,39,617566
chr1,40367365,0,0,32,32,617567
chr1,40367381,0,0,35,35,617568
chr1,40367384,0,0,33,33,617569
chr1,40367390,0,0,30,30,617570
chr1,40367394,0,0,25,25,617571
chr1,40367400,0,0,15,15,617572
chr1,40367402,0,0,15,15,617573
chr1,40367405,0,0,33,33,617574
chr1,40367434,0,0,27,27,617575
chr1,40367439,0,0,26,26,617576
chr1,40367441,0,0,31,31,617577
chr1,40367448,0.05,1,20,21,617578
chr1,40367450,0,0,17,17,617579
chr1,40367454,0,0,27,27,617580
chr1,40367469,0,0,26,26,617581
chr1,40367482,0,0,27,27,617582
chr1,40367491,0,0,23,23,617583
chr1,40367495,0.04,1,24,25,617584
chr1,40367507,0,0,28,28,617585
chr1,40367512,0,0,30,30,617586
chr1,40367520,0,0,23,23,617587
chr1,40367523,0,0,31,31,617588
chr1,40367528,0,0,34,34,617589
chr1,40367538,0,0,30,30,617590
chr1,40367554,0,0,32,32,617591
chr1,40367562,0,0,29,29,617592
chr1,40367564,0,0,22,22,617593
chr1,40367567,0,0,24,24,617594
chr1,40367570,0,0,33,33,617595
chr1,40367576,0,0,26,26,617596
chr1,40367578,0,0,27,27,617597
chr1,40367583,0.03,1,30,31,617598
chr1,40367591,0,0,31,31,617599
chr1,40367595,0,0,14,14,617600
chr1,40367597,0.07,1,14,15,617601
chr1,40367606,0.03,1,28,29,617602
chr1,40367608,0.03,1,28,29,617603
chr1,40367610,0.03,1,28,29,617604
chr1,40367612,0.04,1,25,26,617605
chr1,40367614,0,0,20,20,617606
chr1,40367624,0,0,29,29,617607
chr1,40367628,0,0,32,32,617608
chr1,40367630,0,0,30,30,617609
chr1,40367634,0,0,32,32,617610
chr1,40367637,0,0,26,26,617611
chr1,40367642,0,0,38,38,617612
chr1,40367646,0,0,30,30,617613
chr1,40367652,0,0,37,37,617614
chr1,40367658,0,0,36,36,617615
chr1,40367661,0,0,27,27,617616
chr1,40367663,0.03,1,29,30,617617
chr1,40367669,0,0,23,23,617618
chr1,40367671,0,0,29,29,617619
chr1,40367682,0,0,28,28,617620
chr1,40367710,0,0,38,38,617621
chr1,40367713,0.03,1,30,31,617622
chr1,40367715,0,0,29,29,617623
chr1,40367717,0,0,26,26,617624
chr1,40367721,0,0,36,36,617625
chr1,40367742,0,0,29,29,617626
chr1,40367763,0,0,12,12,617627
chr1,40367783,0,0,48,48,617628
chr1,40367791,0,0,49,49,617629
chr1,40367804,0,0,39,39,617630
chr1,40367823,0,0,43,43,617631
chr1,40367827,0,0,32,32,617632
chr1,40367831,0,0,44,44,617633
chr1,40367836,0,0,58,58,617634
chr1,40367847,0.05,3,52,55,617635
chr1,40367871,0,0,46,46,617636
chr1,40367881,0,0,37,37,617637
chr1,40367904,0.02,1,50,51,617638
chr1,40367909,0,0,51,51,617639
chr1,40367912,0.02,1,43,44,617640
chr1,40367916,0,0,45,45,617641
chr1,40367923,0,0,44,44,617642
chr1,40367933,0,0,53,53,617643
chr1,40367947,0,0,60,60,617644
chr1,40367965,0,0,54,54,617645
chr1,40367991,0,0,26,26,617646
chr1,40368003,0.02,1,49,50,617647
chr1,40368005,0,0,45,45,617648
chr1,40368018,0.02,1,43,44,617649
chr1,40368021,0,0,36,36,617650
chr1,40368028,0,0,38,38,617651
chr1,40368043,0,0,25,25,617652
chr1,40368047,0,0,32,32,617653
chr1,40368052,0,0,29,29,617654
chr1,40368055,0,0,29,29,617655
chr1,40368057,0,0,35,35,617656
chr1,40368078,0.02,1,41,42,617657
chr1,40368080,0,0,34,34,617658
chr1,40368090,0,0,39,39,617659
chr1,40368120,0,0,69,69,617660
chr1,40368123,0,0,59,59,617661
chr1,40368127,0,0,73,73,617662
chr1,40368139,0,0,80,80,617663
chr1,40368142,0.01,1,81,82,617664
chr1,40368147,0,0,81,81,617665
chr1,40368184,0.03,2,77,79,617666
chr1,40368189,0.03,2,76,78,617667
chr1,40368198,0.02,2,80,82,617668
chr1,40368212,0.11,9,74,83,617669
chr1,40368217,0.03,2,78,80,617670
chr1,40368348,0.11,4,32,36,617671
chr1,40368351,0.34,10,19,29,617672
chr1,40368366,0.13,5,33,38,617673
chr1,40368379,0.18,4,18,22,617674
chr1,40368426,0.19,10,42,52,617675
chr1,40368628,0.76,65,21,86,617676
chr1,40368652,0.91,85,8,93,617677
chr1,40368663,0.97,86,3,89,617678
chr1,40368674,0.92,86,7,93,617679
chr1,40368736,0.81,51,12,63,617680
chr1,40368744,0.79,48,13,61,617681
chr1,40368815,0.76,37,12,49,617682
chr1,40368994,0.9,76,8,84,617683
chr1,40369041,0.81,88,21,109,617684
chr1,40369092,0.69,72,32,104,617685
chr1,40369103,0.7,74,32,106,617686
chr1,40369279,0.78,107,30,137,617687
chr1,40369454,0.88,43,6,49,617688
chr1,40369487,1,30,0,30,617689
chr1,40369512,0.84,31,6,37,617690
chr1,40369532,0.81,38,9,47,617691
chr1,40369573,0.94,73,5,78,617692
chr1,40369580,0.89,72,9,81,617693
chr1,40369633,0.76,48,15,63,617694
chr1,40369641,0.87,62,9,71,617695
chr1,40369648,0.86,59,10,69,617696
chr1,40369665,0.81,55,13,68,617697
chr1,40369673,0.89,56,7,63,617698
chr1,40369695,0.93,62,5,67,617699
chr1,40369703,0.96,67,3,70,617700
chr1,40370036,0.75,86,29,115,617701
chr1,40370175,0.81,43,10,53,617702
chr1,40370237,0.96,48,2,50,617703
chr1,40370245,1,51,0,51,617704
chr1,40370262,0.97,56,2,58,617705
chr1,40370270,0.96,66,3,69,617706
chr1,40370301,0.93,64,5,69,617707
chr1,40370333,0.93,75,6,81,617708
chr1,40370482,0.84,52,10,62,617709
chr1,40370627,0.82,63,14,77,617710
chr1,40370687,0.96,75,3,78,617711
chr1,40370746,0.97,89,3,92,617712
chr1,40370894,0.98,61,1,62,617713
chr1,40371045,0.91,77,8,85,617714
chr1,40371171,0.89,66,8,74,617715
chr1,40371178,0.92,67,6,73,617716
chr1,40371281,0.79,69,18,87,617717
chr1,40371303,0.93,80,6,86,617718
chr1,40372093,0.9,78,9,87,617719
chr1,40372098,0.86,83,14,97,617720
chr1,40372169,0.87,75,11,86,617721
chr1,40372244,0.98,61,1,62,617722
chr1,40372495,0.98,51,1,52,617723
chr1,40372626,1,50,0,50,617724
chr1,40372642,0.83,40,8,48,617725
chr1,40372857,0.94,100,6,106,617726
chr1,40373386,0.88,83,11,94,617727
chr1,40373426,0.78,69,20,89,617728
chr1,40374083,0.89,75,9,84,617729
chr1,40374211,0.87,76,11,87,617730
chr1,40374572,0.99,73,1,74,617731
chr1,40374633,1,74,0,74,617732
chr1,40374637,0.9,65,7,72,617733
chr1,40374662,0.99,66,1,67,617734
chr1,40374702,0.99,66,1,67,617735
chr1,40374726,0.98,56,1,57,617736
chr1,40374758,0.98,53,1,54,617737
chr1,40374762,0.98,52,1,53,617738
chr1,40374791,0.96,44,2,46,617739
chr1,40374822,0.97,61,2,63,617740
chr1,40374836,0.99,77,1,78,617741
chr1,40374880,0.89,81,10,91,617742
chr1,40374923,0.89,75,9,84,617743
chr1,40375086,0.95,86,5,91,617744
chr1,40375184,0.99,80,1,81,617745
chr1,40375530,0.69,55,25,80,617746
chr1,40375830,0.59,73,50,123,617747
chr1,40376275,0.89,86,11,97,617748
chr1,40376292,0.93,100,7,107,617749
chr1,40376299,0.95,102,5,107,617750
chr1,40376352,0.97,70,2,72,617751
chr1,40376393,0.93,53,4,57,617752
chr1,40376409,0.83,48,10,58,617753
chr1,40376433,0.78,47,13,60,617754
chr1,40376456,0.97,62,2,64,617755
chr1,40376471,0.86,59,10,69,617756
chr1,40376515,0.98,42,1,43,617757
chr1,40376531,0.81,34,8,42,617758
chr1,40376569,0.74,14,5,19,617759
chr1,40376614,0.83,33,7,40,617760
chr1,40376678,0.95,57,3,60,617761
chr1,40376709,0.93,54,4,58,617762
chr1,40376720,0.84,49,9,58,617763
chr1,40376740,0.93,56,4,60,617764
chr1,40376855,0.8,48,12,60,617765
chr1,40377028,0.91,52,5,57,617766
chr1,40377406,0.68,62,29,91,617767
chr1,40377459,0.89,93,12,105,617768
chr1,40377526,0.93,78,6,84,617769
chr1,40377632,0.9,70,8,78,617770
chr1,40377715,0.95,86,5,91,617771
chr1,40377766,0.92,99,9,108,617772
chr1,40377773,0.99,102,1,103,617773
chr1,40377813,0.98,87,2,89,617774
chr1,40377815,0.96,82,3,85,617775
chr1,40377837,0.84,58,11,69,617776
chr1,40377845,0.73,48,18,66,617777
chr1,40377899,0.93,37,3,40,617778
chr1,40377935,1,62,0,62,617779
chr1,40377954,0.94,66,4,70,617780
chr1,40378136,0.93,42,3,45,617781
chr1,40378192,0.88,50,7,57,617782
chr1,40378476,1,32,0,32,617783
chr1,40378573,0.84,21,4,25,617784
chr1,40378719,1,7,0,7,617785
chr1,40378721,0.75,3,1,4,617786
chr1,40378725,1,8,0,8,617787
chr1,40378735,1,6,0,6,617788
chr1,40378749,1,13,0,13,617789
chr1,40378753,0.93,14,1,15,617790
chr1,40378758,0.93,14,1,15,617791
chr1,40378766,0.83,15,3,18,617792
chr1,40378770,0.95,19,1,20,617793
chr1,40378798,0.92,24,2,26,617794
chr1,40378802,0.88,22,3,25,617795
chr1,40378807,0.96,23,1,24,617796
chr1,40378815,0.86,25,4,29,617797
chr1,40378819,0.93,27,2,29,617798
chr1,40378847,0.87,33,5,38,617799
chr1,40378851,0.74,28,10,38,617800
chr1,40378863,0.95,36,2,38,617801
chr1,40378867,0.97,34,1,35,617802
chr1,40378873,0.97,32,1,33,617803
chr1,40378891,0.9,52,6,58,617804
chr1,40378907,0.98,45,1,46,617805
chr1,40378931,0.92,34,3,37,617806
chr1,40378936,1,34,0,34,617807
chr1,40378947,0.97,28,1,29,617808
chr1,40378971,0.4,8,12,20,617809
chr1,40379011,0.92,12,1,13,617810
chr1,40379016,0.93,14,1,15,617811
chr1,40379020,0.67,10,5,15,617812
chr1,40379030,1,20,0,20,617813
chr1,40379044,1,29,0,29,617814
chr1,40379048,0.97,30,1,31,617815
chr1,40379053,0.94,33,2,35,617816
chr1,40379085,0.92,33,3,36,617817
chr1,40379092,0.97,32,1,33,617818
chr1,40379096,0.91,32,3,35,617819
chr1,40379106,0.97,33,1,34,617820
chr1,40379132,1,28,0,28,617821
chr1,40379136,1,26,0,26,617822
chr1,40379146,1,24,0,24,617823
chr1,40379172,0.9,19,2,21,617824
chr1,40379176,0.95,18,1,19,617825
chr1,40379186,0.93,13,1,14,617826
chr1,40379241,0.75,3,1,4,617827
chr1,40379248,1,2,0,2,617828
chr1,40379280,1,5,0,5,617829
chr1,40379288,1,10,0,10,617830
chr1,40379292,1,13,0,13,617831
chr1,40379311,0.91,21,2,23,617832
chr1,40379363,0.96,51,2,53,617833
chr1,40379372,0.94,47,3,50,617834
chr1,40379415,0.94,33,2,35,617835
chr1,40379423,0.93,38,3,41,617836
chr1,40379435,1,47,0,47,617837
chr1,40379443,0.98,39,1,40,617838
chr1,40379451,1,44,0,44,617839
chr1,40379460,0.98,45,1,46,617840
chr1,40379469,0.94,47,3,50,617841
chr1,40379471,0.98,50,1,51,617842
chr1,40379506,0.97,60,2,62,617843
chr1,40379514,0.95,63,3,66,617844
chr1,40379533,0.99,70,1,71,617845
chr1,40379548,0.97,61,2,63,617846
chr1,40379553,0.95,62,3,65,617847
chr1,40379556,0.97,62,2,64,617848
chr1,40379560,0.98,62,1,63,617849
chr1,40379570,0.94,51,3,54,617850
chr1,40379580,0.96,45,2,47,617851
chr1,40379625,0.89,17,2,19,617852
chr1,40379642,0.88,7,1,8,617853
chr1,40379657,1,4,0,4,617854
chr1,40379674,0.75,3,1,4,617855
chr1,40379699,0.5,1,1,2,617856
chr1,40379761,0.6,6,4,10,617857
chr1,40379852,0.97,33,1,34,617858
chr1,40379858,1,40,0,40,617859
chr1,40379892,1,59,0,59,617860
chr1,40379906,0.94,60,4,64,617861
chr1,40379936,0.98,60,1,61,617862
chr1,40379938,0.97,57,2,59,617863
chr1,40379994,0.88,56,8,64,617864
chr1,40380091,0.95,55,3,58,617865
chr1,40380100,0.9,56,6,62,617866
chr1,40380239,0.79,30,8,38,617867
chr1,40380428,0.96,68,3,71,617868
chr1,40380451,0.95,72,4,76,617869
chr1,40380543,0.95,74,4,78,617870
chr1,40380559,0.97,77,2,79,617871
chr1,40380645,0.97,77,2,79,617872
chr1,40380694,0.95,81,4,85,617873
chr1,40380717,0.98,86,2,88,617874
chr1,40380725,0.99,80,1,81,617875
chr1,40380833,0.93,86,6,92,617876
chr1,40380936,0.94,77,5,82,617877
chr1,40381072,0.93,70,5,75,617878
chr1,40381119,0.85,56,10,66,617879
chr1,40381124,0.92,57,5,62,617880
chr1,40381365,0.79,79,21,100,617881
chr1,40381452,0.84,69,13,82,617882
chr1,40381619,0.8,57,14,71,617883
chr1,40381623,0.87,55,8,63,617884
chr1,40381709,0.88,78,11,89,617885
chr1,40381745,0.91,84,8,92,617886
chr1,40382238,0.98,51,1,52,617887
chr1,40382254,0.87,54,8,62,617888
chr1,40382306,0.81,46,11,57,617889
chr1,40382412,0.91,20,2,22,617890
chr1,40382445,0.82,37,8,45,617891
chr1,40382455,0.78,36,10,46,617892
chr1,40382457,0.92,46,4,50,617893
chr1,40382464,0.84,49,9,58,617894
chr1,40382488,0.77,49,15,64,617895
chr1,40382677,0.82,51,11,62,617896
chr1,40382703,0.89,65,8,73,617897
chr1,40382724,0.96,81,3,84,617898
chr1,40382749,0.89,85,10,95,617899
chr1,40382761,0.96,97,4,101,617900
chr1,40382837,0.77,65,19,84,617901
chr1,40383082,0.97,88,3,91,617902
chr1,40383092,0.92,91,8,99,617903
chr1,40383105,0.96,95,4,99,617904
chr1,40383134,0.8,95,24,119,617905
chr1,40383145,0.9,104,12,116,617906
chr1,40383194,0.83,75,15,90,617907
chr1,40383262,0.98,86,2,88,617908
chr1,40383276,0.96,92,4,96,617909
chr1,40383283,0.92,89,8,97,617910
chr1,40383320,0.73,76,28,104,617911
chr1,40383336,0.76,83,26,109,617912
chr1,40383778,0.88,59,8,67,617913
chr1,40383869,0.94,90,6,96,617914
chr1,40383897,0.93,76,6,82,617915
chr1,40383909,0.96,69,3,72,617916
chr1,40383933,0.92,55,5,60,617917
chr1,40383989,0.9,44,5,49,617918
chr1,40383997,0.87,45,7,52,617919
chr1,40384108,0.92,45,4,49,617920
chr1,40384297,0.54,15,13,28,617921
chr1,40384328,0.76,50,16,66,617922
chr1,40384351,0.99,75,1,76,617923
chr1,40384489,0.88,86,12,98,617924
chr1,40384499,0.85,87,15,102,617925
chr1,40384515,0.81,92,21,113,617926
chr1,40384553,0.82,110,24,134,617927
chr1,40384676,0.92,80,7,87,617928
chr1,40384944,0.96,74,3,77,617929
chr1,40385082,0.79,70,19,89,617930
chr1,40385274,0.85,62,11,73,617931
chr1,40385427,0.19,15,66,81,617932
chr1,40385466,0.24,18,57,75,617933
chr1,40385619,0.94,61,4,65,617934
chr1,40385654,0.98,56,1,57,617935
chr1,40385671,0.91,50,5,55,617936
chr1,40385686,0.86,49,8,57,617937
chr1,40385775,0.97,100,3,103,617938
chr1,40385826,0.96,106,4,110,617939
chr1,40385944,0.75,6,2,8,617940
chr1,40385977,1,16,0,16,617941
chr1,40385981,1,20,0,20,617942
chr1,40385988,0.96,25,1,26,617943
chr1,40385994,0.97,29,1,30,617944
chr1,40386020,0.98,47,1,48,617945
chr1,40386022,0.96,49,2,51,617946
chr1,40386062,0.87,52,8,60,617947
chr1,40386078,1,57,0,57,617948
chr1,40386098,0.98,43,1,44,617949
chr1,40386137,1,26,0,26,617950
chr1,40386200,0.94,46,3,49,617951
chr1,40386488,1,71,0,71,617952
chr1,40386548,1,67,0,67,617953
chr1,40386556,0.98,59,1,60,617954
chr1,40386572,0.98,60,1,61,617955
chr1,40386580,1,60,0,60,617956
chr1,40386822,0.99,73,1,74,617957
chr1,40386824,0.92,66,6,72,617958
chr1,40386951,0.81,63,15,78,617959
chr1,40387009,0.93,42,3,45,617960
chr1,40387038,0.91,49,5,54,617961
chr1,40387042,0.96,52,2,54,617962
chr1,40387058,0.97,61,2,63,617963
chr1,40387158,0.95,94,5,99,617964
chr1,40387196,0.98,97,2,99,617965
chr1,40387364,0.84,73,14,87,617966
chr1,40387400,1,77,0,77,617967
chr1,40387418,0.9,78,9,87,617968
chr1,40387472,0.81,69,16,85,617969
chr1,40387505,0.76,64,20,84,617970
chr1,40387559,0.6,51,34,85,617971
chr1,40387610,0.98,83,2,85,617972
chr1,40387667,0.99,104,1,105,617973
chr1,40387766,0.83,110,23,133,617974
chr1,40387813,0.89,104,13,117,617975
chr1,40387885,0.94,80,5,85,617976
chr1,40387896,0.39,32,51,83,617977
chr1,40387908,0.56,40,32,72,617978
chr1,40387946,0.78,39,11,50,617979
chr1,40388007,0.31,14,31,45,617980
chr1,40388041,0.7,30,13,43,617981
chr1,40388052,0.25,11,33,44,617982
chr1,40388081,0.54,15,13,28,617983
chr1,40388106,0.32,12,26,38,617984
chr1,40388149,0.03,1,31,32,617985
chr1,40388156,0.21,8,31,39,617986
chr1,40388160,0.09,3,31,34,617987
chr1,40388163,0.12,4,29,33,617988
chr1,40388179,0.4,12,18,30,617989
chr1,40388181,0.31,10,22,32,617990
chr1,40388190,0.47,16,18,34,617991
chr1,40388220,0.38,17,28,45,617992
chr1,40388223,0.52,22,20,42,617993
chr1,40388241,0.17,8,40,48,617994
chr1,40388257,0.24,12,39,51,617995
chr1,40388264,0.44,23,29,52,617996
chr1,40388271,0.17,11,54,65,617997
chr1,40388296,0.26,15,43,58,617998
chr1,40388298,0.26,15,43,58,617999
chr1,40388311,0.23,17,56,73,618000
chr1,40388329,0.05,4,75,79,618001
chr1,40388331,0.07,5,69,74,618002
chr1,40388353,0.16,17,87,104,618003
chr1,40388375,0.3,33,76,109,618004
chr1,40388395,0.29,35,85,120,618005
chr1,40388409,0.32,41,88,129,618006
chr1,40388427,0.36,45,80,125,618007
chr1,40388434,0.52,65,60,125,618008
chr1,40388470,0.53,59,52,111,618009
chr1,40388539,0.22,12,43,55,618010
chr1,40388595,0.62,23,14,37,618011
chr1,40388617,0.74,43,15,58,618012
chr1,40388645,0.9,63,7,70,618013
chr1,40388659,0.9,72,8,80,618014
chr1,40388680,0.94,80,5,85,618015
chr1,40388726,0.95,82,4,86,618016
chr1,40388772,0.99,86,1,87,618017
chr1,40388776,0.96,85,4,89,618018
chr1,40388825,0.99,90,1,91,618019
chr1,40388961,0.92,65,6,71,618020
chr1,40388967,1,63,0,63,618021
chr1,40388977,0.92,56,5,61,618022
chr1,40389037,0.99,66,1,67,618023
chr1,40389068,0.98,78,2,80,618024
chr1,40389132,0.95,78,4,82,618025
chr1,40389164,0.97,85,3,88,618026
chr1,40389234,0.95,39,2,41,618027
chr1,40389416,0.98,102,2,104,618028
chr1,40389552,0.98,64,1,65,618029
chr1,40389559,0.98,64,1,65,618030
chr1,40389623,0.96,78,3,81,618031
chr1,40389679,0.94,78,5,83,618032
chr1,40389718,0.86,64,10,74,618033
chr1,40389965,0.98,104,2,106,618034
chr1,40389978,0.95,103,5,108,618035
chr1,40390056,0.94,116,8,124,618036
chr1,40390374,0,0,52,52,618037
chr1,40390660,0.94,83,5,88,618038
chr1,40390779,0.98,60,1,61,618039
chr1,40390970,0.93,68,5,73,618040
chr1,40391026,0.98,91,2,93,618041
chr1,40391628,0.86,66,11,77,618042
chr1,40391944,0.86,49,8,57,618043
chr1,40392055,0.59,39,27,66,618044
chr1,40392088,0.59,29,20,49,618045
chr1,40392128,0.18,12,54,66,618046
chr1,40392292,0.81,94,22,116,618047
chr1,40392327,0.33,34,68,102,618048
chr1,40392447,0.43,37,50,87,618049
chr1,40392459,0.46,39,45,84,618050
chr1,40392558,0.05,4,75,79,618051
chr1,40392585,0.4,29,44,73,618052
chr1,40392646,0.73,35,13,48,618053
chr1,40392649,0.77,36,11,47,618054
chr1,40392714,0.29,18,45,63,618055
chr1,40392806,0.34,29,57,86,618056
chr1,40393066,0.93,66,5,71,618057
chr1,40393299,0.85,60,11,71,618058
chr1,40393329,0.77,49,15,64,618059
chr1,40393334,0.77,46,14,60,618060
chr1,40394049,1,87,0,87,618061
chr1,40394084,0.99,81,1,82,618062
chr1,40394140,1,66,0,66,618063
chr1,40394154,0.91,63,6,69,618064
chr1,40394185,0.97,72,2,74,618065
chr1,40394204,0.97,76,2,78,618066
chr1,40394206,0.97,71,2,73,618067
chr1,40394249,0.91,75,7,82,618068
chr1,40394265,0.92,80,7,87,618069
chr1,40394320,0.98,94,2,96,618070
chr1,40394535,0.92,70,6,76,618071
chr1,40394597,0.9,66,7,73,618072
chr1,40394748,0.74,46,16,62,618073
chr1,40394919,0.94,51,3,54,618074
chr1,40395129,1,61,0,61,618075
chr1,40395192,0.79,59,16,75,618076
chr1,40395270,0.98,107,2,109,618077
chr1,40395278,0.93,101,8,109,618078
chr1,40395282,0.95,103,5,108,618079
chr1,40395400,0.88,91,13,104,618080
chr1,40395556,0.84,27,5,32,618081
chr1,40395653,0.97,86,3,89,618082
chr1,40395663,0.99,81,1,82,618083
chr1,40395994,0.99,67,1,68,618084
chr1,40396158,0.8,61,15,76,618085
chr1,40396213,0.97,71,2,73,618086
chr1,40396228,1,66,0,66,618087
chr1,40396240,1,62,0,62,618088
chr1,40396304,0.95,82,4,86,618089
chr1,40396308,0.95,79,4,83,618090
chr1,40396425,1,46,0,46,618091
chr1,40396442,0.95,39,2,41,618092
chr1,40396474,0.97,29,1,30,618093
chr1,40396571,0.94,49,3,52,618094
chr1,40396582,0.91,48,5,53,618095
chr1,40396727,0.96,49,2,51,618096
chr1,40396971,0.99,67,1,68,618097
chr1,40397114,0.96,47,2,49,618098
chr1,40397118,0.96,48,2,50,618099
chr1,40397194,0.91,30,3,33,618100
chr1,40397356,0.95,112,6,118,618101
chr1,40397370,0.94,119,8,127,618102
chr1,40397388,0.91,126,13,139,618103
chr1,40397482,0.88,127,17,144,618104
chr1,40397639,0.93,78,6,84,618105
chr1,40397698,0.85,86,15,101,618106
chr1,40397728,0.93,99,7,106,618107
chr1,40398008,0.98,44,1,45,618108
chr1,40398020,0.95,40,2,42,618109
chr1,40398147,0.97,58,2,60,618110
chr1,40398201,0.9,46,5,51,618111
chr1,40398317,0.93,50,4,54,618112
chr1,40398333,0.98,60,1,61,618113
chr1,40398345,0.91,59,6,65,618114
chr1,40398361,0.89,58,7,65,618115
chr1,40398510,0.85,46,8,54,618116
chr1,40398574,1,40,0,40,618117
chr1,40398582,0.98,39,1,40,618118
chr1,40398638,0.99,70,1,71,618119
chr1,40398741,0.83,58,12,70,618120
chr1,40398832,0.97,66,2,68,618121
chr1,40398849,0.98,62,1,63,618122
chr1,40399111,0.89,24,3,27,618123
chr1,40399116,1,21,0,21,618124
chr1,40399120,1,7,0,7,618125
chr1,40399206,0.95,69,4,73,618126
chr1,40399216,0.83,59,12,71,618127
chr1,40399260,0.75,67,22,89,618128
chr1,40399270,0.84,78,15,93,618129
chr1,40399277,0.99,81,1,82,618130
chr1,40399327,0.85,60,11,71,618131
chr1,40399340,0.89,68,8,76,618132
chr1,40399621,0.81,83,19,102,618133
chr1,40399639,0.76,74,24,98,618134
chr1,40399833,0.64,54,31,85,618135
chr1,40399883,0.69,48,22,70,618136
chr1,40399999,0.83,50,10,60,618137
chr1,40400055,0.57,39,29,68,618138
chr1,40400145,0.66,70,36,106,618139
chr1,40400163,0.86,85,14,99,618140
chr1,40400211,0.87,75,11,86,618141
chr1,40400248,0.51,42,40,82,618142
chr1,40400257,0.63,59,34,93,618143
chr1,40400391,0.52,61,57,118,618144
chr1,40400505,0.37,56,95,151,618145
chr1,40400661,1,59,0,59,618146
chr1,40400665,0.97,56,2,58,618147
chr1,40400669,0.98,50,1,51,618148
chr1,40400681,0.9,44,5,49,618149
chr1,40400709,0.97,33,1,34,618150
chr1,40400714,1,32,0,32,618151
chr1,40400741,0.95,42,2,44,618152
chr1,40400801,0.65,56,30,86,618153
chr1,40400837,0.92,79,7,86,618154
chr1,40400893,0.95,52,3,55,618155
chr1,40400901,0.98,46,1,47,618156
chr1,40401385,0.95,86,5,91,618157
chr1,40401486,0.87,65,10,75,618158
chr1,40401783,0.9,53,6,59,618159
chr1,40401898,0.7,57,25,82,618160
chr1,40401936,0.93,81,6,87,618161
chr1,40401993,0.56,54,42,96,618162
chr1,40402036,0.87,86,13,99,618163
chr1,40402040,0.91,79,8,87,618164
chr1,40402060,0.79,74,20,94,618165
chr1,40402117,0.74,56,20,76,618166
chr1,40402157,0.96,74,3,77,618167
chr1,40402324,0.75,36,12,48,618168
chr1,40402361,0.79,33,9,42,618169
chr1,40402384,0.88,35,5,40,618170
chr1,40402496,0.93,83,6,89,618171
chr1,40402527,0.86,67,11,78,618172
chr1,40403630,0.73,55,20,75,618173
chr1,40403721,0.94,67,4,71,618174
chr1,40403782,0.98,63,1,64,618175
chr1,40403915,0.96,64,3,67,618176
chr1,40403928,0.91,53,5,58,618177
chr1,40403942,0.95,59,3,62,618178
chr1,40403978,0.88,59,8,67,618179
chr1,40404111,0.94,50,3,53,618180
chr1,40404215,0.91,30,3,33,618181
chr1,40404232,0.98,44,1,45,618182
chr1,40404249,0.96,51,2,53,618183
chr1,40404307,0.9,75,8,83,618184
chr1,40404337,0.9,55,6,61,618185
chr1,40404350,0.65,31,17,48,618186
chr1,40404391,0.95,38,2,40,618187
chr1,40404395,0.97,56,2,58,618188
chr1,40404440,0.95,90,5,95,618189
chr1,40404658,0.98,58,1,59,618190
chr1,40404766,1,76,0,76,618191
chr1,40404816,0.96,74,3,77,618192
chr1,40404837,0.87,71,11,82,618193
chr1,40404859,0.93,83,6,89,618194
chr1,40404861,0.99,86,1,87,618195
chr1,40404909,1,96,0,96,618196
chr1,40404917,0.93,88,7,95,618197
chr1,40404998,0.95,53,3,56,618198
chr1,40405008,0.92,49,4,53,618199
chr1,40405030,0.96,54,2,56,618200
chr1,40405046,0.97,59,2,61,618201
chr1,40405431,0.96,76,3,79,618202
chr1,40405765,0.95,84,4,88,618203
chr1,40405830,0.95,88,5,93,618204
chr1,40405840,0.94,87,6,93,618205
chr1,40406061,0.41,54,78,132,618206
chr1,40406064,0.65,67,36,103,618207
chr1,40406133,0.87,82,12,94,618208
chr1,40406191,0.92,45,4,49,618209
chr1,40406204,0.73,37,14,51,618210
chr1,40406412,0.86,55,9,64,618211
chr1,40406432,0.84,58,11,69,618212
chr1,40406482,0.7,51,22,73,618213
chr1,40406489,0.96,69,3,72,618214
chr1,40406513,0.83,60,12,72,618215
chr1,40406518,0.98,82,2,84,618216
chr1,40406547,0.82,74,16,90,618217
chr1,40406614,0.76,58,18,76,618218
chr1,40406759,0.83,45,9,54,618219
chr1,40406831,0.97,63,2,65,618220
chr1,40406910,0.86,68,11,79,618221
chr1,40407095,0.88,84,11,95,618222
chr1,40407132,0.94,91,6,97,618223
chr1,40407263,0.94,51,3,54,618224
chr1,40407353,0.97,88,3,91,618225
chr1,40407377,0.91,93,9,102,618226
chr1,40407416,0.93,101,8,109,618227
chr1,40407556,0.9,45,5,50,618228
chr1,40407586,0.99,71,1,72,618229
chr1,40407721,0.97,86,3,89,618230
chr1,40407790,0.91,78,8,86,618231
chr1,40407870,0.88,89,12,101,618232
chr1,40407916,0.9,97,11,108,618233
chr1,40407962,0.84,92,18,110,618234
chr1,40408038,0.83,60,12,72,618235
chr1,40408125,0.94,62,4,66,618236
chr1,40408813,0.89,41,5,46,618237
chr1,40408820,0.84,37,7,44,618238
chr1,40408951,0.65,28,15,43,618239
chr1,40409237,0.87,67,10,77,618240
chr1,40409239,0.76,55,17,72,618241
chr1,40409265,0.85,78,14,92,618242
chr1,40409437,0.87,69,10,79,618243
chr1,40409581,0.88,87,12,99,618244
chr1,40409667,0.89,68,8,76,618245
chr1,40409710,0.79,45,12,57,618246
chr1,40409756,0.92,49,4,53,618247
chr1,40409781,0.91,61,6,67,618248
chr1,40409787,0.91,61,6,67,618249
chr1,40409804,0.99,73,1,74,618250
chr1,40409811,0.99,83,1,84,618251
chr1,40409821,0.96,86,4,90,618252
chr1,40409908,0.85,56,10,66,618253
chr1,40409962,0.95,37,2,39,618254
chr1,40409966,0.71,40,16,56,618255
chr1,40410079,0.46,39,45,84,618256
chr1,40410164,0.69,40,18,58,618257
chr1,40410224,0.82,32,7,39,618258
chr1,40410252,0.65,30,16,46,618259
chr1,40410341,0.64,43,24,67,618260
chr1,40410458,0.92,90,8,98,618261
chr1,40410509,0.28,32,81,113,618262
chr1,40410701,0.1,9,85,94,618263
chr1,40410783,0.33,26,53,79,618264
chr1,40410799,0.58,49,35,84,618265
chr1,40410823,0.72,71,28,99,618266
chr1,40410829,0.71,70,28,98,618267
chr1,40410956,1,76,0,76,618268
chr1,40410965,0.95,74,4,78,618269
chr1,40411006,0.92,81,7,88,618270
chr1,40411055,0.76,54,17,71,618271
chr1,40411088,0.96,51,2,53,618272
chr1,40411096,0.85,53,9,62,618273
chr1,40411134,0.95,77,4,81,618274
chr1,40411217,0.95,96,5,101,618275
chr1,40411222,0.92,91,8,99,618276
chr1,40411254,0.95,92,5,97,618277
chr1,40411256,0.96,89,4,93,618278
chr1,40411285,0.95,77,4,81,618279
chr1,40411299,0.93,71,5,76,618280
chr1,40411315,0.99,68,1,69,618281
chr1,40411343,0.93,56,4,60,618282
chr1,40411353,1,62,0,62,618283
chr1,40411355,0.97,56,2,58,618284
chr1,40411502,0.72,64,25,89,618285
chr1,40411598,0.66,63,32,95,618286
chr1,40411783,0.99,96,1,97,618287
chr1,40411856,0.87,85,13,98,618288
chr1,40412071,0.54,83,70,153,618289
chr1,40412158,0.95,124,7,131,618290
chr1,40412204,0.92,102,9,111,618291
chr1,40412277,0.95,80,4,84,618292
chr1,40412299,0.97,65,2,67,618293
chr1,40412458,0.98,91,2,93,618294
chr1,40412481,0.93,85,6,91,618295
chr1,40412512,0.85,74,13,87,618296
chr1,40412544,0.82,61,13,74,618297
chr1,40412605,0.95,58,3,61,618298
chr1,40412637,0.86,48,8,56,618299
chr1,40412659,0.91,49,5,54,618300
chr1,40412667,0.93,51,4,55,618301
chr1,40412724,0.67,32,16,48,618302
chr1,40412916,0.71,50,20,70,618303
chr1,40413046,0.86,79,13,92,618304
chr1,40413135,0.56,61,47,108,618305
chr1,40413198,0.81,109,25,134,618306
chr1,40413274,0.64,62,35,97,618307
chr1,40413624,0.95,77,4,81,618308
chr1,40413632,0.92,70,6,76,618309
chr1,40413734,0.96,89,4,93,618310
chr1,40413740,0.92,81,7,88,618311
chr1,40413799,0.88,46,6,52,618312
chr1,40413973,0.96,47,2,49,618313
chr1,40413997,0.93,56,4,60,618314
chr1,40414068,0.97,64,2,66,618315
chr1,40414071,0.97,62,2,64,618316
chr1,40414088,0.91,61,6,67,618317
chr1,40414131,0.86,60,10,70,618318
chr1,40414159,0.93,75,6,81,618319
chr1,40414210,0.93,89,7,96,618320
chr1,40414515,0.96,22,1,23,618321
chr1,40414523,1,21,0,21,618322
chr1,40414531,0.95,21,1,22,618323
chr1,40414553,1,29,0,29,618324
chr1,40414578,1,36,0,36,618325
chr1,40414584,1,42,0,42,618326
chr1,40414593,0.96,47,2,49,618327
chr1,40414641,0.96,72,3,75,618328
chr1,40414684,0.82,40,9,49,618329
chr1,40414715,0.94,34,2,36,618330
chr1,40414729,0.92,33,3,36,618331
chr1,40414736,0.97,28,1,29,618332
chr1,40414745,0.97,30,1,31,618333
chr1,40414773,0.94,45,3,48,618334
chr1,40414783,0.95,39,2,41,618335
chr1,40414785,0.98,40,1,41,618336
chr1,40414787,1,43,0,43,618337
chr1,40414789,0.96,46,2,48,618338
chr1,40414993,0.87,96,14,110,618339
chr1,40415007,0.87,97,14,111,618340
chr1,40415044,0.98,91,2,93,618341
chr1,40415085,0.95,89,5,94,618342
chr1,40415107,0.98,89,2,91,618343
chr1,40415139,0.62,56,34,90,618344
chr1,40415183,0.82,84,18,102,618345
chr1,40415540,0.97,57,2,59,618346
chr1,40415721,0.96,100,4,104,618347
chr1,40415779,0.92,99,9,108,618348
chr1,40416052,0.95,86,5,91,618349
chr1,40416217,1,99,0,99,618350
chr1,40416458,0.89,94,12,106,618351
chr1,40416622,0.95,102,5,107,618352
chr1,40416794,1,88,0,88,618353
chr1,40416997,0.99,84,1,85,618354
chr1,40417061,0.93,76,6,82,618355
chr1,40417082,0.91,63,6,69,618356
chr1,40417091,0.74,51,18,69,618357
chr1,40417107,0.69,45,20,65,618358
chr1,40417119,0.84,57,11,68,618359
chr1,40417129,0.85,56,10,66,618360
chr1,40417416,0.97,35,1,36,618361
chr1,40417433,0.98,52,1,53,618362
chr1,40417454,1,60,0,60,618363
chr1,40417471,1,70,0,70,618364
chr1,40417493,1,80,0,80,618365
chr1,40417530,0.96,67,3,70,618366
chr1,40417532,1,69,0,69,618367
chr1,40417664,0.93,42,3,45,618368
chr1,40417814,0.92,69,6,75,618369
chr1,40417971,0.81,59,14,73,618370
chr1,40418159,0.74,80,28,108,618371
chr1,40418210,0.7,71,31,102,618372
chr1,40418216,0.45,45,56,101,618373
chr1,40418380,0.36,26,46,72,618374
chr1,40418450,0.64,74,42,116,618375
chr1,40418479,0.44,55,70,125,618376
chr1,40418586,0.48,51,55,106,618377
chr1,40418653,0.2,17,66,83,618378
chr1,40418851,0.97,59,2,61,618379
chr1,40418857,0.95,62,3,65,618380
chr1,40418874,0.97,68,2,70,618381
chr1,40418891,0.96,70,3,73,618382
chr1,40418949,0.97,83,3,86,618383
chr1,40419007,0.97,75,2,77,618384
chr1,40419022,0.51,38,36,74,618385
chr1,40419066,0.84,57,11,68,618386
chr1,40419149,0.92,66,6,72,618387
chr1,40419299,0.99,85,1,86,618388
chr1,40419329,0.94,84,5,89,618389
chr1,40419558,0.92,46,4,50,618390
chr1,40419672,0.95,59,3,62,618391
chr1,40419732,1,60,0,60,618392
chr1,40419793,0.92,60,5,65,618393
chr1,40419957,0.93,87,7,94,618394
chr1,40420017,0.84,61,12,73,618395
chr1,40420142,0.86,59,10,69,618396
chr1,40420210,0.82,58,13,71,618397
chr1,40420214,0.88,52,7,59,618398
chr1,40420222,0.6,37,25,62,618399
chr1,40420235,0.02,1,52,53,618400
chr1,40420299,0.94,46,3,49,618401
chr1,40420317,0.91,40,4,44,618402
chr1,40420336,0.8,41,10,51,618403
chr1,40420374,0.94,47,3,50,618404
chr1,40420378,0.45,24,29,53,618405
chr1,40420488,0.27,14,38,52,618406
chr1,40420493,0.28,15,39,54,618407
chr1,40420503,0.4,20,30,50,618408
chr1,40420519,0.15,8,46,54,618409
chr1,40420528,0.08,5,55,60,618410
chr1,40420537,0.21,13,50,63,618411
chr1,40420546,0.03,2,60,62,618412
chr1,40420574,0.02,1,63,64,618413
chr1,40420583,0,0,63,63,618414
chr1,40420585,0.03,2,61,63,618415
chr1,40420587,0.02,1,61,62,618416
chr1,40420603,0,0,64,64,618417
chr1,40420605,0.01,1,66,67,618418
chr1,40420617,0,0,64,64,618419
chr1,40420635,0.02,1,56,57,618420
chr1,40420648,0,0,61,61,618421
chr1,40420654,0,0,61,61,618422
chr1,40420668,0,0,62,62,618423
chr1,40420675,0,0,63,63,618424
chr1,40420689,0,0,49,49,618425
chr1,40420692,0,0,56,56,618426
chr1,40420696,0,0,39,39,618427
chr1,40420701,0,0,39,39,618428
chr1,40420715,0,0,25,25,618429
chr1,40420719,0,0,30,30,618430
chr1,40420722,0,0,45,45,618431
chr1,40420738,0,0,25,25,618432
chr1,40420746,0,0,38,38,618433
chr1,40420753,0.07,3,42,45,618434
chr1,40420764,0,0,34,34,618435
chr1,40420770,0,0,43,43,618436
chr1,40420798,0.04,1,27,28,618437
chr1,40420800,0,0,45,45,618438
chr1,40420809,0,0,23,23,618439
chr1,40420823,0,0,38,38,618440
chr1,40420830,0,0,47,47,618441
chr1,40420841,0,0,48,48,618442
chr1,40420853,0,0,43,43,618443
chr1,40420855,0,0,45,45,618444
chr1,40420857,0,0,47,47,618445
chr1,40420860,0,0,40,40,618446
chr1,40420864,0,0,50,50,618447
chr1,40420881,0,0,48,48,618448
chr1,40420886,0.03,1,38,39,618449
chr1,40420904,0,0,34,34,618450
chr1,40420911,0,0,33,33,618451
chr1,40420929,0,0,33,33,618452
chr1,40420947,0,0,26,26,618453
chr1,40420950,0,0,27,27,618454
chr1,40420957,0,0,29,29,618455
chr1,40420959,0,0,21,21,618456
chr1,40420982,0,0,24,24,618457
chr1,40420985,0,0,37,37,618458
chr1,40420991,0,0,25,25,618459
chr1,40420997,0,0,41,41,618460
chr1,40420999,0,0,41,41,618461
chr1,40421002,0,0,32,32,618462
chr1,40421040,0,0,33,33,618463
chr1,40421044,0,0,37,37,618464
chr1,40421067,0,0,36,36,618465
chr1,40421075,0.03,1,31,32,618466
chr1,40421077,0,0,29,29,618467
chr1,40421086,0,0,11,11,618468
chr1,40421103,0,0,14,14,618469
chr1,40421123,0,0,10,10,618470
chr1,40421128,0.03,1,36,37,618471
chr1,40421134,0.03,1,29,30,618472
chr1,40421180,0,0,28,28,618473
chr1,40421222,0,0,27,27,618474
chr1,40421239,0,0,3,3,618475
chr1,40421245,0,0,18,18,618476
chr1,40421263,0,0,24,24,618477
chr1,40421272,0,0,27,27,618478
chr1,40421279,0,0,28,28,618479
chr1,40421293,0,0,33,33,618480
chr1,40421314,0.04,1,26,27,618481
chr1,40421327,0,0,43,43,618482
chr1,40421342,0,0,47,47,618483
chr1,40421351,0,0,40,40,618484
chr1,40421365,0.09,2,21,23,618485
chr1,40421461,0,0,46,46,618486
chr1,40421484,0,0,78,78,618487
chr1,40421530,0,0,124,124,618488
chr1,40421532,0.01,1,120,121,618489
chr1,40421565,0,0,126,126,618490
chr1,40421567,0,0,121,121,618491
chr1,40421569,0.01,1,124,125,618492
chr1,40421575,0,0,125,125,618493
chr1,40421585,0.02,2,110,112,618494
chr1,40421590,0,0,112,112,618495
chr1,40421599,0,0,102,102,618496
chr1,40421650,0.04,3,70,73,618497
chr1,40421688,0,0,83,83,618498
chr1,40421823,0,0,45,45,618499
chr1,40421862,0.06,2,34,36,618500
chr1,40421899,0.55,17,14,31,618501
chr1,40421907,0.23,10,33,43,618502
chr1,40421940,0.35,16,30,46,618503
chr1,40422000,0.84,43,8,51,618504
chr1,40422019,0.47,24,27,51,618505
chr1,40422027,0.44,24,30,54,618506
chr1,40422126,0.83,60,12,72,618507
chr1,40422154,0.69,54,24,78,618508
chr1,40422169,0.76,47,15,62,618509
chr1,40422377,0.95,60,3,63,618510
chr1,40422384,0.97,60,2,62,618511
chr1,40422415,0.95,70,4,74,618512
chr1,40422504,0.79,19,5,24,618513
chr1,40422519,1,27,0,27,618514
chr1,40422536,0.39,15,23,38,618515
chr1,40422766,0.85,40,7,47,618516
chr1,40422841,0.96,82,3,85,618517
chr1,40422912,0.96,67,3,70,618518
chr1,40422967,0.96,80,3,83,618519
chr1,40423157,0.76,55,17,72,618520
chr1,40423500,0.95,70,4,74,618521
chr1,40423553,0.89,76,9,85,618522
chr1,40423858,0.91,40,4,44,618523
chr1,40424016,0.97,85,3,88,618524
chr1,40424327,0.98,45,1,46,618525
chr1,40424412,0.88,35,5,40,618526
chr1,40424484,0.99,80,1,81,618527
chr1,40424518,0.84,68,13,81,618528
chr1,40424663,0.41,23,33,56,618529
chr1,40424813,0.81,47,11,58,618530
chr1,40424950,0.97,62,2,64,618531
chr1,40425044,0.97,99,3,102,618532
chr1,40425054,0.95,90,5,95,618533
chr1,40425066,0.9,86,10,96,618534
chr1,40425116,0.89,66,8,74,618535
chr1,40425171,0.93,57,4,61,618536
chr1,40425220,0.95,70,4,74,618537
chr1,40425371,0.9,45,5,50,618538
chr1,40425698,0.9,69,8,77,618539
chr1,40425741,0.89,72,9,81,618540
chr1,40425802,0.94,60,4,64,618541
chr1,40425816,0.89,56,7,63,618542
chr1,40425821,0.87,52,8,60,618543
chr1,40425830,0.98,52,1,53,618544
chr1,40425842,0.93,41,3,44,618545
chr1,40425863,0.95,40,2,42,618546
chr1,40425952,1,30,0,30,618547
chr1,40425971,1,28,0,28,618548
chr1,40425988,0.92,33,3,36,618549
chr1,40426007,0.97,38,1,39,618550
chr1,40426042,0.29,14,34,48,618551
chr1,40426120,0.79,64,17,81,618552
chr1,40426169,0.37,32,55,87,618553
chr1,40426172,0.5,36,36,72,618554
chr1,40426180,0.18,13,59,72,618555
chr1,40426201,0.16,10,52,62,618556
chr1,40426242,0.59,43,30,73,618557
chr1,40426245,0.82,54,12,66,618558
chr1,40426277,0.85,61,11,72,618559
chr1,40426303,0.7,64,27,91,618560
chr1,40426487,0.91,49,5,54,618561
chr1,40426598,0.89,62,8,70,618562
chr1,40426600,0.97,68,2,70,618563
chr1,40426610,0.76,65,21,86,618564
chr1,40426991,0.75,6,2,8,618565
chr1,40426997,0.67,4,2,6,618566
chr1,40427017,0.6,6,4,10,618567
chr1,40427051,0.94,30,2,32,618568
chr1,40427059,0.89,34,4,38,618569
chr1,40427081,0.88,38,5,43,618570
chr1,40427121,1,53,0,53,618571
chr1,40427165,1,50,0,50,618572
chr1,40427169,0.97,57,2,59,618573
chr1,40427209,0.89,50,6,56,618574
chr1,40427220,0.83,43,9,52,618575
chr1,40427240,0.95,36,2,38,618576
chr1,40427265,0.98,40,1,41,618577
chr1,40427270,0.95,40,2,42,618578
chr1,40427298,0.98,42,1,43,618579
chr1,40427435,0.97,65,2,67,618580
chr1,40427463,0.95,69,4,73,618581
chr1,40427651,0.99,75,1,76,618582
chr1,40427818,0.95,74,4,78,618583
chr1,40427844,0.99,87,1,88,618584
chr1,40427857,0.92,91,8,99,618585
chr1,40427894,0.94,94,6,100,618586
chr1,40427936,0.88,104,14,118,618587
chr1,40428141,0.98,120,2,122,618588
chr1,40428192,0.97,103,3,106,618589
chr1,40428205,0.95,97,5,102,618590
chr1,40428223,0.97,89,3,92,618591
chr1,40428241,0.97,85,3,88,618592
chr1,40428294,0.95,78,4,82,618593
chr1,40428296,0.99,79,1,80,618594
chr1,40428305,1,84,0,84,618595
chr1,40428318,0.96,81,3,84,618596
chr1,40428324,0.97,71,2,73,618597
chr1,40428336,0.96,76,3,79,618598
chr1,40428342,0.95,71,4,75,618599
chr1,40428349,0.95,69,4,73,618600
chr1,40428354,0.94,58,4,62,618601
chr1,40428362,0.97,66,2,68,618602
chr1,40428383,0.95,63,3,66,618603
chr1,40428420,0.98,54,1,55,618604
chr1,40428567,0.91,43,4,47,618605
chr1,40428572,0.96,45,2,47,618606
chr1,40428579,0.98,46,1,47,618607
chr1,40428595,0.96,49,2,51,618608
chr1,40428608,0.98,52,1,53,618609
chr1,40428629,0.96,49,2,51,618610
chr1,40428665,1,41,0,41,618611
chr1,40428672,0.97,33,1,34,618612
chr1,40428710,0.93,13,1,14,618613
chr1,40428714,1,13,0,13,618614
chr1,40428755,0.93,27,2,29,618615
chr1,40428777,1,41,0,41,618616
chr1,40428782,1,48,0,48,618617
chr1,40428798,0.95,59,3,62,618618
chr1,40428830,0.97,61,2,63,618619
chr1,40428875,0.98,60,1,61,618620
chr1,40428897,0.96,53,2,55,618621
chr1,40428977,0.93,67,5,72,618622
chr1,40429013,0.92,73,6,79,618623
chr1,40429132,0.94,97,6,103,618624
chr1,40429339,0.97,89,3,92,618625
chr1,40429443,0.97,64,2,66,618626
chr1,40429469,1,62,0,62,618627
chr1,40429475,0.97,59,2,61,618628
chr1,40429499,0.97,56,2,58,618629
chr1,40429518,0.93,43,3,46,618630
chr1,40429531,0.96,51,2,53,618631
chr1,40429555,0.98,50,1,51,618632
chr1,40429595,0.94,50,3,53,618633
chr1,40429604,0.98,53,1,54,618634
chr1,40429699,0.97,68,2,70,618635
chr1,40429726,0.98,81,2,83,618636
chr1,40429767,0.96,99,4,103,618637
chr1,40429997,0.98,81,2,83,618638
chr1,40430037,0.85,63,11,74,618639
chr1,40430236,0.99,76,1,77,618640
chr1,40430500,0.97,32,1,33,618641
chr1,40430527,0.97,33,1,34,618642
chr1,40430702,0.92,58,5,63,618643
chr1,40430897,1,41,0,41,618644
chr1,40430907,0.86,48,8,56,618645
chr1,40430934,0.9,63,7,70,618646
chr1,40430940,0.89,70,9,79,618647
chr1,40430952,0.85,77,14,91,618648
chr1,40431005,0.94,96,6,102,618649
chr1,40431044,0.87,76,11,87,618650
chr1,40431055,0.96,74,3,77,618651
chr1,40431108,1,75,0,75,618652
chr1,40431162,0.8,57,14,71,618653
chr1,40431187,0.8,55,14,69,618654
chr1,40431200,0.81,55,13,68,618655
chr1,40431214,0.82,56,12,68,618656
chr1,40431286,0.96,54,2,56,618657
chr1,40431388,0.98,55,1,56,618658
chr1,40431445,0.95,56,3,59,618659
chr1,40431565,0.97,71,2,73,618660
chr1,40431568,0.97,72,2,74,618661
chr1,40431584,0.92,76,7,83,618662
chr1,40431601,0.99,93,1,94,618663
chr1,40431685,0.6,49,32,81,618664
chr1,40431990,0.9,52,6,58,618665
chr1,40432159,0.97,36,1,37,618666
chr1,40432254,0.97,62,2,64,618667
chr1,40432295,0.97,67,2,69,618668
chr1,40432347,0.95,59,3,62,618669
chr1,40432351,1,61,0,61,618670
chr1,40432468,0.95,36,2,38,618671
chr1,40432514,0.98,49,1,50,618672
chr1,40432524,1,53,0,53,618673
chr1,40432533,0.96,51,2,53,618674
chr1,40432550,0.98,53,1,54,618675
chr1,40432653,0.97,32,1,33,618676
chr1,40432806,0.96,76,3,79,618677
chr1,40432864,0.97,67,2,69,618678
chr1,40432992,0.97,99,3,102,618679
chr1,40433062,0.96,70,3,73,618680
chr1,40433147,0.95,54,3,57,618681
chr1,40433169,0.85,52,9,61,618682
chr1,40433304,1,36,0,36,618683
chr1,40433345,0.93,28,2,30,618684
chr1,40433537,1,59,0,59,618685
chr1,40433614,0.55,46,37,83,618686
chr1,40433817,0.76,52,16,68,618687
chr1,40433963,0.88,70,10,80,618688
chr1,40434001,1,79,0,79,618689
chr1,40434030,0.9,65,7,72,618690
chr1,40434066,0.92,67,6,73,618691
chr1,40434214,0.94,33,2,35,618692
chr1,40434260,0.85,58,10,68,618693
chr1,40434270,0.95,73,4,77,618694
chr1,40434276,0.97,77,2,79,618695
chr1,40434281,0.8,65,16,81,618696
chr1,40434307,0.83,77,16,93,618697
chr1,40434383,0.98,53,1,54,618698
chr1,40434386,0.98,49,1,50,618699
chr1,40434454,0.86,30,5,35,618700
chr1,40434549,0.91,52,5,57,618701
chr1,40434681,0.87,84,13,97,618702
chr1,40434806,0.97,59,2,61,618703
chr1,40434834,0.88,63,9,72,618704
chr1,40434882,0.53,48,43,91,618705
chr1,40434946,0.88,95,13,108,618706
chr1,40434962,0.82,89,19,108,618707
chr1,40435061,0.86,44,7,51,618708
chr1,40435063,0.89,42,5,47,618709
chr1,40435078,0.96,43,2,45,618710
chr1,40435098,0.9,37,4,41,618711
chr1,40435180,0.82,14,3,17,618712
chr1,40435245,0.98,53,1,54,618713
chr1,40435250,0.94,58,4,62,618714
chr1,40435257,0.98,62,1,63,618715
chr1,40435304,1,73,0,73,618716
chr1,40435396,0.89,50,6,56,618717
chr1,40435483,1,66,0,66,618718
chr1,40435494,0.95,63,3,66,618719
chr1,40435687,0.81,60,14,74,618720
chr1,40435729,0.93,65,5,70,618721
chr1,40435764,0.94,68,4,72,618722
chr1,40435772,0.95,70,4,74,618723
chr1,40435807,0.81,55,13,68,618724
chr1,40435839,0.95,53,3,56,618725
chr1,40436058,0.94,65,4,69,618726
chr1,40436114,0.87,72,11,83,618727
chr1,40436120,0.93,76,6,82,618728
chr1,40436162,0.74,73,25,98,618729
chr1,40436369,0.91,48,5,53,618730
chr1,40436401,0.76,35,11,46,618731
chr1,40436742,0.7,77,33,110,618732
chr1,40436817,0.94,122,8,130,618733
chr1,40436922,0.83,94,19,113,618734
chr1,40436944,0.89,92,11,103,618735
chr1,40437011,0.83,75,15,90,618736
chr1,40437307,0.98,56,1,57,618737
chr1,40437319,0.96,54,2,56,618738
chr1,40437347,0.83,29,6,35,618739
chr1,40437352,0.97,33,1,34,618740
chr1,40437379,1,8,0,8,618741
chr1,40437410,0.87,13,2,15,618742
chr1,40437481,0.98,56,1,57,618743
chr1,40437496,0.95,55,3,58,618744
chr1,40437536,0.96,71,3,74,618745
chr1,40437538,0.97,69,2,71,618746
chr1,40437629,0.89,66,8,74,618747
chr1,40437701,1,49,0,49,618748
chr1,40438047,0.87,73,11,84,618749
chr1,40438092,0.96,72,3,75,618750
chr1,40438373,0.9,66,7,73,618751
chr1,40438500,0.93,86,6,92,618752
chr1,40438512,0.89,79,10,89,618753
chr1,40438532,0.8,64,16,80,618754
chr1,40438555,0.95,62,3,65,618755
chr1,40438564,0.79,53,14,67,618756
chr1,40438739,0.7,7,3,10,618757
chr1,40438747,0.95,21,1,22,618758
chr1,40438777,0.97,37,1,38,618759
chr1,40438785,0.93,43,3,46,618760
chr1,40438802,0.96,52,2,54,618761
chr1,40438809,0.98,63,1,64,618762
chr1,40438817,0.94,62,4,66,618763
chr1,40438834,1,85,0,85,618764
chr1,40438840,0.83,71,15,86,618765
chr1,40438861,0.98,62,1,63,618766
chr1,40438865,0.94,60,4,64,618767
chr1,40438870,0.84,58,11,69,618768
chr1,40438872,0.93,62,5,67,618769
chr1,40438876,0.94,62,4,66,618770
chr1,40438905,0.83,34,7,41,618771
chr1,40438916,0.84,26,5,31,618772
chr1,40438936,1,12,0,12,618773
chr1,40438957,1,5,0,5,618774
chr1,40438961,1,10,0,10,618775
chr1,40438966,1,12,0,12,618776
chr1,40438994,1,25,0,25,618777
chr1,40439004,0.71,20,8,28,618778
chr1,40439006,0.96,25,1,26,618779
chr1,40439010,0.79,26,7,33,618780
chr1,40439118,0.95,42,2,44,618781
chr1,40439128,0.86,30,5,35,618782
chr1,40439286,0,0,61,61,618783
chr1,40439358,0.03,1,30,31,618784
chr1,40439392,0.02,2,82,84,618785
chr1,40439436,0.07,7,98,105,618786
chr1,40439450,0.04,4,109,113,618787
chr1,40439574,0.42,50,68,118,618788
chr1,40439597,0.38,51,82,133,618789
chr1,40439625,0.3,40,92,132,618790
chr1,40439759,0.9,55,6,61,618791
chr1,40439922,0.94,90,6,96,618792
chr1,40439956,0.9,75,8,83,618793
chr1,40440049,0.63,31,18,49,618794
chr1,40440081,0.7,39,17,56,618795
chr1,40440142,0.94,74,5,79,618796
chr1,40440204,0.92,77,7,84,618797
chr1,40440213,0.96,76,3,79,618798
chr1,40440216,0.94,75,5,80,618799
chr1,40440221,0.87,69,10,79,618800
chr1,40440227,0.88,72,10,82,618801
chr1,40440457,0.82,80,17,97,618802
chr1,40440618,0.94,101,6,107,618803
chr1,40440677,0.73,56,21,77,618804
chr1,40440839,0.89,34,4,38,618805
chr1,40440885,0.94,66,4,70,618806
chr1,40440944,0.93,101,8,109,618807
chr1,40440956,0.96,104,4,108,618808
chr1,40440988,0.9,91,10,101,618809
chr1,40441044,0.92,76,7,83,618810
chr1,40441119,0.93,89,7,96,618811
chr1,40441144,0.94,93,6,99,618812
chr1,40441168,0.95,104,5,109,618813
chr1,40441208,0.98,90,2,92,618814
chr1,40441263,0.99,70,1,71,618815
chr1,40441276,0.93,62,5,67,618816
chr1,40441294,0.98,64,1,65,618817
chr1,40441352,0.95,53,3,56,618818
chr1,40441580,0.98,43,1,44,618819
chr1,40441611,0.97,63,2,65,618820
chr1,40441615,0.98,65,1,66,618821
chr1,40441655,0.94,66,4,70,618822
chr1,40441701,1,32,0,32,618823
chr1,40441740,0.8,4,1,5,618824
chr1,40441843,0.98,64,1,65,618825
chr1,40442107,0.97,70,2,72,618826
chr1,40442193,0.94,83,5,88,618827
chr1,40442338,0.9,70,8,78,618828
chr1,40442421,0.94,74,5,79,618829
chr1,40442449,0.78,68,19,87,618830
chr1,40442499,0.93,100,7,107,618831
chr1,40442540,0.82,75,17,92,618832
chr1,40442545,0.59,51,35,86,618833
chr1,40442650,0.17,13,63,76,618834
chr1,40442706,0.14,8,51,59,618835
chr1,40442721,0.19,9,38,47,618836
chr1,40442899,0.95,73,4,77,618837
chr1,40443432,0.98,44,1,45,618838
chr1,40443464,0.98,57,1,58,618839
chr1,40443474,0.97,58,2,60,618840
chr1,40443496,0.98,65,1,66,618841
chr1,40443560,1,52,0,52,618842
chr1,40443945,0.96,108,4,112,618843
chr1,40444152,0.97,111,4,115,618844
chr1,40444317,0.97,71,2,73,618845
chr1,40444413,1,83,0,83,618846
chr1,40444510,1,88,0,88,618847
chr1,40444692,0.98,82,2,84,618848
chr1,40444735,0.97,65,2,67,618849
chr1,40444773,0.92,57,5,62,618850
chr1,40444785,0.97,67,2,69,618851
chr1,40444826,0.94,75,5,80,618852
chr1,40444828,0.97,77,2,79,618853
chr1,40444880,0.98,88,2,90,618854
chr1,40444961,0.97,61,2,63,618855
chr1,40444967,1,58,0,58,618856
chr1,40444977,0.95,57,3,60,618857
chr1,40445005,1,43,0,43,618858
chr1,40445014,0.92,35,3,38,618859
chr1,40445029,0.53,31,27,58,618860
chr1,40445154,0.88,72,10,82,618861
chr1,40445180,1,79,0,79,618862
chr1,40445382,0.96,68,3,71,618863
chr1,40445629,0.98,39,1,40,618864
chr1,40445673,1,54,0,54,618865
chr1,40445713,0.93,68,5,73,618866
chr1,40445805,0.89,94,12,106,618867
chr1,40445863,0.99,96,1,97,618868
chr1,40445904,1,52,0,52,618869
chr1,40446319,0.93,41,3,44,618870
chr1,40446531,0.98,59,1,60,618871
chr1,40446674,1,24,0,24,618872
chr1,40446734,0.85,52,9,61,618873
chr1,40446962,0.97,37,1,38,618874
chr1,40446968,0.95,36,2,38,618875
chr1,40446985,0.98,51,1,52,618876
chr1,40447041,1,97,0,97,618877
chr1,40447049,0.98,98,2,100,618878
chr1,40447053,0.96,95,4,99,618879
chr1,40447073,0.96,90,4,94,618880
chr1,40447081,0.9,81,9,90,618881
chr1,40447089,0.96,79,3,82,618882
chr1,40447145,0.93,53,4,57,618883
chr1,40447183,0.96,53,2,55,618884
chr1,40447185,0.98,58,1,59,618885
chr1,40447254,0.77,49,15,64,618886
chr1,40447386,0.89,99,12,111,618887
chr1,40447446,0.95,89,5,94,618888
chr1,40447601,0.78,57,16,73,618889
chr1,40447810,0.44,28,36,64,618890
chr1,40447846,0.49,34,36,70,618891
chr1,40448243,0.94,78,5,83,618892
chr1,40448245,0.98,83,2,85,618893
chr1,40448255,0.87,77,12,89,618894
chr1,40448289,0.99,84,1,85,618895
chr1,40448316,0.98,62,1,63,618896
chr1,40448347,0.92,60,5,65,618897
chr1,40448375,0.94,59,4,63,618898
chr1,40448411,0.96,80,3,83,618899
chr1,40448450,1,70,0,70,618900
chr1,40448466,1,66,0,66,618901
chr1,40448473,0.97,57,2,59,618902
chr1,40448512,0.97,28,1,29,618903
chr1,40448733,0.92,57,5,62,618904
chr1,40448848,0.95,39,2,41,618905
chr1,40448872,0.96,50,2,52,618906
chr1,40448878,0.96,50,2,52,618907
chr1,40448902,0.99,68,1,69,618908
chr1,40448942,0.95,74,4,78,618909
chr1,40448958,1,75,0,75,618910
chr1,40448970,0.93,67,5,72,618911
chr1,40448998,0.99,71,1,72,618912
chr1,40449061,0.99,68,1,69,618913
chr1,40449064,0.97,69,2,71,618914
chr1,40449099,0.9,72,8,80,618915
chr1,40449297,0.82,36,8,44,618916
chr1,40449299,0.78,40,11,51,618917
chr1,40449339,0.97,57,2,59,618918
chr1,40449385,0.96,79,3,82,618919
chr1,40449597,0.96,77,3,80,618920
chr1,40449755,0.77,76,23,99,618921
chr1,40449810,0.83,86,18,104,618922
chr1,40449921,0.95,36,2,38,618923
chr1,40449925,0.94,32,2,34,618924
chr1,40449927,0.97,33,1,34,618925
chr1,40449970,0.96,24,1,25,618926
chr1,40449995,0.96,22,1,23,618927
chr1,40450055,0.98,40,1,41,618928
chr1,40450071,1,41,0,41,618929
chr1,40450091,0.87,40,6,46,618930
chr1,40450113,0.96,46,2,48,618931
chr1,40450123,0.9,45,5,50,618932
chr1,40450130,1,49,0,49,618933
chr1,40450153,1,60,0,60,618934
chr1,40450155,0.98,58,1,59,618935
chr1,40450682,0.95,88,5,93,618936
chr1,40450689,0.95,84,4,88,618937
chr1,40450753,0.76,72,23,95,618938
chr1,40450855,0.65,53,28,81,618939
chr1,40450868,0.92,73,6,79,618940
chr1,40450909,0.88,70,10,80,618941
chr1,40450968,0.58,57,41,98,618942
chr1,40451028,0.69,79,35,114,618943
chr1,40451132,0.63,59,34,93,618944
chr1,40451145,0.61,62,39,101,618945
chr1,40451171,0.44,61,78,139,618946
chr1,40451260,0.62,98,61,159,618947
chr1,40451652,0.83,52,11,63,618948
chr1,40451901,0.86,84,14,98,618949
chr1,40452003,0.98,53,1,54,618950
chr1,40452071,0.97,73,2,75,618951
chr1,40452088,0.92,69,6,75,618952
chr1,40452130,0.91,71,7,78,618953
chr1,40452142,0.95,76,4,80,618954
chr1,40452219,0.84,47,9,56,618955
chr1,40452235,0.92,48,4,52,618956
chr1,40452273,0.97,73,2,75,618957
chr1,40452665,0.96,73,3,76,618958
chr1,40452669,0.97,65,2,67,618959
chr1,40452816,0.98,47,1,48,618960
chr1,40452885,0.97,38,1,39,618961
chr1,40453002,0.96,54,2,56,618962
chr1,40453055,0.96,65,3,68,618963
chr1,40453105,0.97,66,2,68,618964
chr1,40453156,0.85,77,14,91,618965
chr1,40453200,0.88,76,10,86,618966
chr1,40453234,0.96,78,3,81,618967
chr1,40453305,0.59,74,51,125,618968
chr1,40453469,0.97,76,2,78,618969
chr1,40453502,0.71,73,30,103,618970
chr1,40453615,0.51,63,60,123,618971
chr1,40453865,0.93,68,5,73,618972
chr1,40453883,0.94,64,4,68,618973
chr1,40454088,0.97,61,2,63,618974
chr1,40454150,0.87,71,11,82,618975
chr1,40454174,0.96,78,3,81,618976
chr1,40454321,0.88,87,12,99,618977
chr1,40454366,0.88,96,13,109,618978
chr1,40454518,0.7,69,29,98,618979
chr1,40454531,0.68,70,33,103,618980
chr1,40454910,0.39,30,47,77,618981
chr1,40454986,0.97,83,3,86,618982
chr1,40455063,0.78,61,17,78,618983
chr1,40455073,0.89,67,8,75,618984
chr1,40455164,0.97,87,3,90,618985
chr1,40455194,1,97,0,97,618986
chr1,40455254,0.85,56,10,66,618987
chr1,40455278,0.96,55,2,57,618988
chr1,40455286,0.91,52,5,57,618989
chr1,40455349,0.94,32,2,34,618990
chr1,40455370,0.96,25,1,26,618991
chr1,40455374,0.95,35,2,37,618992
chr1,40455407,0.76,37,12,49,618993
chr1,40455417,0.95,52,3,55,618994
chr1,40455647,0.67,53,26,79,618995
chr1,40455765,0.82,91,20,111,618996
chr1,40455842,0.65,51,27,78,618997
chr1,40455862,0.79,56,15,71,618998
chr1,40455907,0.95,73,4,77,618999
chr1,40455923,0.99,75,1,76,619000
chr1,40455999,0.98,57,1,58,619001
chr1,40456085,0.93,37,3,40,619002
chr1,40456115,0.96,53,2,55,619003
chr1,40456243,0.93,69,5,74,619004
chr1,40456287,0.93,70,5,75,619005
chr1,40456411,0.82,75,17,92,619006
chr1,40456558,0.8,64,16,80,619007
chr1,40456592,0.86,71,12,83,619008
chr1,40456603,0.81,75,18,93,619009
chr1,40456684,0.91,59,6,65,619010
chr1,40456740,0.84,70,13,83,619011
chr1,40456766,0.94,92,6,98,619012
chr1,40456857,0.78,62,17,79,619013
chr1,40456942,0.89,68,8,76,619014
chr1,40457026,0.97,60,2,62,619015
chr1,40457084,0.86,30,5,35,619016
chr1,40457098,0.94,16,1,17,619017
chr1,40457118,1,6,0,6,619018
chr1,40457170,0.94,16,1,17,619019
chr1,40457174,0.94,17,1,18,619020
chr1,40457194,0.9,35,4,39,619021
chr1,40457226,0.93,63,5,68,619022
chr1,40457288,0.93,67,5,72,619023
chr1,40457296,0.89,54,7,61,619024
chr1,40457519,0.8,83,21,104,619025
chr1,40457534,0.84,89,17,106,619026
chr1,40457591,0.96,79,3,82,619027
chr1,40457801,0.89,54,7,61,619028
chr1,40457810,0.92,58,5,63,619029
chr1,40457913,0.91,86,9,95,619030
chr1,40458243,0.69,56,25,81,619031
chr1,40458441,0.96,52,2,54,619032
chr1,40458443,0.89,50,6,56,619033
chr1,40458473,0.87,62,9,71,619034
chr1,40458483,0.93,68,5,73,619035
chr1,40458537,0.87,52,8,60,619036
chr1,40458607,0.82,23,5,28,619037
chr1,40458626,0.9,28,3,31,619038
chr1,40458669,1,63,0,63,619039
chr1,40458680,0.95,62,3,65,619040
chr1,40458774,0.98,60,1,61,619041
chr1,40458960,0.84,48,9,57,619042
chr1,40458999,0.94,72,5,77,619043
chr1,40459012,0.94,77,5,82,619044
chr1,40459029,0.99,82,1,83,619045
chr1,40459036,0.89,77,10,87,619046
chr1,40459240,0.93,38,3,41,619047
chr1,40459559,0.93,50,4,54,619048
chr1,40459573,0.98,60,1,61,619049
chr1,40459596,0.99,75,1,76,619050
chr1,40459656,0.91,43,4,47,619051
chr1,40459658,0.96,44,2,46,619052
chr1,40459698,0.94,32,2,34,619053
chr1,40459729,0.96,48,2,50,619054
chr1,40459750,0.9,52,6,58,619055
chr1,40459805,0.91,51,5,56,619056
chr1,40459927,0.81,51,12,63,619057
chr1,40459987,0.89,62,8,70,619058
chr1,40460051,0.99,69,1,70,619059
chr1,40460061,0.97,74,2,76,619060
chr1,40460083,0.97,73,2,75,619061
chr1,40460114,0.85,66,12,78,619062
chr1,40460138,0.95,69,4,73,619063
chr1,40460184,0.91,50,5,55,619064
chr1,40460346,0.76,41,13,54,619065
chr1,40460371,0.67,40,20,60,619066
chr1,40460421,0.89,56,7,63,619067
chr1,40460433,0.79,57,15,72,619068
chr1,40460490,0.8,57,14,71,619069
chr1,40460694,0.9,52,6,58,619070
chr1,40460746,0.8,48,12,60,619071
chr1,40460783,0.96,55,2,57,619072
chr1,40460840,0.7,39,17,56,619073
chr1,40460924,0.94,103,6,109,619074
chr1,40460981,0.9,97,11,108,619075
chr1,40461083,0.9,73,8,81,619076
chr1,40461113,0.93,74,6,80,619077
chr1,40461145,0.94,68,4,72,619078
chr1,40461173,0.92,72,6,78,619079
chr1,40461241,0.94,78,5,83,619080
chr1,40461265,0.99,67,1,68,619081
chr1,40461271,0.94,60,4,64,619082
chr1,40461636,0.89,89,11,100,619083
chr1,40461886,0.89,54,7,61,619084
chr1,40462744,0.49,44,45,89,619085
chr1,40462830,1,61,0,61,619086
chr1,40462948,0.99,103,1,104,619087
chr1,40462988,0.97,117,4,121,619088
chr1,40463044,0.97,120,4,124,619089
chr1,40463053,0.86,103,17,120,619090
chr1,40463310,0.97,57,2,59,619091
chr1,40463356,0.87,46,7,53,619092
chr1,40463366,0.92,44,4,48,619093
chr1,40463386,0.97,38,1,39,619094
chr1,40463449,0.89,41,5,46,619095
chr1,40463453,0.94,45,3,48,619096
chr1,40463465,0.98,58,1,59,619097
chr1,40463477,0.71,47,19,66,619098
chr1,40463497,0.45,28,34,62,619099
chr1,40463514,0.97,56,2,58,619100
chr1,40463531,0.94,46,3,49,619101
chr1,40463539,0.98,45,1,46,619102
chr1,40463695,0.8,89,22,111,619103
chr1,40463842,0.93,65,5,70,619104
chr1,40463908,0.84,81,15,96,619105
chr1,40463950,0.85,96,17,113,619106
chr1,40464013,0.89,91,11,102,619107
chr1,40464041,0.71,55,22,77,619108
chr1,40464103,0.84,47,9,56,619109
chr1,40464117,0.92,49,4,53,619110
chr1,40464160,0.89,50,6,56,619111
chr1,40464170,0.96,50,2,52,619112
chr1,40464415,0.93,137,10,147,619113
chr1,40464435,0.87,124,19,143,619114
chr1,40464525,0.8,66,16,82,619115
chr1,40464756,0.83,5,1,6,619116
chr1,40464772,1,6,0,6,619117
chr1,40464778,1,6,0,6,619118
chr1,40464805,1,5,0,5,619119
chr1,40464860,1,1,0,1,619120
chr1,40464872,1,7,0,7,619121
chr1,40464874,1,8,0,8,619122
chr1,40464877,0.92,12,1,13,619123
chr1,40464882,1,17,0,17,619124
chr1,40464905,0.89,34,4,38,619125
chr1,40464913,0.97,37,1,38,619126
chr1,40464925,0.96,43,2,45,619127
chr1,40464930,0.91,39,4,43,619128
chr1,40464948,0.88,49,7,56,619129
chr1,40464959,1,59,0,59,619130
chr1,40464976,0.98,54,1,55,619131
chr1,40464984,0.96,55,2,57,619132
chr1,40464996,0.94,51,3,54,619133
chr1,40465004,1,51,0,51,619134
chr1,40465056,0.98,54,1,55,619135
chr1,40465060,0.96,54,2,56,619136
chr1,40465083,1,43,0,43,619137
chr1,40465108,0.89,24,3,27,619138
chr1,40465127,0.87,13,2,15,619139
chr1,40465131,1,11,0,11,619140
chr1,40465139,1,6,0,6,619141
chr1,40465552,1,1,0,1,619142
chr1,40465556,1,1,0,1,619143
chr1,40465586,0.71,5,2,7,619144
chr1,40465592,0.86,6,1,7,619145
chr1,40465596,1,8,0,8,619146
chr1,40465603,1,10,0,10,619147
chr1,40465612,0.92,12,1,13,619148
chr1,40465644,0.6,12,8,20,619149
chr1,40465652,0.87,13,2,15,619150
chr1,40465657,0.61,11,7,18,619151
chr1,40465661,0.76,13,4,17,619152
chr1,40465689,0.77,10,3,13,619153
chr1,40465693,0.79,11,3,14,619154
chr1,40465701,1,6,0,6,619155
chr1,40465706,0.6,6,4,10,619156
chr1,40465710,0.73,8,3,11,619157
chr1,40465724,1,2,0,2,619158
chr1,40465734,0.83,5,1,6,619159
chr1,40465738,0.91,10,1,11,619160
chr1,40465771,0.94,34,2,36,619161
chr1,40465783,0.79,30,8,38,619162
chr1,40465817,0.81,39,9,48,619163
chr1,40465836,0.94,46,3,49,619164
chr1,40465857,1,45,0,45,619165
chr1,40465886,0.88,45,6,51,619166
chr1,40465897,0.87,39,6,45,619167
chr1,40466104,0.86,6,1,7,619168
chr1,40466158,0.93,39,3,42,619169
chr1,40466166,0.78,39,11,50,619170
chr1,40466336,0.69,27,12,39,619171
chr1,40466352,0.96,43,2,45,619172
chr1,40466443,0.9,38,4,42,619173
chr1,40466555,0.99,70,1,71,619174
chr1,40466571,0.98,63,1,64,619175
chr1,40466577,0.97,64,2,66,619176
chr1,40466679,0.88,38,5,43,619177
chr1,40466699,0.93,38,3,41,619178
chr1,40466858,0.92,61,5,66,619179
chr1,40466864,0.93,51,4,55,619180
chr1,40466874,0.94,47,3,50,619181
chr1,40466902,0.97,30,1,31,619182
chr1,40466934,0.97,37,1,38,619183
chr1,40466998,0.95,89,5,94,619184
chr1,40467010,0.96,90,4,94,619185
chr1,40467061,0.88,90,12,102,619186
chr1,40467499,0.63,56,33,89,619187
chr1,40467510,0.57,52,39,91,619188
chr1,40467798,0.76,38,12,50,619189
chr1,40467851,0.8,63,16,79,619190
chr1,40467911,0.92,83,7,90,619191
chr1,40468155,0.8,75,19,94,619192
chr1,40468239,0.86,70,11,81,619193
chr1,40468355,0.98,43,1,44,619194
chr1,40468395,0.95,41,2,43,619195
chr1,40468400,0.91,39,4,43,619196
chr1,40468427,0.96,47,2,49,619197
chr1,40468503,0.86,66,11,77,619198
chr1,40468523,0.91,62,6,68,619199
chr1,40468545,0.92,67,6,73,619200
chr1,40468609,0.95,37,2,39,619201
chr1,40468964,0.2,21,84,105,619202
chr1,40469269,0.82,75,16,91,619203
chr1,40469399,0.77,77,23,100,619204
chr1,40469530,0.86,50,8,58,619205
chr1,40469563,0.95,56,3,59,619206
chr1,40469572,0.98,61,1,62,619207
chr1,40469584,0.52,33,31,64,619208
chr1,40469613,0.98,58,1,59,619209
chr1,40469649,0.89,57,7,64,619210
chr1,40469749,0.98,39,1,40,619211
chr1,40470137,0.91,74,7,81,619212
chr1,40470378,0.75,42,14,56,619213
chr1,40470592,0.26,14,39,53,619214
chr1,40470846,0.85,78,14,92,619215
chr1,40470938,1,59,0,59,619216
chr1,40470942,0.8,53,13,66,619217
chr1,40471666,0.91,94,9,103,619218
chr1,40471682,0.96,85,4,89,619219
chr1,40471817,0.85,58,10,68,619220
chr1,40471961,0.8,80,20,100,619221
chr1,40472143,0.89,72,9,81,619222
chr1,40472305,0.91,67,7,74,619223
chr1,40472445,0.72,23,9,32,619224
chr1,40472539,0.38,27,44,71,619225
chr1,40472604,0.62,40,25,65,619226
chr1,40472618,0.95,61,3,64,619227
chr1,40472634,0.87,61,9,70,619228
chr1,40472790,0.62,21,13,34,619229
chr1,40472809,0.93,25,2,27,619230
chr1,40472860,0.67,2,1,3,619231
chr1,40472864,0.5,1,1,2,619232
chr1,40472988,0.63,25,15,40,619233
chr1,40473180,0.7,39,17,56,619234
chr1,40473321,0.99,66,1,67,619235
chr1,40473497,0.93,100,7,107,619236
chr1,40473752,0.5,4,4,8,619237
chr1,40474053,1,24,0,24,619238
chr1,40474181,0.86,6,1,7,619239
chr1,40474274,0.65,66,35,101,619240
chr1,40474404,0.81,43,10,53,619241
chr1,40474407,0.95,59,3,62,619242
chr1,40474725,0.5,7,7,14,619243
chr1,40474849,0.5,4,4,8,619244
chr1,40474853,0.36,4,7,11,619245
chr1,40474895,0.74,32,11,43,619246
chr1,40474904,0.94,58,4,62,619247
chr1,40474927,0.42,35,48,83,619248
chr1,40475020,0.55,28,23,51,619249
chr1,40475270,0.74,29,10,39,619250
chr1,40475410,0.89,49,6,55,619251
chr1,40475414,0.78,42,12,54,619252
chr1,40475688,0.99,90,1,91,619253
chr1,40475846,0.95,77,4,81,619254
chr1,40475916,0.88,69,9,78,619255
chr1,40476024,0.98,58,1,59,619256
chr1,40476031,0.64,38,21,59,619257
chr1,40476040,0.9,56,6,62,619258
chr1,40476068,0.96,50,2,52,619259
chr1,40476078,0.96,50,2,52,619260
chr1,40476084,0.96,53,2,55,619261
chr1,40476123,0.98,45,1,46,619262
chr1,40476337,0.98,53,1,54,619263
chr1,40476429,0.93,74,6,80,619264
chr1,40476443,0.89,74,9,83,619265
chr1,40476504,0.94,99,6,105,619266
chr1,40476698,0.74,63,22,85,619267
chr1,40476781,0.67,64,31,95,619268
chr1,40477009,0.94,101,6,107,619269
chr1,40477050,0.85,106,18,124,619270
chr1,40477161,0.97,95,3,98,619271
chr1,40477527,0.97,34,1,35,619272
chr1,40477551,0.92,47,4,51,619273
chr1,40477581,0.88,52,7,59,619274
chr1,40477591,0.95,59,3,62,619275
chr1,40477633,0.93,65,5,70,619276
chr1,40477635,0.59,44,31,75,619277
chr1,40477645,0.67,47,23,70,619278
chr1,40477649,0.92,66,6,72,619279
chr1,40477734,0.9,57,6,63,619280
chr1,40477781,0.8,49,12,61,619281
chr1,40477803,0.97,61,2,63,619282
chr1,40477811,0.8,59,15,74,619283
chr1,40477828,0.99,79,1,80,619284
chr1,40477843,0.97,83,3,86,619285
chr1,40477867,0.91,81,8,89,619286
chr1,40477887,0.97,70,2,72,619287
chr1,40477891,0.99,80,1,81,619288
chr1,40477899,0.99,83,1,84,619289
chr1,40477903,1,86,0,86,619290
chr1,40477932,0.85,71,13,84,619291
chr1,40477963,0.92,77,7,84,619292
chr1,40477977,0.94,74,5,79,619293
chr1,40477988,0.94,83,5,88,619294
chr1,40478031,0.97,64,2,66,619295
chr1,40478033,0.97,65,2,67,619296
chr1,40478044,0.94,51,3,54,619297
chr1,40478094,0.84,52,10,62,619298
chr1,40478108,0.86,60,10,70,619299
chr1,40478136,0.91,86,8,94,619300
chr1,40478145,0.97,90,3,93,619301
chr1,40478179,0.94,102,7,109,619302
chr1,40478199,0.94,103,7,110,619303
chr1,40478355,1,25,0,25,619304
chr1,40478505,0.99,66,1,67,619305
chr1,40478545,0.89,72,9,81,619306
chr1,40478703,0.82,68,15,83,619307
chr1,40478847,0.88,88,12,100,619308
chr1,40479105,0.83,72,15,87,619309
chr1,40479208,0.67,56,27,83,619310
chr1,40479735,0.7,84,36,120,619311
chr1,40479744,0.67,83,40,123,619312
chr1,40479773,0.75,79,26,105,619313
chr1,40480307,0.89,98,12,110,619314
chr1,40480331,0.7,90,38,128,619315
chr1,40480366,0.79,95,26,121,619316
chr1,40480382,0.9,108,12,120,619317
chr1,40480408,0.93,87,7,94,619318
chr1,40480411,0.92,86,7,93,619319
chr1,40480442,0.54,44,37,81,619320
chr1,40480502,0.85,76,13,89,619321
chr1,40480640,0.53,46,40,86,619322
chr1,40480689,0.36,39,69,108,619323
chr1,40480717,0.33,35,72,107,619324
chr1,40480772,0.77,55,16,71,619325
chr1,40480970,0.91,63,6,69,619326
chr1,40481041,0.72,59,23,82,619327
chr1,40481141,0.8,84,21,105,619328
chr1,40481223,0.27,24,64,88,619329
chr1,40481563,0.96,78,3,81,619330
chr1,40481565,0.94,75,5,80,619331
chr1,40481573,0.88,69,9,78,619332
chr1,40481579,0.95,70,4,74,619333
chr1,40481702,0.79,74,20,94,619334
chr1,40482137,0.94,92,6,98,619335
chr1,40482226,0.61,38,24,62,619336
chr1,40482347,0.51,37,35,72,619337
chr1,40482354,0.84,57,11,68,619338
chr1,40482801,0.59,48,34,82,619339
chr1,40483074,0.9,37,4,41,619340
chr1,40483080,0.89,31,4,35,619341
chr1,40483107,0.42,10,14,24,619342
chr1,40483388,0.86,79,13,92,619343
chr1,40483729,0.98,80,2,82,619344
chr1,40483892,0.91,93,9,102,619345
chr1,40483946,0.56,32,25,57,619346
chr1,40484058,0.4,27,41,68,619347
chr1,40484177,0.28,18,47,65,619348
chr1,40484279,0.9,47,5,52,619349
chr1,40484307,1,50,0,50,619350
chr1,40484410,1,49,0,49,619351
chr1,40484496,0.85,34,6,40,619352
chr1,40484610,0.8,37,9,46,619353
chr1,40484648,0.96,78,3,81,619354
chr1,40484732,0.91,83,8,91,619355
chr1,40484865,0.93,56,4,60,619356
chr1,40484877,0.98,57,1,58,619357
chr1,40484881,1,61,0,61,619358
chr1,40485278,0.91,70,7,77,619359
chr1,40485685,0.96,52,2,54,619360
chr1,40485739,0.87,65,10,75,619361
chr1,40485890,0.85,51,9,60,619362
chr1,40486028,0.4,33,50,83,619363
chr1,40486143,0.72,34,13,47,619364
chr1,40486349,0.7,46,20,66,619365
chr1,40486433,0.1,5,46,51,619366
chr1,40486621,0.38,40,65,105,619367
chr1,40486791,0.51,69,66,135,619368
chr1,40486847,0.96,117,5,122,619369
chr1,40486857,0.96,113,5,118,619370
chr1,40486883,0.91,87,9,96,619371
chr1,40486931,0.69,33,15,48,619372
chr1,40487110,0.83,44,9,53,619373
chr1,40487148,0.85,55,10,65,619374
chr1,40487538,0.91,97,10,107,619375
chr1,40487692,0.91,59,6,65,619376
chr1,40487702,0.91,64,6,70,619377
chr1,40487735,0.98,60,1,61,619378
chr1,40487747,0.96,65,3,68,619379
chr1,40487781,0.91,72,7,79,619380
chr1,40487878,0.54,20,17,37,619381
chr1,40487888,0.97,37,1,38,619382
chr1,40487950,0.81,39,9,48,619383
chr1,40488183,1,7,0,7,619384
chr1,40488187,1,8,0,8,619385
chr1,40488193,1,10,0,10,619386
chr1,40488195,1,10,0,10,619387
chr1,40488199,0.92,11,1,12,619388
chr1,40488231,0.93,14,1,15,619389
chr1,40488287,0.88,30,4,34,619390
chr1,40488292,0.94,33,2,35,619391
chr1,40488320,0.98,52,1,53,619392
chr1,40488330,0.98,58,1,59,619393
chr1,40488332,0.98,58,1,59,619394
chr1,40488336,0.99,67,1,68,619395
chr1,40488526,0.86,38,6,44,619396
chr1,40488554,0.89,34,4,38,619397
chr1,40488563,0.95,39,2,41,619398
chr1,40488670,0.92,79,7,86,619399
chr1,40488730,0.92,60,5,65,619400
chr1,40488760,0.98,51,1,52,619401
chr1,40488762,0.96,53,2,55,619402
chr1,40489102,0.73,88,32,120,619403
chr1,40489411,0.89,83,10,93,619404
chr1,40489542,0.34,23,45,68,619405
chr1,40489572,0.94,58,4,62,619406
chr1,40489678,0.91,40,4,44,619407
chr1,40489899,0.86,77,13,90,619408
chr1,40489907,0.93,82,6,88,619409
chr1,40489912,0.95,89,5,94,619410
chr1,40490030,0.95,71,4,75,619411
chr1,40490053,0.84,67,13,80,619412
chr1,40490444,0.83,78,16,94,619413
chr1,40490478,0.49,42,44,86,619414
chr1,40490968,0.98,81,2,83,619415
chr1,40491021,0.78,47,13,60,619416
chr1,40491276,0.88,65,9,74,619417
chr1,40491323,0.9,74,8,82,619418
chr1,40491327,0.93,80,6,86,619419
chr1,40491446,0.96,75,3,78,619420
chr1,40491644,0.93,141,10,151,619421
chr1,40491651,0.99,149,2,151,619422
chr1,40491670,0.91,121,12,133,619423
chr1,40491844,0.86,72,12,84,619424
chr1,40491891,0.82,71,16,87,619425
chr1,40491995,0.9,54,6,60,619426
chr1,40492026,0.95,57,3,60,619427
chr1,40492065,0.96,52,2,54,619428
chr1,40492422,0.94,61,4,65,619429
chr1,40492698,0.86,64,10,74,619430
chr1,40493040,0.97,84,3,87,619431
chr1,40493782,0.93,53,4,57,619432
chr1,40493977,0.96,121,5,126,619433
chr1,40494174,0.83,63,13,76,619434
chr1,40494199,0.95,78,4,82,619435
chr1,40494300,0.92,55,5,60,619436
chr1,40494403,0.86,110,18,128,619437
chr1,40494678,0.59,53,37,90,619438
chr1,40494825,0.96,74,3,77,619439
chr1,40494863,0.87,53,8,61,619440
chr1,40494872,0.93,57,4,61,619441
chr1,40495008,0.96,50,2,52,619442
chr1,40495048,0.95,37,2,39,619443
chr1,40495117,0.78,36,10,46,619444
chr1,40495347,0.88,67,9,76,619445
chr1,40495565,0.71,66,27,93,619446
chr1,40495645,0.72,60,23,83,619447
chr1,40495725,0.46,41,49,90,619448
chr1,40495747,0.86,81,13,94,619449
chr1,40495826,0.97,62,2,64,619450
chr1,40495842,0.96,51,2,53,619451
chr1,40495850,0.89,41,5,46,619452
chr1,40495865,1,48,0,48,619453
chr1,40495902,0.91,50,5,55,619454
chr1,40495912,0.98,55,1,56,619455
chr1,40495914,1,57,0,57,619456
chr1,40495918,0.95,60,3,63,619457
chr1,40496088,0.63,68,40,108,619458
chr1,40496418,0.84,90,17,107,619459
chr1,40496632,0.7,64,28,92,619460
chr1,40496648,0.48,42,46,88,619461
chr1,40496907,0.96,68,3,71,619462
chr1,40496916,0.99,67,1,68,619463
chr1,40496934,0.92,69,6,75,619464
chr1,40496990,0.95,73,4,77,619465
chr1,40497051,0.43,33,43,76,619466
chr1,40497201,0.96,68,3,71,619467
chr1,40497576,0.98,59,1,60,619468
chr1,40497611,0.43,32,42,74,619469
chr1,40497708,0.36,27,49,76,619470
chr1,40497731,1,77,0,77,619471
chr1,40498084,0,0,95,95,619472
chr1,40498185,0.3,38,88,126,619473
chr1,40498323,0.78,62,18,80,619474
chr1,40498500,1,41,0,41,619475
chr1,40498683,0.96,45,2,47,619476
chr1,40498781,0.93,78,6,84,619477
chr1,40498815,1,95,0,95,619478
chr1,40498921,0.94,81,5,86,619479
chr1,40499332,0.97,72,2,74,619480
chr1,40499463,0.88,66,9,75,619481
chr1,40499816,0.94,68,4,72,619482
chr1,40499905,0.87,45,7,52,619483
chr1,40499949,0.9,70,8,78,619484
chr1,40499969,0.84,67,13,80,619485
chr1,40499991,0.96,85,4,89,619486
chr1,40500347,0.92,72,6,78,619487
chr1,40500480,0.97,62,2,64,619488
chr1,40500524,0.93,69,5,74,619489
chr1,40500526,0.76,55,17,72,619490
chr1,40500679,0.78,68,19,87,619491
chr1,40500808,0.76,44,14,58,619492
chr1,40501048,0.57,60,45,105,619493
chr1,40501272,0.98,96,2,98,619494
chr1,40501352,0.98,78,2,80,619495
chr1,40501459,1,60,0,60,619496
chr1,40501588,0.93,26,2,28,619497
chr1,40501594,0.94,30,2,32,619498
chr1,40501637,0.97,60,2,62,619499
chr1,40501778,0.81,68,16,84,619500
chr1,40502134,0.05,5,86,91,619501
chr1,40502254,0.44,42,53,95,619502
chr1,40502378,0.01,1,92,93,619503
chr1,40502410,0.02,2,108,110,619504
chr1,40502486,0.03,3,88,91,619505
chr1,40503096,0.76,19,6,25,619506
chr1,40503199,0.93,90,7,97,619507
chr1,40503215,0.97,98,3,101,619508
chr1,40503221,0.96,104,4,108,619509
chr1,40503278,0.92,67,6,73,619510
chr1,40503291,0.95,60,3,63,619511
chr1,40503314,0.93,42,3,45,619512
chr1,40503337,0.93,42,3,45,619513
chr1,40503346,0.96,43,2,45,619514
chr1,40503384,0.95,52,3,55,619515
chr1,40503386,0.98,54,1,55,619516
chr1,40503394,0.97,57,2,59,619517
chr1,40503529,0.98,84,2,86,619518
chr1,40503810,1,88,0,88,619519
chr1,40503842,0.96,76,3,79,619520
chr1,40504091,0.96,66,3,69,619521
chr1,40504114,1,66,0,66,619522
chr1,40504144,1,50,0,50,619523
chr1,40504154,1,48,0,48,619524
chr1,40504196,0.98,52,1,53,619525
chr1,40504208,0.98,56,1,57,619526
chr1,40504241,0.96,66,3,69,619527
chr1,40504286,0.97,56,2,58,619528
chr1,40504297,0.96,54,2,56,619529
chr1,40504302,0.95,55,3,58,619530
chr1,40504340,0.95,63,3,66,619531
chr1,40504342,0.97,68,2,70,619532
chr1,40504361,0.99,81,1,82,619533
chr1,40504468,0.66,48,25,73,619534
chr1,40504529,0.86,60,10,70,619535
chr1,40504628,0.47,35,39,74,619536
chr1,40504862,0.03,2,62,64,619537
chr1,40505129,0,0,124,124,619538
chr1,40505160,0,0,119,119,619539
chr1,40505198,0,0,121,121,619540
chr1,40505264,0,0,118,118,619541
chr1,40505286,0.01,1,117,118,619542
chr1,40505301,0,0,108,108,619543
chr1,40505317,0,0,72,72,619544
chr1,40505377,0,0,79,79,619545
chr1,40505412,0,0,64,64,619546
chr1,40505421,0,0,67,67,619547
chr1,40505435,0,0,63,63,619548
chr1,40505441,0,0,56,56,619549
chr1,40505455,0,0,51,51,619550
chr1,40505457,0,0,55,55,619551
chr1,40505459,0,0,53,53,619552
chr1,40505469,0,0,55,55,619553
chr1,40505473,0.02,1,52,53,619554
chr1,40505490,0,0,58,58,619555
chr1,40505501,0,0,50,50,619556
chr1,40505525,0,0,50,50,619557
chr1,40505543,0,0,63,63,619558
chr1,40505597,0,0,58,58,619559
chr1,40505613,0,0,34,34,619560
chr1,40505615,0,0,37,37,619561
chr1,40505618,0,0,58,58,619562
chr1,40505646,0,0,50,50,619563
chr1,40505656,0,0,59,59,619564
chr1,40505658,0,0,55,55,619565
chr1,40505660,0.02,1,54,55,619566
chr1,40505698,0,0,44,44,619567
chr1,40505724,0,0,30,30,619568
chr1,40505750,0,0,32,32,619569
chr1,40505752,0.03,1,31,32,619570
chr1,40505763,0.03,1,29,30,619571
chr1,40505782,0.05,1,19,20,619572
chr1,40505784,0,0,14,14,619573
chr1,40505802,0,0,27,27,619574
chr1,40505809,0,0,30,30,619575
chr1,40505820,0,0,52,52,619576
chr1,40505863,0,0,61,61,619577
chr1,40505872,0,0,67,67,619578
chr1,40505881,0,0,69,69,619579
chr1,40505892,0,0,60,60,619580
chr1,40505906,0,0,59,59,619581
chr1,40505911,0,0,55,55,619582
chr1,40505919,0,0,72,72,619583
chr1,40505929,0,0,84,84,619584
chr1,40505939,0,0,80,80,619585
chr1,40505943,0.02,1,63,64,619586
chr1,40505947,0,0,88,88,619587
chr1,40505955,0.02,1,59,60,619588
chr1,40505982,0,0,99,99,619589
chr1,40505999,0.01,1,99,100,619590
chr1,40506020,0.01,1,93,94,619591
chr1,40506118,0,0,75,75,619592
chr1,40506125,0,0,73,73,619593
chr1,40506131,0,0,44,44,619594
chr1,40506137,0,0,73,73,619595
chr1,40506150,0,0,63,63,619596
chr1,40506155,0.01,1,66,67,619597
chr1,40506161,0,0,44,44,619598
chr1,40506181,0,0,29,29,619599
chr1,40506190,0,0,58,58,619600
chr1,40506195,0,0,45,45,619601
chr1,40506201,0,0,51,51,619602
chr1,40506212,0.03,1,38,39,619603
chr1,40506245,0.02,1,46,47,619604
chr1,40506250,0,0,28,28,619605
chr1,40506259,0,0,53,53,619606
chr1,40506264,0,0,36,36,619607
chr1,40506269,0,0,54,54,619608
chr1,40506279,0.03,1,38,39,619609
chr1,40506287,0,0,64,64,619610
chr1,40506291,0,0,51,51,619611
chr1,40506296,0.03,1,38,39,619612
chr1,40506317,0,0,63,63,619613
chr1,40506319,0,0,65,65,619614
chr1,40506332,0.01,1,67,68,619615
chr1,40506341,0,0,70,70,619616
chr1,40506344,0.02,1,61,62,619617
chr1,40506355,0,0,70,70,619618
chr1,40506364,0,0,26,26,619619
chr1,40506367,0,0,57,57,619620
chr1,40506369,0,0,49,49,619621
chr1,40506384,0,0,58,58,619622
chr1,40506395,0.02,1,54,55,619623
chr1,40506397,0.02,1,51,52,619624
chr1,40506399,0,0,52,52,619625
chr1,40506413,0,0,27,27,619626
chr1,40506423,0.02,1,50,51,619627
chr1,40506429,0,0,41,41,619628
chr1,40506436,0,0,25,25,619629
chr1,40506444,0.02,1,45,46,619630
chr1,40506451,0,0,44,44,619631
chr1,40506462,0,0,24,24,619632
chr1,40506512,0.02,1,46,47,619633
chr1,40506522,0,0,49,49,619634
chr1,40506557,0,0,46,46,619635
chr1,40506559,0,0,43,43,619636
chr1,40506561,0,0,45,45,619637
chr1,40506578,0,0,55,55,619638
chr1,40506587,0,0,51,51,619639
chr1,40506607,0,0,54,54,619640
chr1,40506612,0,0,56,56,619641
chr1,40506624,0,0,40,40,619642
chr1,40506626,0,0,46,46,619643
chr1,40506645,0.02,1,43,44,619644
chr1,40506664,0.02,1,55,56,619645
chr1,40506673,0,0,56,56,619646
chr1,40506691,0.02,1,63,64,619647
chr1,40506697,0,0,65,65,619648
chr1,40506702,0,0,61,61,619649
chr1,40506721,0.01,1,79,80,619650
chr1,40506763,0.01,1,88,89,619651
chr1,40506769,0,0,86,86,619652
chr1,40506858,0,0,73,73,619653
chr1,40506875,0,0,82,82,619654
chr1,40506921,0,0,77,77,619655
chr1,40506930,0,0,71,71,619656
chr1,40506959,0,0,67,67,619657
chr1,40506963,0,0,65,65,619658
chr1,40506974,0,0,65,65,619659
chr1,40507001,0,0,48,48,619660
chr1,40507006,0,0,58,58,619661
chr1,40507043,0.02,1,50,51,619662
chr1,40507078,0,0,51,51,619663
chr1,40507124,0,0,63,63,619664
chr1,40507193,0,0,95,95,619665
chr1,40507319,0.02,3,138,141,619666
chr1,40507362,0.01,2,134,136,619667
chr1,40507403,0.02,2,116,118,619668
chr1,40507405,0.02,2,117,119,619669
chr1,40507570,0.25,22,66,88,619670
chr1,40507574,0.41,37,53,90,619671
chr1,40507665,0.24,14,44,58,619672
chr1,40507745,0.68,41,19,60,619673
chr1,40507748,0.39,26,41,67,619674
chr1,40507768,0.66,48,25,73,619675
chr1,40507800,0.58,46,33,79,619676
chr1,40507824,0.61,54,34,88,619677
chr1,40507838,0.45,43,52,95,619678
chr1,40507844,0.68,68,32,100,619679
chr1,40507857,0.12,13,93,106,619680
chr1,40508108,0.65,70,37,107,619681
chr1,40508161,0.64,86,49,135,619682
chr1,40508182,0.37,50,86,136,619683
chr1,40508350,0.5,56,57,113,619684
chr1,40508566,0.94,105,7,112,619685
chr1,40508568,0.82,97,21,118,619686
chr1,40508762,0.72,69,27,96,619687
chr1,40508847,0.77,48,14,62,619688
chr1,40508892,0.68,32,15,47,619689
chr1,40508938,0.84,48,9,57,619690
chr1,40509014,0.86,51,8,59,619691
chr1,40509018,1,54,0,54,619692
chr1,40509026,0.92,49,4,53,619693
chr1,40509030,0.93,52,4,56,619694
chr1,40509058,0.74,42,15,57,619695
chr1,40509089,0.86,54,9,63,619696
chr1,40509103,0.82,58,13,71,619697
chr1,40509110,0.84,63,12,75,619698
chr1,40509119,0.88,72,10,82,619699
chr1,40509157,0.89,86,11,97,619700
chr1,40509163,0.86,81,13,94,619701
chr1,40509166,0.4,34,51,85,619702
chr1,40509286,0.69,42,19,61,619703
chr1,40509409,0.84,68,13,81,619704
chr1,40509463,0.86,73,12,85,619705
chr1,40509473,0.77,60,18,78,619706
chr1,40509480,0.97,66,2,68,619707
chr1,40509578,0.58,46,34,80,619708
chr1,40510004,0.23,25,85,110,619709
chr1,40510054,0.48,46,49,95,619710
chr1,40510058,0.72,65,25,90,619711
chr1,40510354,0.4,31,47,78,619712
chr1,40510426,0.25,14,42,56,619713
chr1,40510537,0.81,56,13,69,619714
chr1,40510561,0.96,87,4,91,619715
chr1,40510569,0.98,90,2,92,619716
chr1,40510593,0.86,69,11,80,619717
chr1,40510613,0.99,73,1,74,619718
chr1,40510617,0.83,38,8,46,619719
chr1,40510658,0.87,54,8,62,619720
chr1,40510691,0.98,56,1,57,619721
chr1,40510702,1,48,0,48,619722
chr1,40510707,0.94,46,3,49,619723
chr1,40510745,1,47,0,47,619724
chr1,40510747,0.96,45,2,47,619725
chr1,40510926,0.83,72,15,87,619726
chr1,40510939,0.92,90,8,98,619727
chr1,40511011,0.46,50,58,108,619728
chr1,40511182,0.9,74,8,82,619729
chr1,40511262,0.41,21,30,51,619730
chr1,40511266,0.46,21,25,46,619731
chr1,40511288,0.93,41,3,44,619732
chr1,40511320,0.8,36,9,45,619733
chr1,40511447,0.79,42,11,53,619734
chr1,40511516,0.91,71,7,78,619735
chr1,40511520,0.87,76,11,87,619736
chr1,40511853,0.96,68,3,71,619737
chr1,40511865,0.95,59,3,62,619738
chr1,40511898,0.92,44,4,48,619739
chr1,40511925,0.98,49,1,50,619740
chr1,40511956,0.89,57,7,64,619741
chr1,40512003,0.99,75,1,76,619742
chr1,40512051,0.94,72,5,77,619743
chr1,40512082,0.82,55,12,67,619744
chr1,40512101,0.97,61,2,63,619745
chr1,40512129,0.73,46,17,63,619746
chr1,40512467,0.05,1,19,20,619747
chr1,40512483,0.25,5,15,20,619748
chr1,40512507,0.62,21,13,34,619749
chr1,40512530,0.98,47,1,48,619750
chr1,40512591,0.46,36,43,79,619751
chr1,40512601,0.99,79,1,80,619752
chr1,40512732,0.58,35,25,60,619753
chr1,40512734,0.75,39,13,52,619754
chr1,40512738,0.59,32,22,54,619755
chr1,40513222,0.04,3,78,81,619756
chr1,40513321,0.12,10,75,85,619757
chr1,40513355,0.08,6,69,75,619758
chr1,40513395,0.07,4,57,61,619759
chr1,40513582,0.35,29,53,82,619760
chr1,40513618,0.16,13,70,83,619761
chr1,40513767,0.98,39,1,40,619762
chr1,40513776,0.98,43,1,44,619763
chr1,40513783,0.92,44,4,48,619764
chr1,40513863,0.85,56,10,66,619765
chr1,40513903,0.55,34,28,62,619766
chr1,40513934,0.95,59,3,62,619767
chr1,40513979,0.96,46,2,48,619768
chr1,40514160,0.77,70,21,91,619769
chr1,40514343,0.97,94,3,97,619770
chr1,40514729,0.9,91,10,101,619771
chr1,40514897,0.03,1,31,32,619772
chr1,40514919,0.06,2,33,35,619773
chr1,40514921,0.05,2,41,43,619774
chr1,40514927,0.08,4,49,53,619775
chr1,40514945,0.08,4,47,51,619776
chr1,40515071,0.09,5,53,58,619777
chr1,40515079,0.08,4,45,49,619778
chr1,40515102,0.08,4,49,53,619779
chr1,40515129,0.07,4,50,54,619780
chr1,40515174,0.49,37,39,76,619781
chr1,40515642,0,0,108,108,619782
chr1,40515742,0.07,7,92,99,619783
chr1,40515876,0.16,12,64,76,619784
chr1,40516128,0.95,38,2,40,619785
chr1,40516151,0.98,54,1,55,619786
chr1,40516184,0.98,64,1,65,619787
chr1,40516187,0.97,59,2,61,619788
chr1,40516191,1,59,0,59,619789
chr1,40516223,0.86,36,6,42,619790
chr1,40516245,0.97,33,1,34,619791
chr1,40516543,0.71,74,30,104,619792
chr1,40516773,0.91,87,9,96,619793
chr1,40516836,0.81,88,20,108,619794
chr1,40517286,1,39,0,39,619795
chr1,40517308,0.97,29,1,30,619796
chr1,40517310,0.97,30,1,31,619797
chr1,40517324,1,32,0,32,619798
chr1,40517333,1,30,0,30,619799
chr1,40517340,0.97,34,1,35,619800
chr1,40517402,0.63,41,24,65,619801
chr1,40517431,0.75,40,13,53,619802
chr1,40517462,0.97,32,1,33,619803
chr1,40517483,0.97,35,1,36,619804
chr1,40517492,0.97,30,1,31,619805
chr1,40517520,0.95,41,2,43,619806
chr1,40517530,0.98,41,1,42,619807
chr1,40517532,0.98,43,1,44,619808
chr1,40517831,0.95,69,4,73,619809
chr1,40517894,0.92,83,7,90,619810
chr1,40518102,0.43,48,64,112,619811
chr1,40518126,0.93,98,7,105,619812
chr1,40518488,0.98,89,2,91,619813
chr1,40518490,0.51,41,40,81,619814
chr1,40518500,0.97,69,2,71,619815
chr1,40518528,1,61,0,61,619816
chr1,40518578,0.95,54,3,57,619817
chr1,40518589,0.94,68,4,72,619818
chr1,40518634,0.98,58,1,59,619819
chr1,40518667,1,29,0,29,619820
chr1,40518671,1,10,0,10,619821
chr1,40518692,1,3,0,3,619822
chr1,40518723,1,4,0,4,619823
chr1,40518752,0.65,17,9,26,619824
chr1,40518756,1,28,0,28,619825
chr1,40518788,0.96,45,2,47,619826
chr1,40518820,0.98,61,1,62,619827
chr1,40518850,0.98,56,1,57,619828
chr1,40519144,0.42,28,38,66,619829
chr1,40519183,0.79,54,14,68,619830
chr1,40519191,0.62,45,28,73,619831
chr1,40519208,0.98,84,2,86,619832
chr1,40519271,0.78,73,20,93,619833
chr1,40519307,0.52,33,30,63,619834
chr1,40519338,0.69,38,17,55,619835
chr1,40519346,0.83,48,10,58,619836
chr1,40519408,0.07,6,77,83,619837
chr1,40519490,0.33,38,76,114,619838
chr1,40519657,0.21,22,81,103,619839
chr1,40519769,0.17,12,59,71,619840
chr1,40519923,0.96,54,2,56,619841
chr1,40520007,0.98,109,2,111,619842
chr1,40520019,0.49,59,62,121,619843
chr1,40520037,0.91,96,9,105,619844
chr1,40520067,0.96,106,4,110,619845
chr1,40520094,0.9,93,10,103,619846
chr1,40520099,0.96,96,4,100,619847
chr1,40520127,0.9,87,10,97,619848
chr1,40520382,0.97,77,2,79,619849
chr1,40520461,0.99,96,1,97,619850
chr1,40520517,0.97,100,3,103,619851
chr1,40520607,0.51,56,53,109,619852
chr1,40520623,0.78,87,25,112,619853
chr1,40520854,0.74,72,25,97,619854
chr1,40520866,0.69,64,29,93,619855
chr1,40520975,0.79,45,12,57,619856
chr1,40521390,0.74,53,19,72,619857
chr1,40521951,0.55,47,39,86,619858
chr1,40522052,0.94,50,3,53,619859
chr1,40522128,0.92,57,5,62,619860
chr1,40522185,0.09,6,63,69,619861
chr1,40522365,1,82,0,82,619862
chr1,40522429,0.96,44,2,46,619863
chr1,40522441,0.92,44,4,48,619864
chr1,40522683,0.87,93,14,107,619865
chr1,40522944,0.92,92,8,100,619866
chr1,40523478,0.19,20,84,104,619867
chr1,40524119,0.91,61,6,67,619868
chr1,40524135,0.85,53,9,62,619869
chr1,40524168,0.9,56,6,62,619870
chr1,40524229,0.99,79,1,80,619871
chr1,40524267,0.99,85,1,86,619872
chr1,40524557,0.39,32,51,83,619873
chr1,40524612,0.68,50,23,73,619874
chr1,40524648,0.59,37,26,63,619875
chr1,40525067,0.89,78,10,88,619876
chr1,40525103,0.64,56,32,88,619877
chr1,40525169,0.3,26,61,87,619878
chr1,40525208,0.48,30,33,63,619879
chr1,40525679,0.32,30,63,93,619880
chr1,40525772,0.81,76,18,94,619881
chr1,40525830,0.56,36,28,64,619882
chr1,40526015,0.43,47,63,110,619883
chr1,40526053,0.37,40,68,108,619884
chr1,40526326,0.55,18,15,33,619885
chr1,40526417,0.47,52,59,111,619886
chr1,40526468,0.03,4,113,117,619887
chr1,40526746,0.75,80,26,106,619888
chr1,40526776,0.22,21,74,95,619889
chr1,40527120,0.94,84,5,89,619890
chr1,40527408,0.98,56,1,57,619891
chr1,40527440,0.94,58,4,62,619892
chr1,40527530,0.71,46,19,65,619893
chr1,40528250,0.71,49,20,69,619894
chr1,40528311,0.9,65,7,72,619895
chr1,40528415,1,29,0,29,619896
chr1,40528888,0.93,42,3,45,619897
chr1,40528918,0.95,42,2,44,619898
chr1,40528998,1,58,0,58,619899
chr1,40529086,0.98,80,2,82,619900
chr1,40529128,0.94,73,5,78,619901
chr1,40529265,0.97,71,2,73,619902
chr1,40529380,0.83,107,22,129,619903
chr1,40529725,0.88,98,14,112,619904
chr1,40529910,0.93,96,7,103,619905
chr1,40529959,0.96,116,5,121,619906
chr1,40529971,0.78,95,27,122,619907
chr1,40530009,0.98,109,2,111,619908
chr1,40530051,0.96,80,3,83,619909
chr1,40530187,1,69,0,69,619910
chr1,40530206,0.89,63,8,71,619911
chr1,40530281,0.88,42,6,48,619912
chr1,40530394,0.93,92,7,99,619913
chr1,40530429,0.81,90,21,111,619914
chr1,40530955,0.89,84,10,94,619915
chr1,40530987,0.76,60,19,79,619916
chr1,40531326,0.82,75,17,92,619917
chr1,40531769,0.98,94,2,96,619918
chr1,40531788,0.81,86,20,106,619919
chr1,40531849,0.97,98,3,101,619920
chr1,40531971,0.87,48,7,55,619921
chr1,40531991,0.7,38,16,54,619922
chr1,40532772,0.68,91,42,133,619923
chr1,40532873,0.96,102,4,106,619924
chr1,40533235,0.97,31,1,32,619925
chr1,40533259,0.9,19,2,21,619926
chr1,40533341,0.88,22,3,25,619927
chr1,40533355,1,36,0,36,619928
chr1,40533357,1,38,0,38,619929
chr1,40533409,0.88,91,13,104,619930
chr1,40533459,0.86,90,15,105,619931
chr1,40533498,0.72,71,27,98,619932
chr1,40533527,0.79,80,21,101,619933
chr1,40533658,0.87,90,14,104,619934
chr1,40533680,0.68,73,34,107,619935
chr1,40533966,0.93,43,3,46,619936
chr1,40533978,0.62,31,19,50,619937
chr1,40534003,0.97,33,1,34,619938
chr1,40534005,0.94,31,2,33,619939
chr1,40534011,0.95,41,2,43,619940
chr1,40534067,0.86,48,8,56,619941
chr1,40534091,1,57,0,57,619942
chr1,40534201,0.98,50,1,51,619943
chr1,40534241,0.92,61,5,66,619944
chr1,40534245,1,68,0,68,619945
chr1,40534417,0.98,87,2,89,619946
chr1,40534422,0.94,82,5,87,619947
chr1,40534565,0.9,47,5,52,619948
chr1,40534664,0.78,53,15,68,619949
chr1,40534749,0.91,86,8,94,619950
chr1,40534797,0.96,92,4,96,619951
chr1,40535302,0.98,112,2,114,619952
chr1,40535433,0.94,48,3,51,619953
chr1,40535490,0.67,45,22,67,619954
chr1,40535620,0.98,91,2,93,619955
chr1,40535642,0.99,87,1,88,619956
chr1,40535644,0.98,85,2,87,619957
chr1,40535650,0.97,84,3,87,619958
chr1,40535658,0.99,86,1,87,619959
chr1,40535667,1,85,0,85,619960
chr1,40535674,0.87,78,12,90,619961
chr1,40535786,0.98,84,2,86,619962
chr1,40535913,0.86,66,11,77,619963
chr1,40535967,0.98,97,2,99,619964
chr1,40535977,0.99,105,1,106,619965
chr1,40535986,0.94,94,6,100,619966
chr1,40535998,0.93,101,8,109,619967
chr1,40536130,0.84,57,11,68,619968
chr1,40536136,0.82,62,14,76,619969
chr1,40536191,0.72,75,29,104,619970
chr1,40536312,0.76,61,19,80,619971
chr1,40536373,0.78,59,17,76,619972
chr1,40536391,0.94,72,5,77,619973
chr1,40536426,0.71,55,23,78,619974
chr1,40536450,0.83,68,14,82,619975
chr1,40536612,0.89,101,12,113,619976
chr1,40536642,0.98,112,2,114,619977
chr1,40536958,0.96,79,3,82,619978
chr1,40537014,0.8,66,16,82,619979
chr1,40537163,0.81,66,15,81,619980
chr1,40537207,0.97,63,2,65,619981
chr1,40537266,0.73,51,19,70,619982
chr1,40537438,0.97,67,2,69,619983
chr1,40537441,0.96,75,3,78,619984
chr1,40537466,0.73,65,24,89,619985
chr1,40537676,0.95,63,3,66,619986
chr1,40537792,0.53,44,39,83,619987
chr1,40538535,0.5,52,53,105,619988
chr1,40538552,0.95,101,5,106,619989
chr1,40538605,0.63,79,46,125,619990
chr1,40538671,0.46,49,58,107,619991
chr1,40538972,0.82,49,11,60,619992
chr1,40539015,0.91,58,6,64,619993
chr1,40539017,0.93,56,4,60,619994
chr1,40539032,0.96,70,3,73,619995
chr1,40539222,0.67,36,18,54,619996
chr1,40539727,0.66,49,25,74,619997
chr1,40539851,0.92,76,7,83,619998
chr1,40539921,0.88,65,9,74,619999
chr1,40540162,0.95,70,4,74,620000
chr1,40540174,0.9,66,7,73,620001
chr1,40540202,0.94,83,5,88,620002
chr1,40540208,0.99,90,1,91,620003
chr1,40540242,0.95,89,5,94,620004
chr1,40540284,0.98,84,2,86,620005
chr1,40540385,0.96,81,3,84,620006
chr1,40540392,0.99,77,1,78,620007
chr1,40540420,0.92,68,6,74,620008
chr1,40540436,0.89,71,9,80,620009
chr1,40540560,0.98,58,1,59,620010
chr1,40540652,0.98,52,1,53,620011
chr1,40540654,1,54,0,54,620012
chr1,40540664,0.95,55,3,58,620013
chr1,40540701,0.96,69,3,72,620014
chr1,40540795,0.94,83,5,88,620015
chr1,40540842,0.99,89,1,90,620016
chr1,40540852,0.98,83,2,85,620017
chr1,40540859,1,83,0,83,620018
chr1,40540956,0.66,57,30,87,620019
chr1,40541062,0.94,81,5,86,620020
chr1,40541088,0.75,55,18,73,620021
chr1,40541289,0.79,89,23,112,620022
chr1,40541361,0.97,87,3,90,620023
chr1,40541464,0.82,74,16,90,620024
chr1,40541501,0.93,95,7,102,620025
chr1,40541547,0.89,71,9,80,620026
chr1,40541801,0.96,98,4,102,620027
chr1,40541862,0.99,76,1,77,620028
chr1,40541874,0.82,55,12,67,620029
chr1,40542123,0.96,50,2,52,620030
chr1,40542131,0.68,34,16,50,620031
chr1,40542727,0.68,36,17,53,620032
chr1,40542759,0.68,41,19,60,620033
chr1,40542788,0.86,48,8,56,620034
chr1,40542923,0.64,76,43,119,620035
chr1,40542960,0.21,25,93,118,620036
chr1,40543243,0.79,102,27,129,620037
chr1,40543260,0.62,84,51,135,620038
chr1,40543296,0.9,124,14,138,620039
chr1,40543323,0.79,108,28,136,620040
chr1,40543364,0.96,107,4,111,620041
chr1,40543411,0.85,92,16,108,620042
chr1,40543483,0.75,83,27,110,620043
chr1,40543535,0.91,100,10,110,620044
chr1,40543900,0.99,67,1,68,620045
chr1,40543932,0.9,79,9,88,620046
chr1,40544030,0.88,99,14,113,620047
chr1,40544059,0.94,80,5,85,620048
chr1,40544120,0.9,52,6,58,620049
chr1,40544163,0.97,71,2,73,620050
chr1,40544169,0.97,77,2,79,620051
chr1,40544235,0.79,77,20,97,620052
chr1,40544720,0.92,69,6,75,620053
chr1,40544805,0.89,66,8,74,620054
chr1,40544914,0.99,74,1,75,620055
chr1,40544976,0.9,90,10,100,620056
chr1,40545035,0.79,46,12,58,620057
chr1,40545099,0.98,39,1,40,620058
chr1,40545110,0.96,54,2,56,620059
chr1,40545171,0.98,81,2,83,620060
chr1,40545217,0.96,74,3,77,620061
chr1,40545287,0.97,62,2,64,620062
chr1,40545319,0.92,49,4,53,620063
chr1,40545347,0.95,62,3,65,620064
chr1,40545359,0.98,65,1,66,620065
chr1,40545363,0.97,72,2,74,620066
chr1,40545532,0.82,74,16,90,620067
chr1,40545806,0.96,73,3,76,620068
chr1,40545825,0.88,52,7,59,620069
chr1,40546035,0.86,88,14,102,620070
chr1,40546053,0.79,96,25,121,620071
chr1,40546070,0.92,126,11,137,620072
chr1,40546109,0.93,118,9,127,620073
chr1,40546146,0.89,85,10,95,620074
chr1,40546155,0.75,68,23,91,620075
chr1,40546209,0.94,72,5,77,620076
chr1,40546329,0.88,44,6,50,620077
chr1,40546374,0.94,47,3,50,620078
chr1,40546406,0.98,78,2,80,620079
chr1,40546408,0.96,76,3,79,620080
chr1,40546411,0.99,78,1,79,620081
chr1,40546418,0.96,78,3,81,620082
chr1,40546471,0.97,77,2,79,620083
chr1,40546474,0.96,78,3,81,620084
chr1,40546500,1,77,0,77,620085
chr1,40546524,0.96,70,3,73,620086
chr1,40546874,0.91,83,8,91,620087
chr1,40546978,0.95,36,2,38,620088
chr1,40546987,0.97,37,1,38,620089
chr1,40547005,0.98,43,1,44,620090
chr1,40547036,0.96,48,2,50,620091
chr1,40547070,0.95,63,3,66,620092
chr1,40547123,0.98,55,1,56,620093
chr1,40547165,1,44,0,44,620094
chr1,40547195,0.98,39,1,40,620095
chr1,40547295,0.98,44,1,45,620096
chr1,40547316,1,40,0,40,620097
chr1,40547323,0.98,63,1,64,620098
chr1,40547394,0.96,106,4,110,620099
chr1,40547409,0.96,109,5,114,620100
chr1,40547769,0.88,44,6,50,620101
chr1,40547800,0.93,65,5,70,620102
chr1,40547855,0.91,98,10,108,620103
chr1,40547860,0.94,111,7,118,620104
chr1,40547905,0.41,58,83,141,620105
chr1,40547912,0.42,57,78,135,620106
chr1,40547928,0.96,107,5,112,620107
chr1,40547953,0.89,102,12,114,620108
chr1,40548263,0.89,64,8,72,620109
chr1,40548470,0.97,91,3,94,620110
chr1,40548689,0.5,52,53,105,620111
chr1,40548835,0.81,78,18,96,620112
chr1,40548983,0.93,82,6,88,620113
chr1,40548992,0.98,79,2,81,620114
chr1,40549220,0.98,81,2,83,620115
chr1,40549401,0.91,96,10,106,620116
chr1,40549454,0.95,75,4,79,620117
chr1,40549617,0.92,67,6,73,620118
chr1,40549755,0.41,51,72,123,620119
chr1,40549905,0.75,96,32,128,620120
chr1,40549958,0.91,92,9,101,620121
chr1,40550029,0.94,77,5,82,620122
chr1,40550079,0.86,82,13,95,620123
chr1,40550150,0.99,102,1,103,620124
chr1,40550269,0.67,63,31,94,620125
chr1,40550282,0.81,75,18,93,620126
chr1,40550300,0.98,78,2,80,620127
chr1,40550534,0.03,2,62,64,620128
chr1,40550567,0.2,13,51,64,620129
chr1,40550579,0.21,12,46,58,620130
chr1,40550595,0.15,8,46,54,620131
chr1,40550605,0.18,9,40,49,620132
chr1,40550610,0.2,10,40,50,620133
chr1,40550626,0.18,7,31,38,620134
chr1,40550688,0.1,4,37,41,620135
chr1,40550734,0.19,7,29,36,620136
chr1,40550752,0.51,21,20,41,620137
chr1,40550766,0.49,27,28,55,620138
chr1,40550954,0.96,24,1,25,620139
chr1,40550993,0.86,38,6,44,620140
chr1,40551078,0.91,51,5,56,620141
chr1,40551092,0.46,28,33,61,620142
chr1,40551098,1,59,0,59,620143
chr1,40551113,0.87,59,9,68,620144
chr1,40551135,0.95,56,3,59,620145
chr1,40551195,0.95,40,2,42,620146
chr1,40551218,0.59,33,23,56,620147
chr1,40551292,0.96,89,4,93,620148
chr1,40551457,0.86,76,12,88,620149
chr1,40551563,0.88,111,15,126,620150
chr1,40551661,0.98,102,2,104,620151
chr1,40551745,0.99,99,1,100,620152
chr1,40551830,0.82,83,18,101,620153
chr1,40551840,0.88,84,12,96,620154
chr1,40551909,1,58,0,58,620155
chr1,40551938,0.88,53,7,60,620156
chr1,40552047,0.91,49,5,54,620157
chr1,40552069,0.93,51,4,55,620158
chr1,40552095,0.94,63,4,67,620159
chr1,40552110,0.88,65,9,74,620160
chr1,40552193,0.83,70,14,84,620161
chr1,40552236,0.95,70,4,74,620162
chr1,40552325,0.91,52,5,57,620163
chr1,40552391,0.86,54,9,63,620164
chr1,40552395,0.95,63,3,66,620165
chr1,40552458,0.98,52,1,53,620166
chr1,40552977,1,91,0,91,620167
chr1,40553000,0.97,92,3,95,620168
chr1,40553038,0.95,75,4,79,620169
chr1,40553071,0.94,73,5,78,620170
chr1,40553206,0.95,78,4,82,620171
chr1,40553211,0.96,87,4,91,620172
chr1,40553248,0.94,90,6,96,620173
chr1,40553251,0.87,80,12,92,620174
chr1,40553288,0.95,87,5,92,620175
chr1,40553332,0.57,44,33,77,620176
chr1,40553608,0.73,63,23,86,620177
chr1,40553795,0.81,29,7,36,620178
chr1,40553838,0.96,27,1,28,620179
chr1,40553876,1,64,0,64,620180
chr1,40553884,0.89,67,8,75,620181
chr1,40553901,1,91,0,91,620182
chr1,40553908,0.91,92,9,101,620183
chr1,40553963,0.92,96,8,104,620184
chr1,40553967,0.96,100,4,104,620185
chr1,40553975,0.95,104,5,109,620186
chr1,40554007,0.93,93,7,100,620187
chr1,40554096,0.94,77,5,82,620188
chr1,40554112,0.94,78,5,83,620189
chr1,40554680,0.94,91,6,97,620190
chr1,40554696,0.94,84,5,89,620191
chr1,40554748,0.96,69,3,72,620192
chr1,40554819,0.97,74,2,76,620193
chr1,40554827,0.95,75,4,79,620194
chr1,40554851,0.97,66,2,68,620195
chr1,40554857,0.97,67,2,69,620196
chr1,40554872,0.93,64,5,69,620197
chr1,40554914,1,43,0,43,620198
chr1,40554945,0.95,21,1,22,620199
chr1,40555042,0.94,99,6,105,620200
chr1,40555082,0.96,117,5,122,620201
chr1,40555105,0.98,117,3,120,620202
chr1,40555127,0.95,111,6,117,620203
chr1,40555166,0.97,102,3,105,620204
chr1,40555231,0.98,101,2,103,620205
chr1,40555321,0.55,62,51,113,620206
chr1,40555434,0.97,88,3,91,620207
chr1,40556005,0.99,72,1,73,620208
chr1,40556279,0.97,68,2,70,620209
chr1,40556468,0.77,64,19,83,620210
chr1,40556576,0.79,81,21,102,620211
chr1,40556737,0.77,88,27,115,620212
chr1,40556768,0.86,99,16,115,620213
chr1,40557020,0.93,78,6,84,620214
chr1,40557075,1,69,0,69,620215
chr1,40557099,0.97,71,2,73,620216
chr1,40557176,0.97,99,3,102,620217
chr1,40557333,0.97,66,2,68,620218
chr1,40557429,0.97,61,2,63,620219
chr1,40557466,0.98,50,1,51,620220
chr1,40557491,0.94,34,2,36,620221
chr1,40557493,1,32,0,32,620222
chr1,40557712,0.8,75,19,94,620223
chr1,40557841,0.78,61,17,78,620224
chr1,40558062,0.98,92,2,94,620225
chr1,40558105,0.83,100,20,120,620226
chr1,40558485,0.83,24,5,29,620227
chr1,40558561,0.9,79,9,88,620228
chr1,40558660,0.71,61,25,86,620229
chr1,40558722,0.86,82,13,95,620230
chr1,40559287,0.9,72,8,80,620231
chr1,40559296,0.75,62,21,83,620232
chr1,40559324,0.93,76,6,82,620233
chr1,40559354,0.97,72,2,74,620234
chr1,40559413,1,33,0,33,620235
chr1,40559470,0.16,3,16,19,620236
chr1,40559617,0.97,70,2,72,620237
chr1,40559630,0.95,77,4,81,620238
chr1,40559662,0.97,96,3,99,620239
chr1,40559685,0.94,84,5,89,620240
chr1,40559871,0.89,58,7,65,620241
chr1,40559999,0.95,103,5,108,620242
chr1,40560154,0.69,59,26,85,620243
chr1,40560399,0.4,32,48,80,620244
chr1,40560483,0.66,69,35,104,620245
chr1,40560709,0.89,80,10,90,620246
chr1,40560900,1,100,0,100,620247
chr1,40560925,0.92,104,9,113,620248
chr1,40561018,0.93,100,7,107,620249
chr1,40561068,0.97,111,4,115,620250
chr1,40561096,0.94,101,6,107,620251
chr1,40561480,0.99,111,1,112,620252
chr1,40561487,0.94,106,7,113,620253
chr1,40561687,0.94,83,5,88,620254
chr1,40562134,0.99,89,1,90,620255
chr1,40562336,0.78,57,16,73,620256
chr1,40562452,0.09,6,63,69,620257
chr1,40562471,0.13,9,62,71,620258
chr1,40562515,0.08,5,60,65,620259
chr1,40562561,0.06,3,50,53,620260
chr1,40562564,0,0,63,63,620261
chr1,40562568,0.07,4,53,57,620262
chr1,40562570,0.02,1,50,51,620263
chr1,40562614,0,0,48,48,620264
chr1,40562667,0,0,58,58,620265
chr1,40562676,0,0,49,49,620266
chr1,40562678,0.02,1,51,52,620267
chr1,40562693,0,0,48,48,620268
chr1,40562699,0,0,28,28,620269
chr1,40562712,0,0,44,44,620270
chr1,40562727,0,0,52,52,620271
chr1,40562754,0,0,43,43,620272
chr1,40562809,0,0,64,64,620273
chr1,40562815,0,0,64,64,620274
chr1,40562818,0.02,1,46,47,620275
chr1,40562821,0,0,61,61,620276
chr1,40562824,0,0,58,58,620277
chr1,40562842,0.02,1,51,52,620278
chr1,40562846,0,0,75,75,620279
chr1,40562853,0,0,72,72,620280
chr1,40562898,0,0,70,70,620281
chr1,40562902,0.02,1,53,54,620282
chr1,40562905,0,0,62,62,620283
chr1,40562914,0,0,63,63,620284
chr1,40562930,0,0,59,59,620285
chr1,40562932,0,0,59,59,620286
chr1,40562936,0,0,53,53,620287
chr1,40562938,0,0,55,55,620288
chr1,40562946,0,0,59,59,620289
chr1,40562953,0,0,53,53,620290
chr1,40562955,0,0,44,44,620291
chr1,40562960,0,0,47,47,620292
chr1,40562964,0.02,1,52,53,620293
chr1,40562972,0,0,51,51,620294
chr1,40562977,0,0,39,39,620295
chr1,40562980,0,0,57,57,620296
chr1,40562983,0,0,62,62,620297
chr1,40562994,0,0,58,58,620298
chr1,40563003,0.03,2,58,60,620299
chr1,40563010,0,0,65,65,620300
chr1,40563014,0,0,65,65,620301
chr1,40563034,0.02,1,48,49,620302
chr1,40563037,0,0,55,55,620303
chr1,40563060,0,0,52,52,620304
chr1,40563062,0,0,53,53,620305
chr1,40563074,0.02,1,44,45,620306
chr1,40563084,0.02,1,53,54,620307
chr1,40563091,0,0,62,62,620308
chr1,40563105,0,0,56,56,620309
chr1,40563111,0,0,72,72,620310
chr1,40563118,0,0,41,41,620311
chr1,40563127,0.01,1,78,79,620312
chr1,40563271,0.01,1,96,97,620313
chr1,40563332,0.02,2,98,100,620314
chr1,40563405,0.02,2,89,91,620315
chr1,40563557,0.93,50,4,54,620316
chr1,40563570,0.82,45,10,55,620317
chr1,40563574,0.8,39,10,49,620318
chr1,40563882,1,81,0,81,620319
chr1,40563886,0.99,74,1,75,620320
chr1,40563888,0.93,76,6,82,620321
chr1,40563952,0.99,73,1,74,620322
chr1,40563958,0.97,72,2,74,620323
chr1,40563989,0.93,70,5,75,620324
chr1,40564016,0.96,79,3,82,620325
chr1,40564028,0.97,75,2,77,620326
chr1,40564084,0.49,38,40,78,620327
chr1,40564100,0.99,70,1,71,620328
chr1,40564357,0.84,70,13,83,620329
chr1,40564381,0.96,71,3,74,620330
chr1,40564492,0.88,82,11,93,620331
chr1,40564506,0.74,70,25,95,620332
chr1,40564568,0.98,54,1,55,620333
chr1,40564593,1,48,0,48,620334
chr1,40564700,0.91,50,5,55,620335
chr1,40564993,0.69,43,19,62,620336
chr1,40565157,0.9,36,4,40,620337
chr1,40565189,0.93,67,5,72,620338
chr1,40565199,0.96,73,3,76,620339
chr1,40565206,0.77,55,16,71,620340
chr1,40565221,0.81,61,14,75,620341
chr1,40565259,0.86,66,11,77,620342
chr1,40565295,0.95,56,3,59,620343
chr1,40565318,0.89,56,7,63,620344
chr1,40565341,0.95,57,3,60,620345
chr1,40565488,0.85,44,8,52,620346
chr1,40565507,0.98,60,1,61,620347
chr1,40565872,0.76,19,6,25,620348
chr1,40565964,0.85,52,9,61,620349
chr1,40566060,0.74,59,21,80,620350
chr1,40566216,0.83,80,16,96,620351
chr1,40566622,0.97,32,1,33,620352
chr1,40566632,0.85,29,5,34,620353
chr1,40566665,1,19,0,19,620354
chr1,40566676,0.8,4,1,5,620355
chr1,40566690,1,3,0,3,620356
chr1,40566721,1,1,0,1,620357
chr1,40566751,1,14,0,14,620358
chr1,40566755,0.95,18,1,19,620359
chr1,40566787,0.86,25,4,29,620360
chr1,40566819,0.98,42,1,43,620361
chr1,40566826,1,40,0,40,620362
chr1,40566849,0.9,35,4,39,620363
chr1,40566873,0.79,26,7,33,620364
chr1,40566881,0.92,35,3,38,620365
chr1,40566958,0.82,61,13,74,620366
chr1,40567195,0.88,73,10,83,620367
chr1,40567206,0.52,43,39,82,620368
chr1,40567388,0.83,43,9,52,620369
chr1,40567898,0.83,73,15,88,620370
chr1,40568220,0.56,45,35,80,620371
chr1,40568757,0.84,78,15,93,620372
chr1,40568901,0.89,66,8,74,620373
chr1,40568929,0.81,66,15,81,620374
chr1,40569019,0.72,55,21,76,620375
chr1,40569076,0.95,104,6,110,620376
chr1,40569086,0.93,96,7,103,620377
chr1,40569093,0.96,93,4,97,620378
chr1,40569143,0.74,48,17,65,620379
chr1,40569446,0.9,87,10,97,620380
chr1,40569489,0.84,71,14,85,620381
chr1,40569647,0.9,63,7,70,620382
chr1,40569738,0.21,13,49,62,620383
chr1,40570361,0.76,65,21,86,620384
chr1,40570970,0.7,70,30,100,620385
chr1,40571423,0.91,68,7,75,620386
chr1,40571511,0.55,34,28,62,620387
chr1,40571592,0.93,28,2,30,620388
chr1,40571654,0.98,60,1,61,620389
chr1,40572119,0.97,63,2,65,620390
chr1,40572179,0.99,67,1,68,620391
chr1,40572313,0.96,75,3,78,620392
chr1,40572381,0.62,40,25,65,620393
chr1,40572626,0.92,66,6,72,620394
chr1,40572632,0.85,55,10,65,620395
chr1,40572670,0.91,48,5,53,620396
chr1,40572679,0.93,51,4,55,620397
chr1,40572702,0.89,51,6,57,620398
chr1,40572733,0.88,50,7,57,620399
chr1,40572883,0.92,33,3,36,620400
chr1,40572968,0.92,60,5,65,620401
chr1,40573145,0.95,81,4,85,620402
chr1,40573325,0.93,85,6,91,620403
chr1,40573331,0.84,81,15,96,620404
chr1,40573402,0.84,81,15,96,620405
chr1,40573410,0.88,83,11,94,620406
chr1,40573677,0.85,82,15,97,620407
chr1,40573682,0.87,73,11,84,620408
chr1,40573721,1,75,0,75,620409
chr1,40573753,0.92,79,7,86,620410
chr1,40573763,0.96,82,3,85,620411
chr1,40573821,0.76,66,21,87,620412
chr1,40573953,0.71,47,19,66,620413
chr1,40574045,0.9,78,9,87,620414
chr1,40574062,0.97,73,2,75,620415
chr1,40574069,0.87,67,10,77,620416
chr1,40574079,0.94,73,5,78,620417
chr1,40574101,0.84,67,13,80,620418
chr1,40574133,0.77,58,17,75,620419
chr1,40574136,0.87,65,10,75,620420
chr1,40574195,0.87,62,9,71,620421
chr1,40574218,1,72,0,72,620422
chr1,40574255,0.9,63,7,70,620423
chr1,40574466,0.86,56,9,65,620424
chr1,40574565,0.88,66,9,75,620425
chr1,40574720,0.78,87,24,111,620426
chr1,40574736,0.95,101,5,106,620427
chr1,40574834,0.95,87,5,92,620428
chr1,40574939,0.89,64,8,72,620429
chr1,40575031,0.7,84,36,120,620430
chr1,40575106,0.98,114,2,116,620431
chr1,40575123,0.96,115,5,120,620432
chr1,40575478,0.97,115,4,119,620433
chr1,40575489,0.87,104,15,119,620434
chr1,40575593,0.93,75,6,81,620435
chr1,40575640,0.91,59,6,65,620436
chr1,40575710,0.72,33,13,46,620437
chr1,40576575,0.83,59,12,71,620438
chr1,40576645,0.73,56,21,77,620439
chr1,40576676,0.74,67,24,91,620440
chr1,40576779,0.95,52,3,55,620441
chr1,40576903,0.79,60,16,76,620442
chr1,40576934,0.87,65,10,75,620443
chr1,40577059,0.98,96,2,98,620444
chr1,40577102,0.87,89,13,102,620445
chr1,40577246,0.92,82,7,89,620446
chr1,40577815,0.78,76,22,98,620447
chr1,40577912,0.56,41,32,73,620448
chr1,40577975,0.64,52,29,81,620449
chr1,40578222,0.96,82,3,85,620450
chr1,40578342,0.77,86,25,111,620451
chr1,40578389,0.5,59,58,117,620452
chr1,40578416,0.9,95,10,105,620453
chr1,40578552,0.92,73,6,79,620454
chr1,40578578,0.93,80,6,86,620455
chr1,40578653,0.32,30,65,95,620456
chr1,40578936,0.8,51,13,64,620457
chr1,40579136,0.62,58,36,94,620458
chr1,40579456,0.79,72,19,91,620459
chr1,40579540,0.32,21,44,65,620460
chr1,40579672,0.74,48,17,65,620461
chr1,40580136,0.89,74,9,83,620462
chr1,40580138,0.9,77,9,86,620463
chr1,40580398,0.78,56,16,72,620464
chr1,40580480,0.94,102,6,108,620465
chr1,40580526,0.78,91,26,117,620466
chr1,40580643,0.74,96,34,130,620467
chr1,40581945,0.89,73,9,82,620468
chr1,40581983,0.7,35,15,50,620469
chr1,40582110,0.79,46,12,58,620470
chr1,40582132,0.98,43,1,44,620471
chr1,40582149,0.95,36,2,38,620472
chr1,40582174,0.77,24,7,31,620473
chr1,40582336,0.86,113,19,132,620474
chr1,40582614,0.62,38,23,61,620475
chr1,40582648,0.62,44,27,71,620476
chr1,40582922,0.9,95,11,106,620477
chr1,40583103,0.88,79,11,90,620478
chr1,40583113,0.79,72,19,91,620479
chr1,40583208,0.87,73,11,84,620480
chr1,40583335,0.98,86,2,88,620481
chr1,40583457,0.88,84,12,96,620482
chr1,40583503,0.9,93,10,103,620483
chr1,40583526,0.85,99,17,116,620484
chr1,40583596,0.75,76,25,101,620485
chr1,40583659,0.91,92,9,101,620486
chr1,40583671,0.88,84,11,95,620487
chr1,40583691,0.88,72,10,82,620488
chr1,40583713,0.9,65,7,72,620489
chr1,40583970,0.23,24,80,104,620490
chr1,40584033,0.64,72,40,112,620491
chr1,40584069,0.91,93,9,102,620492
chr1,40584125,0.7,76,33,109,620493
chr1,40584369,0.63,38,22,60,620494
chr1,40584401,0.74,45,16,61,620495
chr1,40584489,0.73,72,27,99,620496
chr1,40584644,0.88,68,9,77,620497
chr1,40584746,0.67,48,24,72,620498
chr1,40584797,0.35,31,58,89,620499
chr1,40584879,0.66,44,23,67,620500
chr1,40585109,0.63,70,42,112,620501
chr1,40585421,0.3,30,71,101,620502
chr1,40585457,0.24,26,81,107,620503
chr1,40585509,0.67,78,39,117,620504
chr1,40585561,0.75,86,28,114,620505
chr1,40585629,0.81,71,17,88,620506
chr1,40585770,0.86,62,10,72,620507
chr1,40585839,0.92,98,9,107,620508
chr1,40585866,0.72,78,31,109,620509
chr1,40585915,0.76,62,20,82,620510
chr1,40585928,0.88,59,8,67,620511
chr1,40585991,0.6,38,25,63,620512
chr1,40585995,0.89,54,7,61,620513
chr1,40586097,0.77,41,12,53,620514
chr1,40586251,0.85,91,16,107,620515
chr1,40587020,0.76,84,27,111,620516
chr1,40587067,0.68,46,22,68,620517
chr1,40587153,0.92,61,5,66,620518
chr1,40587161,0.94,61,4,65,620519
chr1,40587163,0.92,61,5,66,620520
chr1,40587242,0.97,59,2,61,620521
chr1,40587264,0.91,58,6,64,620522
chr1,40587442,0.78,67,19,86,620523
chr1,40588333,0.72,69,27,96,620524
chr1,40589146,0.77,81,24,105,620525
chr1,40589235,0.95,76,4,80,620526
chr1,40589604,0.77,70,21,91,620527
chr1,40589753,0.51,46,44,90,620528
chr1,40590238,0.71,37,15,52,620529
chr1,40590260,0.96,46,2,48,620530
chr1,40590284,0.93,56,4,60,620531
chr1,40590307,0.96,66,3,69,620532
chr1,40590345,0.79,65,17,82,620533
chr1,40590377,0.89,85,10,95,620534
chr1,40590406,0.77,86,26,112,620535
chr1,40590446,0.96,110,5,115,620536
chr1,40590507,0.91,107,10,117,620537
chr1,40590546,0.94,93,6,99,620538
chr1,40590570,0.84,76,15,91,620539
chr1,40590835,0.92,85,7,92,620540
chr1,40591032,0.79,76,20,96,620541
chr1,40591333,0.68,53,25,78,620542
chr1,40591475,0.86,65,11,76,620543
chr1,40591506,0.85,62,11,73,620544
chr1,40591586,0.92,84,7,91,620545
chr1,40591659,0.6,56,37,93,620546
chr1,40591864,0.78,83,23,106,620547
chr1,40592051,0.91,70,7,77,620548
chr1,40592115,0.95,82,4,86,620549
chr1,40592138,0.93,81,6,87,620550
chr1,40592201,0.87,69,10,79,620551
chr1,40592265,0.71,45,18,63,620552
chr1,40592303,0.8,32,8,40,620553
chr1,40592367,0.75,52,17,69,620554
chr1,40592506,0.93,64,5,69,620555
chr1,40592538,0.9,55,6,61,620556
chr1,40592774,0.89,49,6,55,620557
chr1,40592797,0.89,57,7,64,620558
chr1,40592828,0.87,54,8,62,620559
chr1,40592930,0.93,62,5,67,620560
chr1,40592957,0.86,50,8,58,620561
chr1,40593126,0.85,29,5,34,620562
chr1,40593313,0.92,78,7,85,620563
chr1,40593321,0.95,77,4,81,620564
chr1,40593358,0.94,61,4,65,620565
chr1,40593394,0.91,69,7,76,620566
chr1,40593396,0.92,72,6,78,620567
chr1,40593588,0.93,75,6,81,620568
chr1,40593718,0.95,53,3,56,620569
chr1,40593748,0.95,69,4,73,620570
chr1,40593830,0.91,77,8,85,620571
chr1,40593987,0.81,68,16,84,620572
chr1,40594081,0.3,21,48,69,620573
chr1,40594181,0.95,88,5,93,620574
chr1,40594215,0.82,61,13,74,620575
chr1,40594253,0.85,39,7,46,620576
chr1,40594736,0.94,44,3,47,620577
chr1,40594744,1,51,0,51,620578
chr1,40594750,0.96,52,2,54,620579
chr1,40594752,0.95,53,3,56,620580
chr1,40594766,0.97,56,2,58,620581
chr1,40594814,0.93,81,6,87,620582
chr1,40594846,0.91,78,8,86,620583
chr1,40594879,0.9,77,9,86,620584
chr1,40594892,0.57,43,32,75,620585
chr1,40594942,0.86,68,11,79,620586
chr1,40594970,0.9,76,8,84,620587
chr1,40594980,0.98,91,2,93,620588
chr1,40594982,0.95,91,5,96,620589
chr1,40594986,0.95,93,5,98,620590
chr1,40594999,0.98,105,2,107,620591
chr1,40595053,0.96,97,4,101,620592
chr1,40595178,0.7,63,27,90,620593
chr1,40595294,0.89,79,10,89,620594
chr1,40595336,0.7,66,28,94,620595
chr1,40595522,0.87,48,7,55,620596
chr1,40595601,0.88,65,9,74,620597
chr1,40595642,0.88,45,6,51,620598
chr1,40595997,0.99,75,1,76,620599
chr1,40596108,0.86,69,11,80,620600
chr1,40596837,0.39,40,63,103,620601
chr1,40596860,0.36,33,59,92,620602
chr1,40596964,0.53,35,31,66,620603
chr1,40597032,0.33,23,47,70,620604
chr1,40597205,0.8,43,11,54,620605
chr1,40597210,0.78,52,15,67,620606
chr1,40597218,0.84,56,11,67,620607
chr1,40597240,0.85,66,12,78,620608
chr1,40597242,0.82,69,15,84,620609
chr1,40597265,0.98,97,2,99,620610
chr1,40597272,0.9,96,11,107,620611
chr1,40597284,0.74,75,27,102,620612
chr1,40597329,0.91,72,7,79,620613
chr1,40597333,0.87,74,11,85,620614
chr1,40597341,0.82,70,15,85,620615
chr1,40597345,0.81,66,15,81,620616
chr1,40597374,0.9,56,6,62,620617
chr1,40597385,0.69,47,21,68,620618
chr1,40597405,0.92,46,4,50,620619
chr1,40597419,0.83,43,9,52,620620
chr1,40597426,0.96,48,2,50,620621
chr1,40597435,0.96,46,2,48,620622
chr1,40597463,0.83,35,7,42,620623
chr1,40597473,0.78,25,7,32,620624
chr1,40597475,0.83,25,5,30,620625
chr1,40597477,0.71,17,7,24,620626
chr1,40597480,0.91,21,2,23,620627
chr1,40597511,0.76,28,9,37,620628
chr1,40597539,0.78,42,12,54,620629
chr1,40597547,0.9,56,6,62,620630
chr1,40597554,0.97,59,2,61,620631
chr1,40597569,0.97,66,2,68,620632
chr1,40597586,0.92,71,6,77,620633
chr1,40597600,0.91,75,7,82,620634
chr1,40597640,0.95,79,4,83,620635
chr1,40597684,0.33,25,50,75,620636
chr1,40597725,0.95,60,3,63,620637
chr1,40597729,0.87,58,9,67,620638
chr1,40597761,0.97,58,2,60,620639
chr1,40597771,0.85,52,9,61,620640
chr1,40597773,0.89,51,6,57,620641
chr1,40597781,0.9,60,7,67,620642
chr1,40597848,0.63,49,29,78,620643
chr1,40597925,0.78,103,29,132,620644
chr1,40598339,0.66,69,36,105,620645
chr1,40598354,0.6,58,39,97,620646
chr1,40598377,0.57,51,38,89,620647
chr1,40598381,0.26,25,72,97,620648
chr1,40598384,0.57,53,40,93,620649
chr1,40598394,0.37,30,51,81,620650
chr1,40598417,0.24,17,55,72,620651
chr1,40598431,0.08,4,48,52,620652
chr1,40598455,0.08,3,37,40,620653
chr1,40598509,0.16,5,27,32,620654
chr1,40598515,0.1,6,53,59,620655
chr1,40598521,0.18,9,41,50,620656
chr1,40598528,0.16,9,46,55,620657
chr1,40598538,0.21,11,42,53,620658
chr1,40598563,0.09,5,51,56,620659
chr1,40598567,0.11,7,54,61,620660
chr1,40598597,0.05,3,60,63,620661
chr1,40598613,0.04,3,69,72,620662
chr1,40598618,0.04,3,67,70,620663
chr1,40598626,0.04,3,65,68,620664
chr1,40598648,0.1,6,55,61,620665
chr1,40598650,0.13,7,47,54,620666
chr1,40598664,0.13,8,56,64,620667
chr1,40598668,0.12,5,36,41,620668
chr1,40598687,0.07,5,69,74,620669
chr1,40598695,0.14,9,56,65,620670
chr1,40598704,0.08,6,66,72,620671
chr1,40598718,0.08,6,71,77,620672
chr1,40598747,0.1,8,76,84,620673
chr1,40598772,0.03,3,84,87,620674
chr1,40598779,0.04,4,86,90,620675
chr1,40598797,0.07,7,90,97,620676
chr1,40598839,0.14,13,81,94,620677
chr1,40598844,0.1,10,91,101,620678
chr1,40598853,0.13,12,83,95,620679
chr1,40598856,0.12,12,85,97,620680
chr1,40598871,0.13,15,99,114,620681
chr1,40598889,0.12,12,88,100,620682
chr1,40598905,0.19,14,61,75,620683
chr1,40598935,0.24,24,77,101,620684
chr1,40598938,0.14,15,94,109,620685
chr1,40598953,0.28,22,57,79,620686
chr1,40598956,0.12,11,81,92,620687
chr1,40598989,0.13,11,75,86,620688
chr1,40599001,0.42,31,43,74,620689
chr1,40599011,0.4,37,56,93,620690
chr1,40599067,0.53,47,41,88,620691
chr1,40599090,0.38,36,58,94,620692
chr1,40599093,0.46,45,52,97,620693
chr1,40599112,0.81,70,16,86,620694
chr1,40599125,0.73,68,25,93,620695
chr1,40599129,0.65,58,31,89,620696
chr1,40599134,0.74,64,23,87,620697
chr1,40599161,0.78,62,18,80,620698
chr1,40599166,0.78,80,22,102,620699
chr1,40599169,0.62,54,33,87,620700
chr1,40599176,0.67,64,31,95,620701
chr1,40599186,0.72,51,20,71,620702
chr1,40599190,0.4,32,49,81,620703
chr1,40599199,0.53,41,36,77,620704
chr1,40599208,0.58,46,34,80,620705
chr1,40599245,0.11,5,42,47,620706
chr1,40599282,0.8,32,8,40,620707
chr1,40599290,0.97,38,1,39,620708
chr1,40599353,1,88,0,88,620709
chr1,40599376,0.77,69,21,90,620710
chr1,40599381,0.69,59,26,85,620711
chr1,40599417,0.73,45,17,62,620712
chr1,40599487,0.92,68,6,74,620713
chr1,40599497,0.97,76,2,78,620714
chr1,40599518,0.45,39,48,87,620715
chr1,40599718,0.64,54,31,85,620716
chr1,40599918,0.76,67,21,88,620717
chr1,40600001,0.89,81,10,91,620718
chr1,40600243,0.76,35,11,46,620719
chr1,40600280,0.88,30,4,34,620720
chr1,40600287,0.82,28,6,34,620721
chr1,40600321,0.79,26,7,33,620722
chr1,40600376,0.93,39,3,42,620723
chr1,40600418,0.83,30,6,36,620724
chr1,40600725,0.89,109,14,123,620725
chr1,40600782,0.92,114,10,124,620726
chr1,40600860,0.86,99,16,115,620727
chr1,40600965,0.96,82,3,85,620728
chr1,40601041,0.91,41,4,45,620729
chr1,40601085,1,38,0,38,620730
chr1,40601116,0.9,36,4,40,620731
chr1,40601140,0.98,43,1,44,620732
chr1,40601145,0.93,41,3,44,620733
chr1,40601160,0.93,53,4,57,620734
chr1,40601173,0.94,61,4,65,620735
chr1,40601189,0.79,53,14,67,620736
chr1,40601254,0.81,92,21,113,620737
chr1,40601317,0.92,114,10,124,620738
chr1,40601357,0.68,77,36,113,620739
chr1,40601427,0.91,71,7,78,620740
chr1,40601680,0.62,68,42,110,620741
chr1,40602163,0.5,39,39,78,620742
chr1,40602166,0.27,21,56,77,620743
chr1,40602251,0.06,5,78,83,620744
chr1,40602798,0.9,92,10,102,620745
chr1,40602872,0.91,127,12,139,620746
chr1,40602884,0.93,143,10,153,620747
chr1,40602897,0.73,110,40,150,620748
chr1,40602985,0.97,64,2,66,620749
chr1,40602997,0.96,51,2,53,620750
chr1,40603025,0.93,43,3,46,620751
chr1,40603030,0.98,42,1,43,620752
chr1,40603034,0.97,31,1,32,620753
chr1,40603132,0.94,60,4,64,620754
chr1,40603174,0.93,62,5,67,620755
chr1,40603191,0.98,56,1,57,620756
chr1,40603214,0.94,64,4,68,620757
chr1,40603234,0.43,30,39,69,620758
chr1,40603444,0.73,46,17,63,620759
chr1,40603502,0.91,61,6,67,620760
chr1,40603575,0.82,73,16,89,620761
chr1,40603700,0.84,37,7,44,620762
chr1,40603703,0.95,39,2,41,620763
chr1,40603829,0.91,108,11,119,620764
chr1,40603844,0.89,111,14,125,620765
chr1,40603861,0.92,121,10,131,620766
chr1,40603983,0.98,57,1,58,620767
chr1,40603985,1,54,0,54,620768
chr1,40604007,0.93,39,3,42,620769
chr1,40604028,0.94,33,2,35,620770
chr1,40604118,0.89,40,5,45,620771
chr1,40604126,0.96,44,2,46,620772
chr1,40604150,1,54,0,54,620773
chr1,40604182,0.95,53,3,56,620774
chr1,40604189,1,55,0,55,620775
chr1,40604214,0.8,41,10,51,620776
chr1,40604627,0.97,102,3,105,620777
chr1,40604857,0.73,53,20,73,620778
chr1,40605243,0.92,23,2,25,620779
chr1,40605316,0.91,64,6,70,620780
chr1,40605341,1,87,0,87,620781
chr1,40605390,0.94,89,6,95,620782
chr1,40605404,0.96,89,4,93,620783
chr1,40605778,0.87,96,14,110,620784
chr1,40605867,0.65,70,38,108,620785
chr1,40605901,0.45,40,49,89,620786
chr1,40605985,0.89,55,7,62,620787
chr1,40606340,0.7,46,20,66,620788
chr1,40606425,0.66,52,27,79,620789
chr1,40606441,0.73,53,20,73,620790
chr1,40606510,0.86,59,10,69,620791
chr1,40606557,0.71,51,21,72,620792
chr1,40607099,0.81,88,20,108,620793
chr1,40607108,0.84,97,19,116,620794
chr1,40607345,0.94,62,4,66,620795
chr1,40607357,0.85,50,9,59,620796
chr1,40607417,0.88,50,7,57,620797
chr1,40607480,0.82,49,11,60,620798
chr1,40607512,0.73,41,15,56,620799
chr1,40607545,0.72,31,12,43,620800
chr1,40607607,0.91,10,1,11,620801
chr1,40607785,0.52,54,50,104,620802
chr1,40608536,0.86,64,10,74,620803
chr1,40608631,0.92,68,6,74,620804
chr1,40608635,0.97,64,2,66,620805
chr1,40608637,0.94,60,4,64,620806
chr1,40608675,0.85,41,7,48,620807
chr1,40608691,0.85,47,8,55,620808
chr1,40608736,0.87,59,9,68,620809
chr1,40608764,0.81,69,16,85,620810
chr1,40608800,0.78,67,19,86,620811
chr1,40608845,0.85,40,7,47,620812
chr1,40608875,0.77,20,6,26,620813
chr1,40608883,0.95,18,1,19,620814
chr1,40609095,0.54,60,51,111,620815
chr1,40609453,0.69,68,30,98,620816
chr1,40609565,0.1,11,94,105,620817
chr1,40609782,0.02,1,61,62,620818
chr1,40609905,0.03,3,103,106,620819
chr1,40609907,0,0,101,101,620820
chr1,40609909,0.02,2,104,106,620821
chr1,40609963,0,0,112,112,620822
chr1,40610246,0.87,69,10,79,620823
chr1,40610691,0.46,51,61,112,620824
chr1,40610888,0.58,60,44,104,620825
chr1,40610958,0.8,69,17,86,620826
chr1,40611047,0.69,41,18,59,620827
chr1,40611058,0.84,48,9,57,620828
chr1,40611605,0.41,23,33,56,620829
chr1,40611693,0.77,46,14,60,620830
chr1,40611921,0.55,61,50,111,620831
chr1,40612060,0.91,73,7,80,620832
chr1,40612186,0.71,77,32,109,620833
chr1,40612198,0.8,90,23,113,620834
chr1,40612349,0.57,55,42,97,620835
chr1,40612400,0.66,52,27,79,620836
chr1,40613111,0.53,49,43,92,620837
chr1,40613113,0.71,66,27,93,620838
chr1,40613266,0.53,28,25,53,620839
chr1,40613316,0.52,33,30,63,620840
chr1,40613369,0.52,42,39,81,620841
chr1,40613463,0.54,49,41,90,620842
chr1,40613715,0.86,96,15,111,620843
chr1,40613877,0.65,53,29,82,620844
chr1,40613947,0.87,101,15,116,620845
chr1,40613980,0.81,101,23,124,620846
chr1,40614306,0.89,73,9,82,620847
chr1,40614338,0.98,89,2,91,620848
chr1,40614348,0.95,86,5,91,620849
chr1,40614441,0.95,88,5,93,620850
chr1,40614473,0.87,95,14,109,620851
chr1,40614486,0.93,100,8,108,620852
chr1,40614490,1,103,0,103,620853
chr1,40614497,0.88,89,12,101,620854
chr1,40614645,1,42,0,42,620855
chr1,40614662,0.81,30,7,37,620856
chr1,40614699,0.76,26,8,34,620857
chr1,40614888,0.83,100,21,121,620858
chr1,40615167,0.79,46,12,58,620859
chr1,40615279,0.85,53,9,62,620860
chr1,40615311,0.95,59,3,62,620861
chr1,40615333,0.97,62,2,64,620862
chr1,40615343,0.97,62,2,64,620863
chr1,40615397,0.81,25,6,31,620864
chr1,40615731,0.88,53,7,60,620865
chr1,40615923,0.95,39,2,41,620866
chr1,40615925,0.98,40,1,41,620867
chr1,40615931,0.84,36,7,43,620868
chr1,40615948,1,45,0,45,620869
chr1,40615955,0.93,43,3,46,620870
chr1,40615986,0.89,51,6,57,620871
chr1,40616090,0.93,53,4,57,620872
chr1,40616106,0.98,52,1,53,620873
chr1,40616110,0.97,68,2,70,620874
chr1,40616115,0.9,62,7,69,620875
chr1,40616155,0.95,89,5,94,620876
chr1,40616163,0.89,87,11,98,620877
chr1,40616266,0.87,75,11,86,620878
chr1,40616484,0.93,65,5,70,620879
chr1,40616631,0.92,72,6,78,620880
chr1,40616634,0.89,70,9,79,620881
chr1,40616690,1,76,0,76,620882
chr1,40616707,0.87,60,9,69,620883
chr1,40616781,0.65,24,13,37,620884
chr1,40616826,0.97,58,2,60,620885
chr1,40616955,0.94,59,4,63,620886
chr1,40616958,0.92,59,5,64,620887
chr1,40617061,0.87,77,12,89,620888
chr1,40617078,0.77,75,23,98,620889
chr1,40617149,0.97,88,3,91,620890
chr1,40617188,0.93,50,4,54,620891
chr1,40617329,0.89,75,9,84,620892
chr1,40617407,0.87,90,13,103,620893
chr1,40617556,0.95,84,4,88,620894
chr1,40617660,0.88,59,8,67,620895
chr1,40617943,0.93,100,8,108,620896
chr1,40617947,0.99,102,1,103,620897
chr1,40617949,0.82,86,19,105,620898
chr1,40617985,0.54,64,55,119,620899
chr1,40618062,1,87,0,87,620900
chr1,40618620,0.26,25,73,98,620901
chr1,40618846,0,0,71,71,620902
chr1,40618861,0,0,64,64,620903
chr1,40619459,0.91,74,7,81,620904
chr1,40619547,0.45,34,41,75,620905
chr1,40619579,0.72,47,18,65,620906
chr1,40619610,0.92,49,4,53,620907
chr1,40619642,0.86,59,10,69,620908
chr1,40619686,0.42,44,61,105,620909
chr1,40619986,0.82,89,20,109,620910
chr1,40620046,0.59,70,48,118,620911
chr1,40620355,0.88,45,6,51,620912
chr1,40620360,0.96,51,2,53,620913
chr1,40620374,0.98,57,1,58,620914
chr1,40620944,0.92,86,7,93,620915
chr1,40621098,0.8,70,17,87,620916
chr1,40621111,0.89,78,10,88,620917
chr1,40621319,0.88,74,10,84,620918
chr1,40621536,0.06,7,104,111,620919
chr1,40621676,0.25,31,93,124,620920
chr1,40621789,0.32,40,84,124,620921
chr1,40621848,0.79,86,23,109,620922
chr1,40621986,0.3,14,32,46,620923
chr1,40622133,0.32,34,73,107,620924
chr1,40622635,0.96,64,3,67,620925
chr1,40623285,0.6,65,43,108,620926
chr1,40623614,0.79,45,12,57,620927
chr1,40623636,0.94,59,4,63,620928
chr1,40623644,0.88,50,7,57,620929
chr1,40623673,0.78,42,12,54,620930
chr1,40623717,0.96,26,1,27,620931
chr1,40623721,0.9,26,3,29,620932
chr1,40623729,0.9,26,3,29,620933
chr1,40623733,0.88,28,4,32,620934
chr1,40623764,0.84,16,3,19,620935
chr1,40623775,0.81,17,4,21,620936
chr1,40623795,0.86,24,4,28,620937
chr1,40623809,0.82,28,6,34,620938
chr1,40623825,0.9,36,4,40,620939
chr1,40623863,0.81,43,10,53,620940
chr1,40624272,0.68,84,40,124,620941
chr1,40624288,0.88,101,14,115,620942
chr1,40624557,0.6,62,42,104,620943
chr1,40624660,0.8,72,18,90,620944
chr1,40624702,0.91,81,8,89,620945
chr1,40625105,0.91,81,8,89,620946
chr1,40625147,0.96,121,5,126,620947
chr1,40625159,0.84,112,21,133,620948
chr1,40625225,0.91,119,12,131,620949
chr1,40625251,0.91,110,11,121,620950
chr1,40625296,0.64,75,43,118,620951
chr1,40625342,0.89,84,10,94,620952
chr1,40625387,0.89,41,5,46,620953
chr1,40625425,0.9,43,5,48,620954
chr1,40625427,1,49,0,49,620955
chr1,40625433,0.85,35,6,41,620956
chr1,40625465,1,28,0,28,620957
chr1,40625489,0.81,21,5,26,620958
chr1,40625513,0.81,13,3,16,620959
chr1,40625521,0.85,11,2,13,620960
chr1,40625525,1,8,0,8,620961
chr1,40625565,0.75,6,2,8,620962
chr1,40625599,1,23,0,23,620963
chr1,40625610,0.9,28,3,31,620964
chr1,40625615,1,32,0,32,620965
chr1,40625643,0.9,45,5,50,620966
chr1,40625655,0.94,51,3,54,620967
chr1,40625664,0.92,55,5,60,620968
chr1,40625709,1,71,0,71,620969
chr1,40625711,0.96,64,3,67,620970
chr1,40625721,0.94,59,4,63,620971
chr1,40625754,0.98,45,1,46,620972
chr1,40625758,0.94,33,2,35,620973
chr1,40625781,0.92,24,2,26,620974
chr1,40625812,0.87,33,5,38,620975
chr1,40625852,0.92,72,6,78,620976
chr1,40625856,0.92,77,7,84,620977
chr1,40625892,0.97,89,3,92,620978
chr1,40625939,0.95,80,4,84,620979
chr1,40626075,0.98,53,1,54,620980
chr1,40626137,0.96,64,3,67,620981
chr1,40626161,0.98,65,1,66,620982
chr1,40626165,0.98,65,1,66,620983
chr1,40626167,1,67,0,67,620984
chr1,40626177,0.98,59,1,60,620985
chr1,40626210,0.9,35,4,39,620986
chr1,40626214,1,26,0,26,620987
chr1,40626237,0.94,32,2,34,620988
chr1,40626307,0.99,80,1,81,620989
chr1,40626332,0.94,85,5,90,620990
chr1,40626369,0.99,74,1,75,620991
chr1,40626378,0.99,70,1,71,620992
chr1,40626433,0.75,27,9,36,620993
chr1,40626527,0.61,53,34,87,620994
chr1,40626599,0.56,42,33,75,620995
chr1,40626626,0.59,42,29,71,620996
chr1,40626646,0.06,5,83,88,620997
chr1,40626690,0.06,6,94,100,620998
chr1,40626736,0.47,43,48,91,620999
chr1,40626780,0.02,2,99,101,621000
chr1,40626837,0,0,119,119,621001
chr1,40626914,0,0,104,104,621002
chr1,40626919,0.01,1,115,116,621003
chr1,40626939,0,0,107,107,621004
chr1,40626946,0.01,1,105,106,621005
chr1,40626953,0.02,2,96,98,621006
chr1,40626963,0,0,79,79,621007
chr1,40626967,0,0,53,53,621008
chr1,40626971,0,0,87,87,621009
chr1,40626973,0,0,88,88,621010
chr1,40626976,0,0,86,86,621011
chr1,40626988,0,0,76,76,621012
chr1,40626998,0,0,71,71,621013
chr1,40627000,0,0,70,70,621014
chr1,40627004,0,0,46,46,621015
chr1,40627008,0,0,66,66,621016
chr1,40627033,0,0,59,59,621017
chr1,40627050,0,0,50,50,621018
chr1,40627052,0,0,49,49,621019
chr1,40627063,0,0,40,40,621020
chr1,40627076,0,0,33,33,621021
chr1,40627080,0,0,46,46,621022
chr1,40627092,0,0,42,42,621023
chr1,40627095,0.04,2,44,46,621024
chr1,40627098,0,0,47,47,621025
chr1,40627104,0,0,44,44,621026
chr1,40627107,0,0,48,48,621027
chr1,40627127,0,0,55,55,621028
chr1,40627130,0,0,40,40,621029
chr1,40627136,0,0,48,48,621030
chr1,40627143,0.02,1,54,55,621031
chr1,40627155,0.02,1,58,59,621032
chr1,40627174,0.01,1,70,71,621033
chr1,40627183,0,0,59,59,621034
chr1,40627188,0,0,69,69,621035
chr1,40627199,0,0,58,58,621036
chr1,40627202,0.01,1,74,75,621037
chr1,40627211,0,0,72,72,621038
chr1,40627219,0.03,2,65,67,621039
chr1,40627223,0.03,2,66,68,621040
chr1,40627268,0,0,54,54,621041
chr1,40627294,0,0,48,48,621042
chr1,40627336,0,0,14,14,621043
chr1,40627339,0.06,1,16,17,621044
chr1,40627344,0,0,16,16,621045
chr1,40627387,0,0,32,32,621046
chr1,40627405,0,0,18,18,621047
chr1,40627414,0,0,39,39,621048
chr1,40627421,0,0,32,32,621049
chr1,40627424,0,0,33,33,621050
chr1,40627426,0,0,26,26,621051
chr1,40627432,0,0,44,44,621052
chr1,40627437,0,0,46,46,621053
chr1,40627452,0,0,48,48,621054
chr1,40627460,0.02,1,44,45,621055
chr1,40627464,0,0,45,45,621056
chr1,40627478,0,0,50,50,621057
chr1,40627488,0.03,2,59,61,621058
chr1,40627501,0,0,57,57,621059
chr1,40627509,0,0,62,62,621060
chr1,40627537,0,0,77,77,621061
chr1,40627550,0,0,64,64,621062
chr1,40627577,0.03,2,71,73,621063
chr1,40627580,0,0,88,88,621064
chr1,40627598,0,0,93,93,621065
chr1,40627611,0,0,67,67,621066
chr1,40627649,0,0,101,101,621067
chr1,40627683,0,0,103,103,621068
chr1,40627697,0,0,91,91,621069
chr1,40627795,0,0,96,96,621070
chr1,40627802,0,0,67,67,621071
chr1,40627829,0.01,1,82,83,621072
chr1,40627835,0,0,79,79,621073
chr1,40627880,0,0,64,64,621074
chr1,40627888,0,0,65,65,621075
chr1,40627924,0,0,65,65,621076
chr1,40627996,0.01,1,67,68,621077
chr1,40628081,0,0,70,70,621078
chr1,40628223,0.02,2,110,112,621079
chr1,40628278,0.13,11,75,86,621080
chr1,40628281,0.03,2,78,80,621081
chr1,40628325,0.08,5,61,66,621082
chr1,40628377,0,0,42,42,621083
chr1,40628432,0.01,1,66,67,621084
chr1,40628500,0.01,1,85,86,621085
chr1,40628695,0.1,10,94,104,621086
chr1,40628903,0.05,5,102,107,621087
chr1,40629775,0.88,78,11,89,621088
chr1,40630500,0.18,19,88,107,621089
chr1,40630543,0.24,28,90,118,621090
chr1,40630702,0.5,51,52,103,621091
chr1,40631077,0.76,71,22,93,621092
chr1,40631088,0.91,81,8,89,621093
chr1,40631094,0.94,81,5,86,621094
chr1,40631107,0.79,68,18,86,621095
chr1,40631421,0.77,51,15,66,621096
chr1,40631464,0.92,58,5,63,621097
chr1,40631618,0.93,109,8,117,621098
chr1,40631759,0.28,33,84,117,621099
chr1,40632074,0.96,68,3,71,621100
chr1,40632110,1,62,0,62,621101
chr1,40632226,0.69,71,32,103,621102
chr1,40632337,0.97,36,1,37,621103
chr1,40632442,0.96,23,1,24,621104
chr1,40632446,0.92,23,2,25,621105
chr1,40632490,1,48,0,48,621106
chr1,40632514,0.9,47,5,52,621107
chr1,40632545,0.96,43,2,45,621108
chr1,40632581,0.48,29,31,60,621109
chr1,40632789,0.86,68,11,79,621110
chr1,40632998,0.98,81,2,83,621111
chr1,40633015,0.99,74,1,75,621112
chr1,40633107,0.84,80,15,95,621113
chr1,40633264,0.14,13,77,90,621114
chr1,40633414,0.83,85,17,102,621115
chr1,40633663,0.49,36,38,74,621116
chr1,40633807,1,82,0,82,621117
chr1,40633841,0.9,65,7,72,621118
chr1,40634003,0.96,80,3,83,621119
chr1,40634020,0.96,85,4,89,621120
chr1,40634027,0.97,86,3,89,621121
chr1,40634074,0.95,79,4,83,621122
chr1,40634114,0.94,60,4,64,621123
chr1,40634137,0.85,51,9,60,621124
chr1,40634194,0.98,41,1,42,621125
chr1,40634210,0.89,31,4,35,621126
chr1,40634386,0.9,64,7,71,621127
chr1,40634392,0.86,62,10,72,621128
chr1,40634434,1,59,0,59,621129
chr1,40634461,0.98,47,1,48,621130
chr1,40634660,0.53,41,37,78,621131
chr1,40634863,0.72,60,23,83,621132
chr1,40634976,0.88,59,8,67,621133
chr1,40635006,0.96,53,2,55,621134
chr1,40635010,0.98,50,1,51,621135
chr1,40635014,1,50,0,50,621136
chr1,40635016,1,48,0,48,621137
chr1,40635026,1,45,0,45,621138
chr1,40635054,0.91,20,2,22,621139
chr1,40635059,1,17,0,17,621140
chr1,40635084,1,4,0,4,621141
chr1,40635180,0.8,4,1,5,621142
chr1,40635204,0.8,4,1,5,621143
chr1,40635212,1,5,0,5,621144
chr1,40635219,1,5,0,5,621145
chr1,40635236,1,5,0,5,621146
chr1,40635244,1,6,0,6,621147
chr1,40635257,1,7,0,7,621148
chr1,40635273,1,2,0,2,621149
chr1,40635281,1,2,0,2,621150
chr1,40635289,0.5,1,1,2,621151
chr1,40635394,0.93,27,2,29,621152
chr1,40635425,0.76,19,6,25,621153
chr1,40635433,0.96,25,1,26,621154
chr1,40635450,0.89,31,4,35,621155
chr1,40635457,0.92,36,3,39,621156
chr1,40635525,0.93,55,4,59,621157
chr1,40635641,0.93,65,5,70,621158
chr1,40635655,0.88,73,10,83,621159
chr1,40635691,0.55,48,40,88,621160
chr1,40635718,0.81,73,17,90,621161
chr1,40635964,0.96,67,3,70,621162
chr1,40635980,0.99,69,1,70,621163
chr1,40636079,1,69,0,69,621164
chr1,40636081,0.99,71,1,72,621165
chr1,40636091,0.97,71,2,73,621166
chr1,40636129,0.96,82,3,85,621167
chr1,40636134,0.65,60,32,92,621168
chr1,40636215,0.87,83,12,95,621169
chr1,40636275,0.93,98,7,105,621170
chr1,40636478,0.72,84,33,117,621171
chr1,40636539,0.92,109,9,118,621172
chr1,40636568,0.64,113,63,176,621173
chr1,40636727,0.57,44,33,77,621174
chr1,40636980,0.95,76,4,80,621175
chr1,40637048,0.68,75,36,111,621176
chr1,40637706,0.89,85,11,96,621177
chr1,40638178,0.91,64,6,70,621178
chr1,40638184,0.92,58,5,63,621179
chr1,40638187,0.95,56,3,59,621180
chr1,40638227,0.97,36,1,37,621181
chr1,40638254,0.93,37,3,40,621182
chr1,40638394,0.77,70,21,91,621183
chr1,40638517,0.96,86,4,90,621184
chr1,40638609,0.93,71,5,76,621185
chr1,40638632,0.54,36,31,67,621186
chr1,40638811,0.91,62,6,68,621187
chr1,40638817,0.94,66,4,70,621188
chr1,40638825,0.97,76,2,78,621189
chr1,40638841,0.97,86,3,89,621190
chr1,40638851,0.94,79,5,84,621191
chr1,40638897,0.97,65,2,67,621192
chr1,40638905,0.94,68,4,72,621193
chr1,40638994,0.99,76,1,77,621194
chr1,40639039,0.97,64,2,66,621195
chr1,40639375,0.6,58,39,97,621196
chr1,40639429,1,110,0,110,621197
chr1,40639446,0.91,107,11,118,621198
chr1,40639466,0.86,91,15,106,621199
chr1,40639476,0.88,93,13,106,621200
chr1,40639534,0.97,77,2,79,621201
chr1,40639766,0.9,66,7,73,621202
chr1,40639772,0.92,61,5,66,621203
chr1,40639782,0.92,56,5,61,621204
chr1,40639815,1,38,0,38,621205
chr1,40639903,0.99,73,1,74,621206
chr1,40639915,0.98,80,2,82,621207
chr1,40639935,0.84,82,16,98,621208
chr1,40639957,0.89,83,10,93,621209
chr1,40640491,0.69,77,35,112,621210
chr1,40640642,0.97,115,3,118,621211
chr1,40640688,0.85,94,17,111,621212
chr1,40640905,0.15,8,44,52,621213
chr1,40640977,0.89,62,8,70,621214
chr1,40641050,0.88,52,7,59,621215
chr1,40641097,0.99,71,1,72,621216
chr1,40641118,0.95,70,4,74,621217
chr1,40641181,0.96,69,3,72,621218
chr1,40641205,0.95,53,3,56,621219
chr1,40641245,0.97,36,1,37,621220
chr1,40641252,1,40,0,40,621221
chr1,40641275,0.98,47,1,48,621222
chr1,40641299,0.94,44,3,47,621223
chr1,40641315,0.98,56,1,57,621224
chr1,40641350,1,67,0,67,621225
chr1,40641382,0.98,58,1,59,621226
chr1,40641997,0.97,62,2,64,621227
chr1,40642225,0.97,85,3,88,621228
chr1,40642303,0.94,61,4,65,621229
chr1,40642352,0.86,59,10,69,621230
chr1,40642361,1,78,0,78,621231
chr1,40642394,0.97,93,3,96,621232
chr1,40642476,0.98,92,2,94,621233
chr1,40642683,1,58,0,58,621234
chr1,40642698,0.87,54,8,62,621235
chr1,40642720,1,67,0,67,621236
chr1,40642722,0.96,64,3,67,621237
chr1,40642745,0.97,75,2,77,621238
chr1,40642762,0.99,82,1,83,621239
chr1,40642802,1,82,0,82,621240
chr1,40642818,0.96,74,3,77,621241
chr1,40642854,0.98,61,1,62,621242
chr1,40642885,0.9,47,5,52,621243
chr1,40642904,0.96,47,2,49,621244
chr1,40642937,0.41,16,23,39,621245
chr1,40642984,0.94,44,3,47,621246
chr1,40643047,0.95,74,4,78,621247
chr1,40643054,1,78,0,78,621248
chr1,40643106,0.98,44,1,45,621249
chr1,40643110,1,51,0,51,621250
chr1,40643118,0.98,54,1,55,621251
chr1,40643155,0.96,53,2,55,621252
chr1,40643200,0.99,66,1,67,621253
chr1,40643211,0.95,63,3,66,621254
chr1,40643244,0.96,69,3,72,621255
chr1,40643259,0.94,60,4,64,621256
chr1,40643283,0.96,70,3,73,621257
chr1,40643345,0.94,80,5,85,621258
chr1,40643443,0.88,82,11,93,621259
chr1,40643514,0.7,64,28,92,621260
chr1,40643646,0.85,74,13,87,621261
chr1,40643649,0.98,78,2,80,621262
chr1,40644147,0.29,22,53,75,621263
chr1,40644151,0.76,60,19,79,621264
chr1,40644442,0.98,59,1,60,621265
chr1,40644493,0.96,66,3,69,621266
chr1,40644537,1,80,0,80,621267
chr1,40644569,0.99,81,1,82,621268
chr1,40644599,0.98,92,2,94,621269
chr1,40644663,1,90,0,90,621270
chr1,40644667,0.99,86,1,87,621271
chr1,40644703,0.98,78,2,80,621272
chr1,40644706,0.94,78,5,83,621273
chr1,40644790,0.99,70,1,71,621274
chr1,40645084,1,85,0,85,621275
chr1,40645138,0.99,71,1,72,621276
chr1,40645141,0.89,59,7,66,621277
chr1,40645258,0.97,57,2,59,621278
chr1,40645719,0.99,71,1,72,621279
chr1,40645721,0.97,70,2,72,621280
chr1,40646075,1,77,0,77,621281
chr1,40646079,0.98,82,2,84,621282
chr1,40646087,0.95,84,4,88,621283
chr1,40646153,0.95,83,4,87,621284
chr1,40646196,0.68,62,29,91,621285
chr1,40646270,0.96,82,3,85,621286
chr1,40646276,0.93,86,6,92,621287
chr1,40646922,0.98,45,1,46,621288
chr1,40647002,0.95,77,4,81,621289
chr1,40647016,0.98,78,2,80,621290
chr1,40647050,0.97,60,2,62,621291
chr1,40647064,1,55,0,55,621292
chr1,40647088,0.93,40,3,43,621293
chr1,40647479,0.68,72,34,106,621294
chr1,40647767,0.65,58,31,89,621295
chr1,40647795,0.83,74,15,89,621296
chr1,40647824,0.96,79,3,82,621297
chr1,40647828,0.89,73,9,82,621298
chr1,40647871,0.93,77,6,83,621299
chr1,40647887,0.99,76,1,77,621300
chr1,40647901,0.98,80,2,82,621301
chr1,40647933,0.74,56,20,76,621302
chr1,40647974,0.93,71,5,76,621303
chr1,40647978,0.99,67,1,68,621304
chr1,40648053,1,62,0,62,621305
chr1,40648062,0.98,58,1,59,621306
chr1,40648099,0.94,50,3,53,621307
chr1,40648329,0.7,96,42,138,621308
chr1,40648821,0.21,25,94,119,621309
chr1,40649174,0.48,45,49,94,621310
chr1,40649302,0.31,22,49,71,621311
chr1,40649526,0.75,76,25,101,621312
chr1,40649949,0.73,66,25,91,621313
chr1,40650346,0.9,61,7,68,621314
chr1,40650365,0.98,65,1,66,621315
chr1,40650624,1,58,0,58,621316
chr1,40650895,0.97,62,2,64,621317
chr1,40650951,1,64,0,64,621318
chr1,40650959,0.97,58,2,60,621319
chr1,40650963,0.95,56,3,59,621320
chr1,40651053,0.97,67,2,69,621321
chr1,40651081,0.98,64,1,65,621322
chr1,40651218,0.86,6,1,7,621323
chr1,40651222,0.91,10,1,11,621324
chr1,40651250,0.94,17,1,18,621325
chr1,40651255,0.94,17,1,18,621326
chr1,40651266,0.94,17,1,18,621327
chr1,40651280,1,15,0,15,621328
chr1,40651300,1,11,0,11,621329
chr1,40651311,1,8,0,8,621330
chr1,40651416,0.89,16,2,18,621331
chr1,40651454,0.93,26,2,28,621332
chr1,40651554,0.97,29,1,30,621333
chr1,40651603,0.96,52,2,54,621334
chr1,40651626,0.96,65,3,68,621335
chr1,40651685,0.92,90,8,98,621336
chr1,40651697,0.97,91,3,94,621337
chr1,40651778,0.85,68,12,80,621338
chr1,40651792,0.93,64,5,69,621339
chr1,40652215,0.91,70,7,77,621340
chr1,40652385,0.98,91,2,93,621341
chr1,40652743,0.96,48,2,50,621342
chr1,40652764,0.96,44,2,46,621343
chr1,40652789,1,56,0,56,621344
chr1,40652806,0.9,57,6,63,621345
chr1,40652848,0.97,67,2,69,621346
chr1,40652850,0.99,70,1,71,621347
chr1,40652852,0.99,70,1,71,621348
chr1,40652860,1,76,0,76,621349
chr1,40652891,0.9,71,8,79,621350
chr1,40652923,0.95,76,4,80,621351
chr1,40652944,0.95,70,4,74,621352
chr1,40652948,0.95,81,4,85,621353
chr1,40652953,0.94,79,5,84,621354
chr1,40652981,0.99,81,1,82,621355
chr1,40653244,0.19,22,92,114,621356
chr1,40653499,0.99,107,1,108,621357
chr1,40653764,0.27,22,59,81,621358
chr1,40654793,0.98,86,2,88,621359
chr1,40654823,0.97,87,3,90,621360
chr1,40654928,0.91,67,7,74,621361
chr1,40655025,0.88,91,12,103,621362
chr1,40655325,0.97,71,2,73,621363
chr1,40655327,0.99,76,1,77,621364
chr1,40655339,1,72,0,72,621365
chr1,40655343,0.97,72,2,74,621366
chr1,40655381,0.98,83,2,85,621367
chr1,40655388,0.96,81,3,84,621368
chr1,40655430,1,67,0,67,621369
chr1,40655492,0.88,45,6,51,621370
chr1,40655996,0.64,55,31,86,621371
chr1,40656453,0.96,81,3,84,621372
chr1,40656947,0.98,86,2,88,621373
chr1,40657007,0.96,89,4,93,621374
chr1,40657030,0.98,86,2,88,621375
chr1,40657066,0.97,96,3,99,621376
chr1,40657078,1,99,0,99,621377
chr1,40657124,0.98,102,2,104,621378
chr1,40657164,0.97,67,2,69,621379
chr1,40657209,0.94,29,2,31,621380
chr1,40657245,0.96,45,2,47,621381
chr1,40657321,0.99,78,1,79,621382
chr1,40657398,0.97,105,3,108,621383
chr1,40657845,0.7,64,28,92,621384
chr1,40657873,0.94,93,6,99,621385
chr1,40657919,0.64,61,35,96,621386
chr1,40658085,0.92,108,9,117,621387
chr1,40658118,0.94,94,6,100,621388
chr1,40658782,0.92,60,5,65,621389
chr1,40659254,0.64,39,22,61,621390
chr1,40659256,0.74,46,16,62,621391
chr1,40659593,0.78,73,20,93,621392
chr1,40659728,0.9,81,9,90,621393
chr1,40659895,0.55,45,37,82,621394
chr1,40660004,0.99,101,1,102,621395
chr1,40660108,1,81,0,81,621396
chr1,40660127,0.93,75,6,81,621397
chr1,40660140,0.99,75,1,76,621398
chr1,40660172,0.99,71,1,72,621399
chr1,40660184,0.98,64,1,65,621400
chr1,40660226,0.96,53,2,55,621401
chr1,40660440,0.37,25,42,67,621402
chr1,40660528,0.98,46,1,47,621403
chr1,40660558,1,63,0,63,621404
chr1,40660630,0.98,64,1,65,621405
chr1,40660662,0.98,65,1,66,621406
chr1,40660666,1,67,0,67,621407
chr1,40660717,0.82,61,13,74,621408
chr1,40660753,0.95,61,3,64,621409
chr1,40660847,0.98,58,1,59,621410
chr1,40660849,1,57,0,57,621411
chr1,40660888,0.97,36,1,37,621412
chr1,40660893,0.97,34,1,35,621413
chr1,40660904,1,27,0,27,621414
chr1,40660981,0.99,69,1,70,621415
chr1,40660983,0.97,70,2,72,621416
chr1,40660993,0.9,71,8,79,621417
chr1,40661075,0.95,62,3,65,621418
chr1,40661077,1,64,0,64,621419
chr1,40661428,0.9,95,10,105,621420
chr1,40661480,0.85,88,15,103,621421
chr1,40661765,0.84,26,5,31,621422
chr1,40661770,0.67,20,10,30,621423
chr1,40661778,1,34,0,34,621424
chr1,40661816,0.96,51,2,53,621425
chr1,40661850,1,78,0,78,621426
chr1,40661889,0.99,79,1,80,621427
chr1,40661891,0.99,77,1,78,621428
chr1,40661893,1,79,0,79,621429
chr1,40661901,0.96,79,3,82,621430
chr1,40661934,0.93,88,7,95,621431
chr1,40661939,0.99,88,1,89,621432
chr1,40661965,0.99,81,1,82,621433
chr1,40662035,0.93,68,5,73,621434
chr1,40662039,1,74,0,74,621435
chr1,40662320,0.99,71,1,72,621436
chr1,40662506,0.98,106,2,108,621437
chr1,40662601,0.98,94,2,96,621438
chr1,40662730,0.98,92,2,94,621439
chr1,40662858,0.89,88,11,99,621440
chr1,40662981,0.95,114,6,120,621441
chr1,40663705,1,73,0,73,621442
chr1,40663767,0.99,89,1,90,621443
chr1,40663778,0.96,85,4,89,621444
chr1,40663800,0.94,68,4,72,621445
chr1,40663824,0.98,47,1,48,621446
chr1,40663836,0.93,43,3,46,621447
chr1,40663894,0.94,50,3,53,621448
chr1,40663961,1,33,0,33,621449
chr1,40663963,0.97,30,1,31,621450
chr1,40663967,1,25,0,25,621451
chr1,40664001,0.84,31,6,37,621452
chr1,40664037,0.94,48,3,51,621453
chr1,40664045,0.96,50,2,52,621454
chr1,40664062,1,59,0,59,621455
chr1,40664137,0.88,69,9,78,621456
chr1,40664192,0.98,87,2,89,621457
chr1,40664204,0.99,86,1,87,621458
chr1,40664232,0.96,90,4,94,621459
chr1,40664252,0.94,90,6,96,621460
chr1,40664268,0.93,100,7,107,621461
chr1,40664401,0.96,107,4,111,621462
chr1,40664684,1,102,0,102,621463
chr1,40664848,0.95,105,5,110,621464
chr1,40664916,0.92,95,8,103,621465
chr1,40665052,0.86,72,12,84,621466
chr1,40665254,0.55,58,48,106,621467
chr1,40665288,0.86,96,16,112,621468
chr1,40665340,0.95,110,6,116,621469
chr1,40665478,0.78,93,26,119,621470
chr1,40665680,0.71,64,26,90,621471
chr1,40666017,0.96,121,5,126,621472
chr1,40666472,0.87,45,7,52,621473
chr1,40666758,0.71,5,2,7,621474
chr1,40667015,1,73,0,73,621475
chr1,40667019,0.99,71,1,72,621476
chr1,40667025,0.97,61,2,63,621477
chr1,40667068,0.98,53,1,54,621478
chr1,40667093,0.98,47,1,48,621479
chr1,40667114,0.96,52,2,54,621480
chr1,40667125,0.96,54,2,56,621481
chr1,40667154,1,42,0,42,621482
chr1,40667166,0.97,32,1,33,621483
chr1,40667190,0.95,18,1,19,621484
chr1,40667214,1,12,0,12,621485
chr1,40667222,0.85,11,2,13,621486
chr1,40667229,1,14,0,14,621487
chr1,40667252,1,16,0,16,621488
chr1,40667254,1,16,0,16,621489
chr1,40667259,1,19,0,19,621490
chr1,40667623,0.78,54,15,69,621491
chr1,40667819,0.91,77,8,85,621492
chr1,40668128,1,98,0,98,621493
chr1,40668440,0.95,118,6,124,621494
chr1,40668582,0.77,79,24,103,621495
chr1,40668855,0.96,47,2,49,621496
chr1,40668879,0.95,59,3,62,621497
chr1,40668935,1,64,0,64,621498
chr1,40668976,0.93,78,6,84,621499
chr1,40669087,0.96,80,3,83,621500
chr1,40669129,0.96,86,4,90,621501
chr1,40669139,0.98,89,2,91,621502
chr1,40669163,0.97,87,3,90,621503
chr1,40669169,0.95,71,4,75,621504
chr1,40669691,0.88,42,6,48,621505
chr1,40669735,0.95,63,3,66,621506
chr1,40669765,0.96,87,4,91,621507
chr1,40669767,0.95,90,5,95,621508
chr1,40669812,0.95,73,4,77,621509
chr1,40669832,0.96,67,3,70,621510
chr1,40669844,0.99,67,1,68,621511
chr1,40669933,0.98,47,1,48,621512
chr1,40669938,1,51,0,51,621513
chr1,40669966,0.98,49,1,50,621514
chr1,40669982,0.95,52,3,55,621515
chr1,40670141,1,87,0,87,621516
chr1,40670239,0.9,70,8,78,621517
chr1,40670313,0.98,53,1,54,621518
chr1,40670336,0.98,63,1,64,621519
chr1,40670544,0.97,100,3,103,621520
chr1,40670762,0.91,90,9,99,621521
chr1,40670891,0.97,92,3,95,621522
chr1,40670915,0.89,82,10,92,621523
chr1,40670964,0.92,79,7,86,621524
chr1,40671002,0.8,78,20,98,621525
chr1,40671043,0.65,68,36,104,621526
chr1,40671139,0.92,35,3,38,621527
chr1,40671192,0.96,22,1,23,621528
chr1,40671224,0.96,27,1,28,621529
chr1,40671235,0.88,23,3,26,621530
chr1,40671247,0.93,25,2,27,621531
chr1,40671262,0.96,23,1,24,621532
chr1,40671286,0.67,4,2,6,621533
chr1,40671306,1,4,0,4,621534
chr1,40671310,1,11,0,11,621535
chr1,40671322,1,14,0,14,621536
chr1,40671353,0.95,36,2,38,621537
chr1,40671364,1,45,0,45,621538
chr1,40671398,0.98,51,1,52,621539
chr1,40671405,0.98,49,1,50,621540
chr1,40671409,1,57,0,57,621541
chr1,40671442,0.9,55,6,61,621542
chr1,40671451,0.91,59,6,65,621543
chr1,40671805,0.97,90,3,93,621544
chr1,40672251,0.74,56,20,76,621545
chr1,40672360,0.52,61,57,118,621546
chr1,40672407,0.51,47,45,92,621547
chr1,40672483,0.85,92,16,108,621548
chr1,40672591,0.95,107,6,113,621549
chr1,40672768,0.91,108,11,119,621550
chr1,40672798,0.87,93,14,107,621551
chr1,40673321,0.94,49,3,52,621552
chr1,40673343,0.94,50,3,53,621553
chr1,40673351,0.94,47,3,50,621554
chr1,40673427,0.75,54,18,72,621555
chr1,40673431,0.93,63,5,68,621556
chr1,40673484,0.58,36,26,62,621557
chr1,40673562,0.93,50,4,54,621558
chr1,40673574,0.93,54,4,58,621559
chr1,40673702,0.8,92,23,115,621560
chr1,40673905,0.88,100,13,113,621561
chr1,40674171,0.97,83,3,86,621562
chr1,40674350,0.94,66,4,70,621563
chr1,40674365,0.55,38,31,69,621564
chr1,40674381,0.66,63,32,95,621565
chr1,40674552,0.98,63,1,64,621566
chr1,40675012,0.93,78,6,84,621567
chr1,40675154,0.97,70,2,72,621568
chr1,40675157,0.96,67,3,70,621569
chr1,40675315,0.97,76,2,78,621570
chr1,40675320,0.99,73,1,74,621571
chr1,40675421,0.95,61,3,64,621572
chr1,40675503,1,63,0,63,621573
chr1,40675518,0.94,51,3,54,621574
chr1,40675528,0.98,47,1,48,621575
chr1,40675536,1,46,0,46,621576
chr1,40675544,1,34,0,34,621577
chr1,40675568,0.96,25,1,26,621578
chr1,40675841,0.22,25,88,113,621579
chr1,40676386,0.96,95,4,99,621580
chr1,40676639,0.58,33,24,57,621581
chr1,40676834,0.57,48,36,84,621582
chr1,40676902,0.54,57,49,106,621583
chr1,40676919,0.69,73,33,106,621584
chr1,40676930,0.53,58,51,109,621585
chr1,40677264,0.97,74,2,76,621586
chr1,40677354,0.98,82,2,84,621587
chr1,40677362,1,91,0,91,621588
chr1,40677386,1,101,0,101,621589
chr1,40677418,0.95,91,5,96,621590
chr1,40677434,1,93,0,93,621591
chr1,40677440,0.99,83,1,84,621592
chr1,40677450,0.99,80,1,81,621593
chr1,40677482,0.93,67,5,72,621594
chr1,40677493,0.94,60,4,64,621595
chr1,40677542,0.95,35,2,37,621596
chr1,40677546,0.95,60,3,63,621597
chr1,40677551,0.96,64,3,67,621598
chr1,40677592,0.96,76,3,79,621599
chr1,40677735,0.49,43,44,87,621600
chr1,40677885,0.89,91,11,102,621601
chr1,40678295,0.98,110,2,112,621602
chr1,40678314,0.91,99,10,109,621603
chr1,40678349,0.97,91,3,94,621604
chr1,40678359,0.92,82,7,89,621605
chr1,40678890,0.9,97,11,108,621606
chr1,40679006,0.91,82,8,90,621607
chr1,40679038,0.48,41,45,86,621608
chr1,40679127,0.85,93,17,110,621609
chr1,40679527,0.94,90,6,96,621610
chr1,40679576,0.72,63,24,87,621611
chr1,40680146,0.99,96,1,97,621612
chr1,40680357,0.94,85,5,90,621613
chr1,40681354,0.97,76,2,78,621614
chr1,40681533,0.93,66,5,71,621615
chr1,40681881,0.99,67,1,68,621616
chr1,40681892,0.94,65,4,69,621617
chr1,40681907,0.99,75,1,76,621618
chr1,40681925,0.96,81,3,84,621619
chr1,40681983,0.93,76,6,82,621620
chr1,40682020,0.98,65,1,66,621621
chr1,40682074,0.98,43,1,44,621622
chr1,40682084,0.97,31,1,32,621623
chr1,40682147,1,14,0,14,621624
chr1,40682303,0.95,62,3,65,621625
chr1,40682454,0.96,70,3,73,621626
chr1,40682464,0.99,80,1,81,621627
chr1,40682494,0.99,79,1,80,621628
chr1,40682521,0.99,71,1,72,621629
chr1,40682552,0.98,86,2,88,621630
chr1,40682579,0.97,95,3,98,621631
chr1,40682594,0.93,89,7,96,621632
chr1,40682652,1,75,0,75,621633
chr1,40682675,0.98,55,1,56,621634
chr1,40682947,0.96,67,3,70,621635
chr1,40683075,0.94,74,5,79,621636
chr1,40683097,0.99,74,1,75,621637
chr1,40683124,0.89,68,8,76,621638
chr1,40683165,0.97,75,2,77,621639
chr1,40683209,0.98,87,2,89,621640
chr1,40683214,0.95,82,4,86,621641
chr1,40683241,0.98,79,2,81,621642
chr1,40683261,0.98,80,2,82,621643
chr1,40683304,0.99,75,1,76,621644
chr1,40683306,0.97,72,2,74,621645
chr1,40683312,0.96,71,3,74,621646
chr1,40683316,0.99,66,1,67,621647
chr1,40683336,0.95,75,4,79,621648
chr1,40683368,0.99,74,1,75,621649
chr1,40683375,0.99,70,1,71,621650
chr1,40683392,1,62,0,62,621651
chr1,40683400,0.98,54,1,55,621652
chr1,40683435,0.93,38,3,41,621653
chr1,40683597,0.97,96,3,99,621654
chr1,40683704,0.97,99,3,102,621655
chr1,40683956,0.94,73,5,78,621656
chr1,40684172,0.93,110,8,118,621657
chr1,40684182,0.99,115,1,116,621658
chr1,40684190,0.99,114,1,115,621659
chr1,40684239,0.82,97,21,118,621660
chr1,40684316,0.82,106,23,129,621661
chr1,40684577,0.93,91,7,98,621662
chr1,40685285,0.92,89,8,97,621663
chr1,40685413,0.91,123,12,135,621664
chr1,40685646,0.93,66,5,71,621665
chr1,40685656,0.96,73,3,76,621666
chr1,40685764,0.9,75,8,83,621667
chr1,40685768,0.96,77,3,80,621668
chr1,40685792,0.92,72,6,78,621669
chr1,40685856,0.84,41,8,49,621670
chr1,40685886,0.68,27,13,40,621671
chr1,40686332,0.55,72,58,130,621672
chr1,40686718,0.97,57,2,59,621673
chr1,40686753,0.52,45,41,86,621674
chr1,40687089,0.58,57,42,99,621675
chr1,40687231,0.49,35,37,72,621676
chr1,40687236,0.62,46,28,74,621677
chr1,40687294,0.67,31,15,46,621678
chr1,40687300,0.55,26,21,47,621679
chr1,40687310,0.63,31,18,49,621680
chr1,40687343,0.94,47,3,50,621681
chr1,40687354,0.72,38,15,53,621682
chr1,40687399,0.81,43,10,53,621683
chr1,40687434,0.82,58,13,71,621684
chr1,40687444,0.96,71,3,74,621685
chr1,40687496,0.99,100,1,101,621686
chr1,40687503,0.98,102,2,104,621687
chr1,40687526,0.96,76,3,79,621688
chr1,40687528,0.97,73,2,75,621689
chr1,40687541,0.97,65,2,67,621690
chr1,40687550,0.94,48,3,51,621691
chr1,40687558,1,52,0,52,621692
chr1,40687566,0.98,40,1,41,621693
chr1,40688002,0.95,88,5,93,621694
chr1,40688257,0.5,56,55,111,621695
chr1,40688334,0.8,70,17,87,621696
chr1,40688930,0.8,82,20,102,621697
chr1,40689291,0.91,74,7,81,621698
chr1,40689651,0.95,98,5,103,621699
chr1,40689713,0.84,87,16,103,621700
chr1,40690003,0.86,24,4,28,621701
chr1,40690066,0.97,65,2,67,621702
chr1,40690073,0.85,67,12,79,621703
chr1,40690105,0.92,72,6,78,621704
chr1,40690109,0.95,71,4,75,621705
chr1,40690225,0.53,19,17,36,621706
chr1,40690237,0.97,28,1,29,621707
chr1,40690487,0.9,53,6,59,621708
chr1,40690515,0.72,59,23,82,621709
chr1,40690551,0.78,72,20,92,621710
chr1,40690590,0.99,97,1,98,621711
chr1,40690607,0.96,92,4,96,621712
chr1,40690642,0.99,98,1,99,621713
chr1,40690885,0.95,89,5,94,621714
chr1,40690976,1,86,0,86,621715
chr1,40690988,1,70,0,70,621716
chr1,40691021,1,62,0,62,621717
chr1,40691048,1,49,0,49,621718
chr1,40691107,0.99,72,1,73,621719
chr1,40691111,0.97,69,2,71,621720
chr1,40691119,0.96,70,3,73,621721
chr1,40691194,0.97,59,2,61,621722
chr1,40691205,1,50,0,50,621723
chr1,40691270,1,7,0,7,621724
chr1,40691274,1,8,0,8,621725
chr1,40691276,1,9,0,9,621726
chr1,40691314,1,16,0,16,621727
chr1,40691319,1,24,0,24,621728
chr1,40691392,0.97,67,2,69,621729
chr1,40691404,0.97,73,2,75,621730
chr1,40691415,0.97,77,2,79,621731
chr1,40691419,0.99,69,1,70,621732
chr1,40691441,1,61,0,61,621733
chr1,40691497,0.94,59,4,63,621734
chr1,40691503,0.97,56,2,58,621735
chr1,40691507,1,54,0,54,621736
chr1,40691537,1,43,0,43,621737
chr1,40691545,0.98,39,1,40,621738
chr1,40691548,0.92,36,3,39,621739
chr1,40691579,1,22,0,22,621740
chr1,40691594,1,30,0,30,621741
chr1,40691638,1,43,0,43,621742
chr1,40691768,0.91,80,8,88,621743
chr1,40691792,0.95,97,5,102,621744
chr1,40691960,0.94,122,8,130,621745
chr1,40692039,0.94,106,7,113,621746
chr1,40692242,0.88,79,11,90,621747
chr1,40692264,0.98,78,2,80,621748
chr1,40692629,0.96,87,4,91,621749
chr1,40692692,0.88,63,9,72,621750
chr1,40692756,1,67,0,67,621751
chr1,40692881,0.88,74,10,84,621752
chr1,40693066,0.97,114,4,118,621753
chr1,40693188,0.84,72,14,86,621754
chr1,40693465,1,78,0,78,621755
chr1,40693503,1,76,0,76,621756
chr1,40693543,0.97,74,2,76,621757
chr1,40693589,1,93,0,93,621758
chr1,40693623,0.99,76,1,77,621759
chr1,40693629,0.97,73,2,75,621760
chr1,40693754,0.94,62,4,66,621761
chr1,40693825,0.96,66,3,69,621762
chr1,40693829,0.97,67,2,69,621763
chr1,40693906,0.97,74,2,76,621764
chr1,40693926,0.87,55,8,63,621765
chr1,40693976,0.98,65,1,66,621766
chr1,40694030,0.98,86,2,88,621767
chr1,40694076,0.98,85,2,87,621768
chr1,40694084,0.94,88,6,94,621769
chr1,40694098,0.91,83,8,91,621770
chr1,40694113,0.96,80,3,83,621771
chr1,40694145,0.96,80,3,83,621772
chr1,40694179,1,68,0,68,621773
chr1,40694186,1,64,0,64,621774
chr1,40694233,1,40,0,40,621775
chr1,40694239,1,47,0,47,621776
chr1,40694360,0.94,85,5,90,621777
chr1,40694367,1,83,0,83,621778
chr1,40694578,0.99,70,1,71,621779
chr1,40694585,0.97,73,2,75,621780
chr1,40694677,0.94,77,5,82,621781
chr1,40694799,0.9,82,9,91,621782
chr1,40694899,0.83,95,19,114,621783
chr1,40695179,0.89,47,6,53,621784
chr1,40695195,0.91,48,5,53,621785
chr1,40695203,0.88,44,6,50,621786
chr1,40695219,0.98,48,1,49,621787
chr1,40695315,0.91,10,1,11,621788
chr1,40695346,0.97,33,1,34,621789
chr1,40695416,1,83,0,83,621790
chr1,40695420,0.98,80,2,82,621791
chr1,40695472,0.94,83,5,88,621792
chr1,40695508,0.97,83,3,86,621793
chr1,40695514,0.98,83,2,85,621794
chr1,40695552,0.97,75,2,77,621795
chr1,40695646,0.94,67,4,71,621796
chr1,40695726,0.98,55,1,56,621797
chr1,40695781,0.91,29,3,32,621798
chr1,40695866,0.78,60,17,77,621799
chr1,40696142,0.97,58,2,60,621800
chr1,40696164,0.98,49,1,50,621801
chr1,40696206,0.95,54,3,57,621802
chr1,40696324,0.94,34,2,36,621803
chr1,40696395,0.95,35,2,37,621804
chr1,40696404,0.92,36,3,39,621805
chr1,40696541,0.95,86,5,91,621806
chr1,40696801,0.97,92,3,95,621807
chr1,40697007,0.92,69,6,75,621808
chr1,40697126,0.97,68,2,70,621809
chr1,40697256,0.97,104,3,107,621810
chr1,40697262,0.96,112,5,117,621811
chr1,40697287,0.91,95,9,104,621812
chr1,40697579,0.94,79,5,84,621813
chr1,40697607,0.94,75,5,80,621814
chr1,40697650,0.99,67,1,68,621815
chr1,40697677,0.99,72,1,73,621816
chr1,40697708,0.96,77,3,80,621817
chr1,40697736,0.97,91,3,94,621818
chr1,40697748,0.93,83,6,89,621819
chr1,40697752,0.94,79,5,84,621820
chr1,40697794,0.98,91,2,93,621821
chr1,40697811,0.99,85,1,86,621822
chr1,40698054,0.98,102,2,104,621823
chr1,40698204,0.98,87,2,89,621824
chr1,40698407,0.99,105,1,106,621825
chr1,40698439,0.97,102,3,105,621826
chr1,40698488,0.93,108,8,116,621827
chr1,40698521,0.92,96,8,104,621828
chr1,40698555,0.95,59,3,62,621829
chr1,40698715,0.89,58,7,65,621830
chr1,40698745,0.79,31,8,39,621831
chr1,40698817,0.88,51,7,58,621832
chr1,40699420,0.18,11,50,61,621833
chr1,40699643,0.26,20,58,78,621834
chr1,40699681,0.56,49,39,88,621835
chr1,40699706,0.77,81,24,105,621836
chr1,40699873,0.98,81,2,83,621837
chr1,40699917,0.99,97,1,98,621838
chr1,40699980,0.73,91,33,124,621839
chr1,40700025,0.95,110,6,116,621840
chr1,40700233,0.93,100,7,107,621841
chr1,40700405,0.89,85,10,95,621842
chr1,40700627,0.98,129,2,131,621843
chr1,40700755,0.75,21,7,28,621844
chr1,40700837,0.98,82,2,84,621845
chr1,40700858,0.96,70,3,73,621846
chr1,40700921,0.98,53,1,54,621847
chr1,40700932,0.95,52,3,55,621848
chr1,40700976,0.96,69,3,72,621849
chr1,40701004,0.95,73,4,77,621850
chr1,40701014,0.93,75,6,81,621851
chr1,40701199,0.87,110,16,126,621852
chr1,40701270,0.97,116,3,119,621853
chr1,40701602,0.85,112,19,131,621854
chr1,40701711,0.94,113,7,120,621855
chr1,40701728,0.95,109,6,115,621856
chr1,40701803,0.92,121,10,131,621857
chr1,40702058,0.97,112,3,115,621858
chr1,40702214,0.97,85,3,88,621859
chr1,40702396,0.91,110,11,121,621860
chr1,40702412,0.93,113,9,122,621861
chr1,40702532,0.92,84,7,91,621862
chr1,40702535,0.91,82,8,90,621863
chr1,40702562,0.91,75,7,82,621864
chr1,40702570,0.97,76,2,78,621865
chr1,40702675,0.86,62,10,72,621866
chr1,40702682,0.97,73,2,75,621867
chr1,40703224,0.93,91,7,98,621868
chr1,40703300,0.99,82,1,83,621869
chr1,40703343,0.93,68,5,73,621870
chr1,40703483,0.96,100,4,104,621871
chr1,40703570,0.97,111,3,114,621872
chr1,40703742,0.96,109,4,113,621873
chr1,40703751,0.98,100,2,102,621874
chr1,40703876,0.92,90,8,98,621875
chr1,40704248,0.98,60,1,61,621876
chr1,40704359,0.99,76,1,77,621877
chr1,40704488,0.92,83,7,90,621878
chr1,40704571,0.97,94,3,97,621879
chr1,40704746,0.98,92,2,94,621880
chr1,40704776,0.97,90,3,93,621881
chr1,40705088,0.83,86,17,103,621882
chr1,40705147,0.97,101,3,104,621883
chr1,40705156,0.95,90,5,95,621884
chr1,40705238,0.99,85,1,86,621885
chr1,40705260,0.94,80,5,85,621886
chr1,40705643,0.73,89,33,122,621887
chr1,40706021,0.91,102,10,112,621888
chr1,40706183,0.98,117,3,120,621889
chr1,40706210,0.77,96,29,125,621890
chr1,40706596,0.92,87,8,95,621891
chr1,40706763,0.88,22,3,25,621892
chr1,40706802,0.96,54,2,56,621893
chr1,40706850,0.95,95,5,100,621894
chr1,40706888,0.35,44,81,125,621895
chr1,40706968,0.67,73,36,109,621896
chr1,40707009,0.61,75,47,122,621897
chr1,40707051,0.72,100,38,138,621898
chr1,40707658,0.84,31,6,37,621899
chr1,40707674,0.89,34,4,38,621900
chr1,40707696,0.93,37,3,40,621901
chr1,40707698,0.95,37,2,39,621902
chr1,40707704,0.91,43,4,47,621903
chr1,40707721,0.98,63,1,64,621904
chr1,40707792,1,75,0,75,621905
chr1,40707796,0.97,73,2,75,621906
chr1,40707870,0.97,34,1,35,621907
chr1,40707886,0.88,38,5,43,621908
chr1,40707914,0.93,57,4,61,621909
chr1,40708059,0.8,103,25,128,621910
chr1,40708229,0.94,90,6,96,621911
chr1,40708313,0.95,60,3,63,621912
chr1,40708459,1,63,0,63,621913
chr1,40708463,0.93,57,4,61,621914
chr1,40708465,0.91,61,6,67,621915
chr1,40708512,0.99,77,1,78,621916
chr1,40708553,0.97,85,3,88,621917
chr1,40708564,0.95,84,4,88,621918
chr1,40708609,0.98,86,2,88,621919
chr1,40708651,1,95,0,95,621920
chr1,40708661,0.98,97,2,99,621921
chr1,40708668,0.98,97,2,99,621922
chr1,40708685,1,91,0,91,621923
chr1,40708691,0.99,88,1,89,621924
chr1,40708693,0.96,82,3,85,621925
chr1,40708723,0.99,78,1,79,621926
chr1,40708849,0.98,81,2,83,621927
chr1,40708851,0.99,82,1,83,621928
chr1,40708859,0.93,74,6,80,621929
chr1,40708894,1,63,0,63,621930
chr1,40708952,0.33,19,39,58,621931
chr1,40709038,0.05,3,53,56,621932
chr1,40709179,0.02,1,47,48,621933
chr1,40709795,0.62,48,30,78,621934
chr1,40709976,0.09,10,107,117,621935
chr1,40710269,0.21,18,68,86,621936
chr1,40710305,0.64,54,30,84,621937
chr1,40710364,0.94,47,3,50,621938
chr1,40710451,0.89,81,10,91,621939
chr1,40710462,0.88,76,10,86,621940
chr1,40710471,0.72,61,24,85,621941
chr1,40710770,0.9,61,7,68,621942
chr1,40710909,0.93,65,5,70,621943
chr1,40711037,0.98,54,1,55,621944
chr1,40711039,0.91,48,5,53,621945
chr1,40711056,0.9,55,6,61,621946
chr1,40711098,0.97,60,2,62,621947
chr1,40711124,0.98,57,1,58,621948
chr1,40711408,0.96,102,4,106,621949
chr1,40711470,0.94,76,5,81,621950
chr1,40711754,0.94,76,5,81,621951
chr1,40711835,0.93,69,5,74,621952
chr1,40711898,0.96,77,3,80,621953
chr1,40711905,0.89,73,9,82,621954
chr1,40711949,0.86,69,11,80,621955
chr1,40711989,0.96,55,2,57,621956
chr1,40712021,0.87,39,6,45,621957
chr1,40712186,0.86,54,9,63,621958
chr1,40712202,0.8,41,10,51,621959
chr1,40712235,0.96,44,2,46,621960
chr1,40712246,0.93,42,3,45,621961
chr1,40712260,0.91,41,4,45,621962
chr1,40712291,0.86,50,8,58,621963
chr1,40712323,0.81,61,14,75,621964
chr1,40712377,0.44,45,58,103,621965
chr1,40712419,0.71,37,15,52,621966
chr1,40712449,0.41,11,16,27,621967
chr1,40712463,0.83,15,3,18,621968
chr1,40712673,0.97,57,2,59,621969
chr1,40712681,0.96,52,2,54,621970
chr1,40712685,0.96,47,2,49,621971
chr1,40712727,0.93,50,4,54,621972
chr1,40712767,0.98,58,1,59,621973
chr1,40712791,0.99,71,1,72,621974
chr1,40712804,0.98,84,2,86,621975
chr1,40713016,0.93,43,3,46,621976
chr1,40713134,0.93,77,6,83,621977
chr1,40713197,0.97,68,2,70,621978
chr1,40713257,0.97,73,2,75,621979
chr1,40713471,0.8,74,19,93,621980
chr1,40713882,0.64,52,29,81,621981
chr1,40714009,0.96,86,4,90,621982
chr1,40714589,0.52,46,42,88,621983
chr1,40714703,0.66,53,27,80,621984
chr1,40714847,0.58,36,26,62,621985
chr1,40714976,0.82,32,7,39,621986
chr1,40714978,0.88,35,5,40,621987
chr1,40714984,0.93,42,3,45,621988
chr1,40715104,0.98,52,1,53,621989
chr1,40715121,0.96,44,2,46,621990
chr1,40715123,0.98,44,1,45,621991
chr1,40715175,0.8,43,11,54,621992
chr1,40715205,0.83,30,6,36,621993
chr1,40715229,0.88,35,5,40,621994
chr1,40715414,0.96,53,2,55,621995
chr1,40715470,0.89,62,8,70,621996
chr1,40715490,0.95,63,3,66,621997
chr1,40715566,0.94,49,3,52,621998
chr1,40715589,0.93,54,4,58,621999
chr1,40715636,0.8,41,10,51,622000
chr1,40715707,0.83,59,12,71,622001
chr1,40715867,0.98,89,2,91,622002
chr1,40715872,0.95,89,5,94,622003
chr1,40716531,0.91,96,10,106,622004
chr1,40716547,0.94,92,6,98,622005
chr1,40716577,0.96,91,4,95,622006
chr1,40716584,0.94,84,5,89,622007
chr1,40716591,0.9,79,9,88,622008
chr1,40716625,0.83,55,11,66,622009
chr1,40716636,0.93,54,4,58,622010
chr1,40716665,0.92,34,3,37,622011
chr1,40716669,0.94,32,2,34,622012
chr1,40716681,0.96,25,1,26,622013
chr1,40716725,0.77,20,6,26,622014
chr1,40716740,1,22,0,22,622015
chr1,40716765,1,23,0,23,622016
chr1,40717051,0.8,99,25,124,622017
chr1,40717158,0.8,64,16,80,622018
chr1,40717178,0.85,60,11,71,622019
chr1,40717346,0.9,111,13,124,622020
chr1,40717361,0.8,107,26,133,622021
chr1,40717590,0.88,67,9,76,622022
chr1,40717971,0.97,30,1,31,622023
chr1,40718026,0.97,73,2,75,622024
chr1,40718097,0.97,75,2,77,622025
chr1,40718207,0.96,66,3,69,622026
chr1,40718337,0.9,37,4,41,622027
chr1,40718613,0.52,37,34,71,622028
chr1,40718673,0.88,60,8,68,622029
chr1,40718975,0.76,94,29,123,622030
chr1,40719048,0.96,100,4,104,622031
chr1,40719108,0.93,76,6,82,622032
chr1,40719162,1,76,0,76,622033
chr1,40719193,0.99,77,1,78,622034
chr1,40719195,0.96,73,3,76,622035
chr1,40719209,0.96,75,3,78,622036
chr1,40719235,0.89,68,8,76,622037
chr1,40719257,0.9,69,8,77,622038
chr1,40719277,0.97,64,2,66,622039
chr1,40719281,0.96,68,3,71,622040
chr1,40719343,0.95,54,3,57,622041
chr1,40719360,0.98,61,1,62,622042
chr1,40719380,0.97,58,2,60,622043
chr1,40719393,0.98,58,1,59,622044
chr1,40719425,0.98,54,1,55,622045
chr1,40719429,0.9,47,5,52,622046
chr1,40719468,1,56,0,56,622047
chr1,40719476,0.98,55,1,56,622048
chr1,40719506,0.98,54,1,55,622049
chr1,40719519,0.98,62,1,63,622050
chr1,40719538,0.97,61,2,63,622051
chr1,40719594,1,25,0,25,622052
chr1,40719602,1,24,0,24,622053
chr1,40719646,0.89,8,1,9,622054
chr1,40719666,0.29,6,15,21,622055
chr1,40719691,0.97,28,1,29,622056
chr1,40719696,0.89,31,4,35,622057
chr1,40719724,1,51,0,51,622058
chr1,40719734,1,45,0,45,622059
chr1,40719736,0.98,43,1,44,622060
chr1,40719740,0.98,50,1,51,622061
chr1,40719795,0.91,61,6,67,622062
chr1,40719928,0.86,89,14,103,622063
chr1,40720021,0.99,72,1,73,622064
chr1,40720037,0.99,72,1,73,622065
chr1,40720044,0.96,70,3,73,622066
chr1,40720054,0.97,64,2,66,622067
chr1,40720084,0.97,57,2,59,622068
chr1,40720086,0.95,57,3,60,622069
chr1,40720209,0.95,62,3,65,622070
chr1,40720233,0.97,87,3,90,622071
chr1,40720237,0.97,84,3,87,622072
chr1,40720249,0.98,83,2,85,622073
chr1,40720521,0.61,28,18,46,622074
chr1,40720901,0.72,73,28,101,622075
chr1,40721422,0.91,94,9,103,622076
chr1,40721434,0.96,94,4,98,622077
chr1,40721495,0.87,76,11,87,622078
chr1,40721716,0.86,94,15,109,622079
chr1,40721733,0.97,98,3,101,622080
chr1,40721737,0.92,91,8,99,622081
chr1,40722212,0.91,95,9,104,622082
chr1,40722254,0.55,63,52,115,622083
chr1,40722274,0.92,107,9,116,622084
chr1,40722341,0.68,78,36,114,622085
chr1,40722583,0.32,33,71,104,622086
chr1,40722598,0.16,16,82,98,622087
chr1,40722916,0,0,98,98,622088
chr1,40722955,0.03,3,94,97,622089
chr1,40723002,0,0,73,73,622090
chr1,40723048,0,0,91,91,622091
chr1,40723053,0.01,1,84,85,622092
chr1,40723064,0,0,101,101,622093
chr1,40723092,0,0,93,93,622094
chr1,40723120,0,0,86,86,622095
chr1,40723150,0.01,1,77,78,622096
chr1,40723161,0,0,55,55,622097
chr1,40723164,0,0,68,68,622098
chr1,40723194,0,0,69,69,622099
chr1,40723220,0,0,61,61,622100
chr1,40723226,0,0,80,80,622101
chr1,40723242,0,0,75,75,622102
chr1,40723253,0,0,78,78,622103
chr1,40723331,0.01,1,101,102,622104
chr1,40723353,0,0,109,109,622105
chr1,40723387,0,0,79,79,622106
chr1,40723394,0,0,74,74,622107
chr1,40723396,0,0,81,81,622108
chr1,40723415,0,0,75,75,622109
chr1,40723434,0,0,66,66,622110
chr1,40723446,0,0,63,63,622111
chr1,40723457,0,0,57,57,622112
chr1,40723486,0,0,62,62,622113
chr1,40723507,0,0,63,63,622114
chr1,40723530,0,0,58,58,622115
chr1,40723560,0.02,1,56,57,622116
chr1,40723563,0.02,1,53,54,622117
chr1,40723565,0,0,55,55,622118
chr1,40723602,0.02,1,59,60,622119
chr1,40723612,0.02,1,58,59,622120
chr1,40723620,0,0,67,67,622121
chr1,40723655,0,0,78,78,622122
chr1,40723661,0.01,1,77,78,622123
chr1,40723668,0,0,74,74,622124
chr1,40723671,0,0,69,69,622125
chr1,40723683,0,0,69,69,622126
chr1,40723697,0,0,74,74,622127
chr1,40723797,0,0,58,58,622128
chr1,40723799,0.02,1,58,59,622129
chr1,40723819,0.05,1,21,22,622130
chr1,40723826,0,0,68,68,622131
chr1,40723829,0,0,52,52,622132
chr1,40723841,0,0,69,69,622133
chr1,40723850,0,0,68,68,622134
chr1,40723868,0.02,1,65,66,622135
chr1,40723870,0,0,59,59,622136
chr1,40723876,0,0,48,48,622137
chr1,40723889,0.02,1,64,65,622138
chr1,40723896,0.01,1,67,68,622139
chr1,40723907,0,0,69,69,622140
chr1,40723914,0,0,66,66,622141
chr1,40723926,0,0,67,67,622142
chr1,40723929,0,0,52,52,622143
chr1,40723935,0,0,71,71,622144
chr1,40723960,0.02,1,59,60,622145
chr1,40723967,0,0,56,56,622146
chr1,40723984,0.02,1,62,63,622147
chr1,40723988,0,0,60,60,622148
chr1,40723995,0.02,1,54,55,622149
chr1,40724003,0.03,2,58,60,622150
chr1,40724009,0,0,51,51,622151
chr1,40724061,0,0,40,40,622152
chr1,40724103,0,0,60,60,622153
chr1,40724130,0,0,75,75,622154
chr1,40724154,0,0,87,87,622155
chr1,40724161,0,0,84,84,622156
chr1,40724163,0.01,1,83,84,622157
chr1,40724172,0,0,89,89,622158
chr1,40724197,0,0,89,89,622159
chr1,40724209,0,0,85,85,622160
chr1,40724215,0.01,1,68,69,622161
chr1,40724245,0.02,1,61,62,622162
chr1,40724266,0,0,65,65,622163
chr1,40724546,0.29,27,65,92,622164
chr1,40724552,0.41,36,51,87,622165
chr1,40724555,0.12,10,72,82,622166
chr1,40724595,0.54,34,29,63,622167
chr1,40724600,0.7,38,16,54,622168
chr1,40724604,0.76,31,10,41,622169
chr1,40724627,0.82,41,9,50,622170
chr1,40724645,0.28,17,43,60,622171
chr1,40724650,0.98,63,1,64,622172
chr1,40724658,0.66,45,23,68,622173
chr1,40724686,0.95,78,4,82,622174
chr1,40724698,0.97,73,2,75,622175
chr1,40724700,0.91,71,7,78,622176
chr1,40724761,0.99,69,1,70,622177
chr1,40724808,0.91,68,7,75,622178
chr1,40724871,0.68,56,26,82,622179
chr1,40725056,0.68,61,29,90,622180
chr1,40725064,0.63,62,36,98,622181
chr1,40725091,0.36,32,58,90,622182
chr1,40725140,0.96,66,3,69,622183
chr1,40725142,0.99,68,1,69,622184
chr1,40725186,0.38,33,55,88,622185
chr1,40725208,0.27,23,61,84,622186
chr1,40725218,0.64,47,27,74,622187
chr1,40725250,0.34,25,48,73,622188
chr1,40725361,0.79,37,10,47,622189
chr1,40725367,0.61,30,19,49,622190
chr1,40725379,0.71,29,12,41,622191
chr1,40725429,0.78,40,11,51,622192
chr1,40725479,0.44,22,28,50,622193
chr1,40725517,0.83,35,7,42,622194
chr1,40725560,0.08,4,46,50,622195
chr1,40725566,0.07,4,50,54,622196
chr1,40725921,0.55,40,33,73,622197
chr1,40726012,0.69,68,31,99,622198
chr1,40726022,0.52,50,47,97,622199
chr1,40726028,0.5,50,50,100,622200
chr1,40726183,0.32,41,86,127,622201
chr1,40726356,0.18,16,75,91,622202
chr1,40726439,0.76,77,24,101,622203
chr1,40726545,0.5,55,54,109,622204
chr1,40726589,0.34,36,71,107,622205
chr1,40726786,0.1,9,78,87,622206
chr1,40726950,0.16,11,59,70,622207
chr1,40727082,0.27,18,49,67,622208
chr1,40727118,0.34,28,54,82,622209
chr1,40727146,0.13,12,84,96,622210
chr1,40727181,0.11,11,91,102,622211
chr1,40727420,0.81,63,15,78,622212
chr1,40727440,0.87,66,10,76,622213
chr1,40727444,0.76,61,19,80,622214
chr1,40727474,0.84,67,13,80,622215
chr1,40727484,0.95,78,4,82,622216
chr1,40727526,0.97,67,2,69,622217
chr1,40727528,0.88,59,8,67,622218
chr1,40727571,0.72,33,13,46,622219
chr1,40727602,0.98,39,1,40,622220
chr1,40727616,0.94,44,3,47,622221
chr1,40728454,0.34,25,49,74,622222
chr1,40728961,0.08,7,80,87,622223
chr1,40729399,0.11,5,40,45,622224
chr1,40729424,0.07,2,25,27,622225
chr1,40729622,0.19,18,77,95,622226
chr1,40729731,0.24,19,59,78,622227
chr1,40729741,0.3,20,47,67,622228
chr1,40729769,0.21,14,52,66,622229
chr1,40729780,0.7,38,16,54,622230
chr1,40729826,0.15,10,57,67,622231
chr1,40729866,0.21,17,65,82,622232
chr1,40729888,0.19,15,64,79,622233
chr1,40729930,0.08,7,85,92,622234
chr1,40730093,0.12,9,64,73,622235
chr1,40730111,0.1,7,63,70,622236
chr1,40730305,0.12,11,80,91,622237
chr1,40730521,0.25,14,41,55,622238
chr1,40730601,0.67,31,15,46,622239
chr1,40732070,0.57,41,31,72,622240
chr1,40732222,0.67,42,21,63,622241
chr1,40732426,0.56,22,17,39,622242
chr1,40732502,0.22,9,32,41,622243
chr1,40732524,0.31,17,37,54,622244
chr1,40732565,0.38,28,45,73,622245
chr1,40732659,0.23,16,54,70,622246
chr1,40733105,0.45,40,49,89,622247
chr1,40733183,0.48,43,47,90,622248
chr1,40733279,0.11,6,51,57,622249
chr1,40733331,0.07,4,53,57,622250
chr1,40733506,0.04,4,89,93,622251
chr1,40733757,0.04,5,108,113,622252
chr1,40734370,0.1,7,61,68,622253
chr1,40734372,0.08,6,65,71,622254
chr1,40734401,0.09,7,70,77,622255
chr1,40734423,0.1,8,72,80,622256
chr1,40734520,0.94,50,3,53,622257
chr1,40734545,0.8,40,10,50,622258
chr1,40734566,0.94,59,4,63,622259
chr1,40734575,0.78,53,15,68,622260
chr1,40734604,0.98,62,1,63,622261
chr1,40734620,1,55,0,55,622262
chr1,40734640,0.96,49,2,51,622263
chr1,40734664,1,49,0,49,622264
chr1,40734672,1,44,0,44,622265
chr1,40734704,0.97,31,1,32,622266
chr1,40734740,0.77,17,5,22,622267
chr1,40734806,0.94,45,3,48,622268
chr1,40734839,1,55,0,55,622269
chr1,40735007,0.94,51,3,54,622270
chr1,40735151,0.94,65,4,69,622271
chr1,40735162,0.93,67,5,72,622272
chr1,40735216,0.97,83,3,86,622273
chr1,40735433,0.74,73,25,98,622274
chr1,40735819,0.68,69,33,102,622275
chr1,40736075,0.45,28,34,62,622276
chr1,40736246,0.74,37,13,50,622277
chr1,40736979,0.96,95,4,99,622278
chr1,40737201,0.97,88,3,91,622279
chr1,40737219,0.95,86,5,91,622280
chr1,40737687,0.89,88,11,99,622281
chr1,40738288,0.93,81,6,87,622282
chr1,40738379,0.99,86,1,87,622283
chr1,40738593,0.75,71,24,95,622284
chr1,40738639,0.87,84,13,97,622285
chr1,40738915,0.96,66,3,69,622286
chr1,40738927,0.91,59,6,65,622287
chr1,40738964,0.98,59,1,60,622288
chr1,40738983,0.98,60,1,61,622289
chr1,40738987,0.97,61,2,63,622290
chr1,40739050,0.96,66,3,69,622291
chr1,40739060,0.96,67,3,70,622292
chr1,40739104,0.89,54,7,61,622293
chr1,40739289,0.64,37,21,58,622294
chr1,40739498,0.96,96,4,100,622295
chr1,40739558,0.69,64,29,93,622296
chr1,40739726,0.6,44,29,73,622297
chr1,40739854,0.94,62,4,66,622298
chr1,40739880,0.99,76,1,77,622299
chr1,40740175,0.98,102,2,104,622300
chr1,40740186,0.78,84,24,108,622301
chr1,40740817,1,78,0,78,622302
chr1,40740857,0.92,61,5,66,622303
chr1,40740866,0.97,59,2,61,622304
chr1,40740889,0.78,43,12,55,622305
chr1,40740962,0.88,14,2,16,622306
chr1,40740966,0.89,16,2,18,622307
chr1,40740974,0.92,22,2,24,622308
chr1,40740978,0.92,24,2,26,622309
chr1,40741037,0.98,46,1,47,622310
chr1,40741060,0.96,53,2,55,622311
chr1,40741149,0.93,56,4,60,622312
chr1,40741161,0.98,46,1,47,622313
chr1,40741221,0.94,30,2,32,622314
chr1,40741338,0.95,56,3,59,622315
chr1,40741372,1,39,0,39,622316
chr1,40741378,0.97,36,1,37,622317
chr1,40741380,0.97,36,1,37,622318
chr1,40741450,0.29,8,20,28,622319
chr1,40741490,0.52,36,33,69,622320
chr1,40741591,0.93,74,6,80,622321
chr1,40741719,0.84,85,16,101,622322
chr1,40741934,0.89,90,11,101,622323
chr1,40741943,0.96,103,4,107,622324
chr1,40742133,0.81,62,15,77,622325
chr1,40742280,0.94,79,5,84,622326
chr1,40742366,0.56,47,37,84,622327
chr1,40742381,0.9,79,9,88,622328
chr1,40742490,0.99,103,1,104,622329
chr1,40742587,0.93,122,9,131,622330
chr1,40742674,0.98,102,2,104,622331
chr1,40742689,0.95,91,5,96,622332
chr1,40742706,1,85,0,85,622333
chr1,40742723,0.89,63,8,71,622334
chr1,40742780,0.26,8,23,31,622335
chr1,40742843,1,56,0,56,622336
chr1,40742850,0.95,52,3,55,622337
chr1,40742902,0.96,43,2,45,622338
chr1,40742906,0.98,47,1,48,622339
chr1,40742918,0.91,40,4,44,622340
chr1,40742959,0.93,40,3,43,622341
chr1,40742979,0.98,39,1,40,622342
chr1,40743009,0.98,49,1,50,622343
chr1,40743047,0.97,65,2,67,622344
chr1,40743094,0.8,51,13,64,622345
chr1,40743199,1,73,0,73,622346
chr1,40743234,0.97,76,2,78,622347
chr1,40743366,0.99,72,1,73,622348
chr1,40743438,0.96,67,3,70,622349
chr1,40743469,0.92,55,5,60,622350
chr1,40743509,1,65,0,65,622351
chr1,40743555,1,60,0,60,622352
chr1,40743565,1,53,0,53,622353
chr1,40743572,0.94,50,3,53,622354
chr1,40743595,0.98,40,1,41,622355
chr1,40744005,0.94,75,5,80,622356
chr1,40744012,0.99,77,1,78,622357
chr1,40744026,0.99,67,1,68,622358
chr1,40744046,0.98,54,1,55,622359
chr1,40744057,0.9,44,5,49,622360
chr1,40744086,0.96,24,1,25,622361
chr1,40744102,0.63,5,3,8,622362
chr1,40744122,0,0,3,3,622363
chr1,40744154,0,0,1,1,622364
chr1,40744267,0.82,36,8,44,622365
chr1,40744309,0.97,61,2,63,622366
chr1,40744669,0.95,89,5,94,622367
chr1,40744791,0.84,57,11,68,622368
chr1,40745136,0.55,70,58,128,622369
chr1,40745172,0.83,128,26,154,622370
chr1,40745226,0.37,54,92,146,622371
chr1,40745356,1,95,0,95,622372
chr1,40745363,0.97,89,3,92,622373
chr1,40745424,0.97,90,3,93,622374
chr1,40745449,0.95,97,5,102,622375
chr1,40745622,0.99,92,1,93,622376
chr1,40745626,0.93,83,6,89,622377
chr1,40745650,0.99,82,1,83,622378
chr1,40745657,0.95,80,4,84,622379
chr1,40745705,0.99,73,1,74,622380
chr1,40745744,0.97,64,2,66,622381
chr1,40745810,0.97,57,2,59,622382
chr1,40745814,1,66,0,66,622383
chr1,40745825,0.95,55,3,58,622384
chr1,40745840,1,62,0,62,622385
chr1,40745876,1,55,0,55,622386
chr1,40745910,0.93,51,4,55,622387
chr1,40745926,0.93,52,4,56,622388
chr1,40745981,1,86,0,86,622389
chr1,40745988,0.91,84,8,92,622390
chr1,40745992,0.94,88,6,94,622391
chr1,40746016,0.97,96,3,99,622392
chr1,40746030,0.98,96,2,98,622393
chr1,40746051,0.94,78,5,83,622394
chr1,40746128,0.98,57,1,58,622395
chr1,40746157,0.98,79,2,81,622396
chr1,40746182,0.98,99,2,101,622397
chr1,40746221,0.86,92,15,107,622398
chr1,40746245,0.98,86,2,88,622399
chr1,40746257,0.95,82,4,86,622400
chr1,40746317,0.92,66,6,72,622401
chr1,40746340,1,69,0,69,622402
chr1,40746579,0.8,86,21,107,622403
chr1,40746625,0.74,84,29,113,622404
chr1,40746645,0.58,67,49,116,622405
chr1,40747023,0.76,75,24,99,622406
chr1,40747071,0.77,88,26,114,622407
chr1,40747152,0.65,50,27,77,622408
chr1,40747677,0.1,9,85,94,622409
chr1,40747842,0.21,21,79,100,622410
chr1,40747954,0.59,68,47,115,622411
chr1,40748233,0.39,30,46,76,622412
chr1,40748256,0.96,81,3,84,622413
chr1,40748293,0.92,76,7,83,622414
chr1,40748303,0.98,79,2,81,622415
chr1,40748310,0.97,91,3,94,622416
chr1,40748377,0.78,52,15,67,622417
chr1,40748549,0.95,92,5,97,622418
chr1,40748558,0.9,80,9,89,622419
chr1,40748973,0.92,84,7,91,622420
chr1,40748996,0.87,83,12,95,622421
chr1,40749046,0.97,96,3,99,622422
chr1,40749050,0.77,74,22,96,622423
chr1,40749386,0.84,70,13,83,622424
chr1,40749482,0.82,54,12,66,622425
chr1,40749649,0.98,47,1,48,622426
chr1,40749671,0.97,56,2,58,622427
chr1,40749673,0.98,59,1,60,622428
chr1,40749700,0.96,66,3,69,622429
chr1,40749814,0.79,19,5,24,622430
chr1,40749859,1,47,0,47,622431
chr1,40749979,0.96,90,4,94,622432
chr1,40750154,0.99,73,1,74,622433
chr1,40750221,0.98,78,2,80,622434
chr1,40750280,0.91,69,7,76,622435
chr1,40750296,0.97,70,2,72,622436
chr1,40750365,0.98,93,2,95,622437
chr1,40750372,0.97,84,3,87,622438
chr1,40750378,0.99,89,1,90,622439
chr1,40750383,0.98,89,2,91,622440
chr1,40750658,1,53,0,53,622441
chr1,40750683,0.99,66,1,67,622442
chr1,40750839,1,55,0,55,622443
chr1,40750923,0.95,79,4,83,622444
chr1,40750932,0.95,78,4,82,622445
chr1,40750998,0.96,77,3,80,622446
chr1,40751012,0.97,84,3,87,622447
chr1,40751163,0.95,83,4,87,622448
chr1,40751191,0.93,86,6,92,622449
chr1,40751395,0.76,74,24,98,622450
chr1,40751632,0.96,104,4,108,622451
chr1,40752123,0.96,46,2,48,622452
chr1,40752161,0.98,50,1,51,622453
chr1,40752195,0.94,62,4,66,622454
chr1,40752312,1,71,0,71,622455
chr1,40752344,1,69,0,69,622456
chr1,40752372,0.96,49,2,51,622457
chr1,40752460,0.98,42,1,43,622458
chr1,40752468,0.96,48,2,50,622459
chr1,40752492,0.95,71,4,75,622460
chr1,40752548,0.96,70,3,73,622461
chr1,40752592,0.88,65,9,74,622462
chr1,40752623,0.97,70,2,72,622463
chr1,40752646,0.93,69,5,74,622464
chr1,40752699,0.85,47,8,55,622465
chr1,40752799,0.87,47,7,54,622466
chr1,40752893,1,93,0,93,622467
chr1,40752895,0.98,94,2,96,622468
chr1,40752899,0.95,87,5,92,622469
chr1,40752930,0.99,83,1,84,622470
chr1,40752978,0.98,101,2,103,622471
chr1,40752987,0.94,98,6,104,622472
chr1,40753030,0.94,90,6,96,622473
chr1,40753036,0.95,92,5,97,622474
chr1,40753072,0.99,71,1,72,622475
chr1,40753075,0.98,65,1,66,622476
chr1,40753099,0.97,70,2,72,622477
chr1,40753146,0.99,66,1,67,622478
chr1,40753209,0.98,65,1,66,622479
chr1,40753219,0.99,66,1,67,622480
chr1,40753301,0.96,47,2,49,622481
chr1,40753325,0.94,32,2,34,622482
chr1,40753432,0.81,64,15,79,622483
chr1,40753617,0.96,85,4,89,622484
chr1,40753669,0.97,75,2,77,622485
chr1,40754188,0.9,73,8,81,622486
chr1,40754239,0.99,75,1,76,622487
chr1,40754284,1,67,0,67,622488
chr1,40754460,0.69,88,39,127,622489
chr1,40754504,0.98,96,2,98,622490
chr1,40754616,0.97,87,3,90,622491
chr1,40754929,0.99,102,1,103,622492
chr1,40755193,0.91,75,7,82,622493
chr1,40755275,0.81,61,14,75,622494
chr1,40755537,0.96,77,3,80,622495
chr1,40755559,0.94,82,5,87,622496
chr1,40755776,0.94,62,4,66,622497
chr1,40755884,0.9,66,7,73,622498
chr1,40755913,0.95,58,3,61,622499
chr1,40755929,1,42,0,42,622500
chr1,40755949,0.9,38,4,42,622501
chr1,40755973,0.98,39,1,40,622502
chr1,40755988,1,35,0,35,622503
chr1,40756005,1,41,0,41,622504
chr1,40756011,0.98,40,1,41,622505
chr1,40756035,0.93,53,4,57,622506
chr1,40756193,0.9,18,2,20,622507
chr1,40756218,1,30,0,30,622508
chr1,40756225,1,36,0,36,622509
chr1,40756233,0.95,35,2,37,622510
chr1,40756257,0.98,47,1,48,622511
chr1,40756281,0.98,49,1,50,622512
chr1,40756289,0.98,55,1,56,622513
chr1,40756293,0.98,56,1,57,622514
chr1,40756324,0.76,34,11,45,622515
chr1,40756369,0.82,32,7,39,622516
chr1,40756380,0.89,49,6,55,622517
chr1,40756413,0.98,57,1,58,622518
chr1,40756423,1,65,0,65,622519
chr1,40756425,0.97,63,2,65,622520
chr1,40756429,1,67,0,67,622521
chr1,40756571,0.95,78,4,82,622522
chr1,40756858,0.7,91,39,130,622523
chr1,40756925,0.83,88,18,106,622524
chr1,40757131,0.95,81,4,85,622525
chr1,40757194,0.91,106,11,117,622526
chr1,40757543,0.96,26,1,27,622527
chr1,40757598,1,50,0,50,622528
chr1,40757605,0.95,54,3,57,622529
chr1,40757669,0.87,83,12,95,622530
chr1,40757732,0.97,100,3,103,622531
chr1,40757809,0.9,93,10,103,622532
chr1,40758147,0.66,67,34,101,622533
chr1,40758620,0.69,92,42,134,622534
chr1,40759043,0.78,63,18,81,622535
chr1,40759066,0.3,21,48,69,622536
chr1,40759166,0.46,51,61,112,622537
chr1,40759202,0.67,75,37,112,622538
chr1,40759227,0.75,82,27,109,622539
chr1,40759587,0.82,92,20,112,622540
chr1,40759621,0.92,98,9,107,622541
chr1,40759843,0.74,82,29,111,622542
chr1,40760334,0.7,79,34,113,622543
chr1,40760607,0.97,58,2,60,622544
chr1,40760758,0.97,69,2,71,622545
chr1,40760772,1,71,0,71,622546
chr1,40760781,1,69,0,69,622547
chr1,40760798,0.97,64,2,66,622548
chr1,40760844,0.96,55,2,57,622549
chr1,40760852,0.93,52,4,56,622550
chr1,40760925,1,38,0,38,622551
chr1,40760931,0.98,42,1,43,622552
chr1,40761025,0.85,50,9,59,622553
chr1,40761172,0.81,86,20,106,622554
chr1,40761236,0.95,87,5,92,622555
chr1,40761290,0.97,64,2,66,622556
chr1,40761336,0.92,56,5,61,622557
chr1,40761402,0.76,41,13,54,622558
chr1,40761567,0.93,77,6,83,622559
chr1,40761673,0.97,110,3,113,622560
chr1,40761880,0.95,76,4,80,622561
chr1,40761886,0.97,72,2,74,622562
chr1,40761935,0.96,65,3,68,622563
chr1,40762054,1,71,0,71,622564
chr1,40762092,0.97,75,2,77,622565
chr1,40762142,1,89,0,89,622566
chr1,40762147,0.84,78,15,93,622567
chr1,40762230,0.97,67,2,69,622568
chr1,40762315,0.85,40,7,47,622569
chr1,40762339,0.89,33,4,37,622570
chr1,40762369,0.88,29,4,33,622571
chr1,40762379,0.84,27,5,32,622572
chr1,40762496,0.98,63,1,64,622573
chr1,40762523,0.96,77,3,80,622574
chr1,40762563,0.96,82,3,85,622575
chr1,40762694,0.86,89,14,103,622576
chr1,40763095,0.99,93,1,94,622577
chr1,40763137,0.96,96,4,100,622578
chr1,40763171,0.95,97,5,102,622579
chr1,40763202,0.88,88,12,100,622580
chr1,40763205,0.94,96,6,102,622581
chr1,40763222,0.91,92,9,101,622582
chr1,40763353,0.98,60,1,61,622583
chr1,40763663,0.92,59,5,64,622584
chr1,40763712,1,30,0,30,622585
chr1,40763737,1,6,0,6,622586
chr1,40763798,1,6,0,6,622587
chr1,40763810,0.86,6,1,7,622588
chr1,40763834,0.71,20,8,28,622589
chr1,40763885,0.96,43,2,45,622590
chr1,40763898,0.79,34,9,43,622591
chr1,40764297,0.93,62,5,67,622592
chr1,40764506,0.7,101,43,144,622593
chr1,40764699,0.21,23,86,109,622594
chr1,40764792,0.78,47,13,60,622595
chr1,40764843,0.77,51,15,66,622596
chr1,40765246,0.55,36,30,66,622597
chr1,40765490,0.31,9,20,29,622598
chr1,40765580,0.45,9,11,20,622599
chr1,40765690,0.65,48,26,74,622600
chr1,40765807,0.86,83,13,96,622601
chr1,40765851,0.91,84,8,92,622602
chr1,40765854,0.91,81,8,89,622603
chr1,40766052,0.95,56,3,59,622604
chr1,40766249,0.84,81,15,96,622605
chr1,40766275,0.96,80,3,83,622606
chr1,40766357,0.97,77,2,79,622607
chr1,40766484,0.96,53,2,55,622608
chr1,40766493,0.91,49,5,54,622609
chr1,40766576,0.87,45,7,52,622610
chr1,40766587,0.96,50,2,52,622611
chr1,40766602,0.98,41,1,42,622612
chr1,40766618,0.98,40,1,41,622613
chr1,40766623,0.91,42,4,46,622614
chr1,40766632,0.98,46,1,47,622615
chr1,40766816,1,58,0,58,622616
chr1,40766888,0.98,60,1,61,622617
chr1,40766905,0.92,58,5,63,622618
chr1,40766922,0.98,63,1,64,622619
chr1,40766941,0.97,67,2,69,622620
chr1,40766952,0.95,70,4,74,622621
chr1,40766972,0.74,54,19,73,622622
chr1,40767005,0.97,84,3,87,622623
chr1,40767021,0.85,76,13,89,622624
chr1,40767041,0.89,84,10,94,622625
chr1,40767337,0.93,50,4,54,622626
chr1,40767391,0.96,44,2,46,622627
chr1,40767399,0.96,43,2,45,622628
chr1,40767414,1,51,0,51,622629
chr1,40767427,0.89,51,6,57,622630
chr1,40767511,0.85,51,9,60,622631
chr1,40767522,0.95,55,3,58,622632
chr1,40767555,0.79,60,16,76,622633
chr1,40767635,0.88,106,14,120,622634
chr1,40767695,0.92,84,7,91,622635
chr1,40767938,0.91,79,8,87,622636
chr1,40767951,0.78,67,19,86,622637
chr1,40767981,0.8,67,17,84,622638
chr1,40768026,0.96,73,3,76,622639
chr1,40768102,0.79,73,19,92,622640
chr1,40768133,0.83,70,14,84,622641
chr1,40768189,0.96,69,3,72,622642
chr1,40768236,0.94,48,3,51,622643
chr1,40768276,0.84,42,8,50,622644
chr1,40768303,0.76,39,12,51,622645
chr1,40768311,0.96,45,2,47,622646
chr1,40768323,0.92,44,4,48,622647
chr1,40768332,0.86,51,8,59,622648
chr1,40768344,1,60,0,60,622649
chr1,40768349,0.95,62,3,65,622650
chr1,40768432,0.94,48,3,51,622651
chr1,40768448,0.98,50,1,51,622652
chr1,40768461,0.7,37,16,53,622653
chr1,40768464,0.91,40,4,44,622654
chr1,40768562,0.98,56,1,57,622655
chr1,40768609,0.85,67,12,79,622656
chr1,40768625,0.96,72,3,75,622657
chr1,40768727,0.84,64,12,76,622658
chr1,40768738,0.97,71,2,73,622659
chr1,40768756,1,54,0,54,622660
chr1,40768759,1,50,0,50,622661
chr1,40768768,0.7,38,16,54,622662
chr1,40768819,1,59,0,59,622663
chr1,40768830,0.95,57,3,60,622664
chr1,40768853,0.92,56,5,61,622665
chr1,40768907,0.98,52,1,53,622666
chr1,40768930,0.96,50,2,52,622667
chr1,40768938,1,62,0,62,622668
chr1,40769030,0.78,47,13,60,622669
chr1,40769032,0.94,59,4,63,622670
chr1,40769095,1,59,0,59,622671
chr1,40769104,0.69,43,19,62,622672
chr1,40769135,0.97,56,2,58,622673
chr1,40769144,0.98,45,1,46,622674
chr1,40769187,0.52,28,26,54,622675
chr1,40769194,0.56,28,22,50,622676
chr1,40769207,0.93,41,3,44,622677
chr1,40769219,0.74,35,12,47,622678
chr1,40769234,1,48,0,48,622679
chr1,40769239,0.92,48,4,52,622680
chr1,40769246,1,56,0,56,622681
chr1,40769257,0.83,48,10,58,622682
chr1,40769264,1,59,0,59,622683
chr1,40769297,0.96,47,2,49,622684
chr1,40769301,0.88,45,6,51,622685
chr1,40769309,0.96,45,2,47,622686
chr1,40769327,0.5,21,21,42,622687
chr1,40769338,0.85,33,6,39,622688
chr1,40769352,0.94,32,2,34,622689
chr1,40769378,0.48,16,17,33,622690
chr1,40769390,1,31,0,31,622691
chr1,40769394,0.5,16,16,32,622692
chr1,40769402,1,27,0,27,622693
chr1,40769422,0.54,7,6,13,622694
chr1,40769438,0.97,30,1,31,622695
chr1,40769451,0.84,32,6,38,622696
chr1,40769458,0.47,17,19,36,622697
chr1,40769461,0.76,29,9,38,622698
chr1,40769494,0.92,36,3,39,622699
chr1,40769499,0.92,35,3,38,622700
chr1,40769502,0.79,30,8,38,622701
chr1,40769508,0.89,32,4,36,622702
chr1,40769531,1,37,0,37,622703
chr1,40769537,1,41,0,41,622704
chr1,40769543,0.78,28,8,36,622705
chr1,40769545,0.5,17,17,34,622706
chr1,40769554,0.32,12,26,38,622707
chr1,40769564,0.95,36,2,38,622708
chr1,40769567,0.97,36,1,37,622709
chr1,40769574,0.98,41,1,42,622710
chr1,40769589,0.95,39,2,41,622711
chr1,40769591,0.8,28,7,35,622712
chr1,40769593,0.98,41,1,42,622713
chr1,40769605,0.96,44,2,46,622714
chr1,40769617,0.61,35,22,57,622715
chr1,40769626,0.79,34,9,43,622716
chr1,40769660,0.21,13,48,61,622717
chr1,40769669,0.83,49,10,59,622718
chr1,40769671,0.5,28,28,56,622719
chr1,40769673,0.8,45,11,56,622720
chr1,40769679,0.96,52,2,54,622721
chr1,40769682,0.96,51,2,53,622722
chr1,40769688,1,47,0,47,622723
chr1,40769708,0.47,17,19,36,622724
chr1,40769744,0.78,25,7,32,622725
chr1,40769746,0.77,23,7,30,622726
chr1,40769753,0.68,17,8,25,622727
chr1,40769782,0.88,21,3,24,622728
chr1,40769801,0.83,15,3,18,622729
chr1,40769817,0.17,3,15,18,622730
chr1,40769838,0.93,26,2,28,622731
chr1,40769862,0.97,37,1,38,622732
chr1,40769867,0.97,36,1,37,622733
chr1,40769870,0.78,31,9,40,622734
chr1,40769894,1,50,0,50,622735
chr1,40769911,0.96,50,2,52,622736
chr1,40769931,0.95,36,2,38,622737
chr1,40770006,0.86,57,9,66,622738
chr1,40770036,0.48,30,33,63,622739
chr1,40770116,0.92,54,5,59,622740
chr1,40770189,0.98,52,1,53,622741
chr1,40770257,0.9,66,7,73,622742
chr1,40770262,0.81,64,15,79,622743
chr1,40770275,0.9,78,9,87,622744
chr1,40770381,0.58,46,33,79,622745
chr1,40770390,0.48,37,40,77,622746
chr1,40770424,0.84,63,12,75,622747
chr1,40770436,0.83,58,12,70,622748
chr1,40770503,0.34,17,33,50,622749
chr1,40770547,0.98,51,1,52,622750
chr1,40770800,1,42,0,42,622751
chr1,40770802,0.95,42,2,44,622752
chr1,40770809,0.91,39,4,43,622753
chr1,40770825,1,49,0,49,622754
chr1,40770832,0.84,46,9,55,622755
chr1,40770894,0.98,45,1,46,622756
chr1,40770929,0.96,43,2,45,622757
chr1,40770940,1,43,0,43,622758
chr1,40770942,0.95,42,2,44,622759
chr1,40770962,0.95,35,2,37,622760
chr1,40770973,0.98,39,1,40,622761
chr1,40771006,0.96,53,2,55,622762
chr1,40771016,1,56,0,56,622763
chr1,40771018,0.98,56,1,57,622764
chr1,40771022,0.97,59,2,61,622765
chr1,40771025,0.97,59,2,61,622766
chr1,40771135,0.53,26,23,49,622767
chr1,40771305,0.56,37,29,66,622768
chr1,40771426,0.77,66,20,86,622769
chr1,40771432,0.76,68,22,90,622770
chr1,40771509,0.54,43,36,79,622771
chr1,40771547,0.45,35,42,77,622772
chr1,40771807,0.85,50,9,59,622773
chr1,40771988,0.75,73,24,97,622774
chr1,40772077,0.88,80,11,91,622775
chr1,40772128,0.92,67,6,73,622776
chr1,40772252,0.89,86,11,97,622777
chr1,40772602,0.97,59,2,61,622778
chr1,40772668,0.94,85,5,90,622779
chr1,40772673,0.97,89,3,92,622780
chr1,40772705,0.94,94,6,100,622781
chr1,40772812,0.91,104,10,114,622782
chr1,40772866,0.99,84,1,85,622783
chr1,40772984,0.95,76,4,80,622784
chr1,40773045,0.92,49,4,53,622785
chr1,40773118,0.94,46,3,49,622786
chr1,40773144,0.86,61,10,71,622787
chr1,40773154,0.94,74,5,79,622788
chr1,40773387,1,47,0,47,622789
chr1,40773410,0.96,43,2,45,622790
chr1,40773465,0.91,58,6,64,622791
chr1,40773608,0.8,39,10,49,622792
chr1,40773647,0.75,40,13,53,622793
chr1,40773675,0.53,31,27,58,622794
chr1,40773864,0.1,8,72,80,622795
chr1,40773876,0.12,10,72,82,622796
chr1,40773901,0.22,19,67,86,622797
chr1,40773926,0.29,20,49,69,622798
chr1,40774052,0,0,40,40,622799
chr1,40774222,0.05,4,74,78,622800
chr1,40774643,0.88,60,8,68,622801
chr1,40774683,0.57,35,26,61,622802
chr1,40774715,0.48,31,34,65,622803
chr1,40774781,0.85,60,11,71,622804
chr1,40774844,0.95,71,4,75,622805
chr1,40774861,0.43,34,46,80,622806
chr1,40774867,0.48,34,37,71,622807
chr1,40775078,0.38,18,30,48,622808
chr1,40775141,0.14,8,49,57,622809
chr1,40775506,0.76,73,23,96,622810
chr1,40775612,0.48,37,40,77,622811
chr1,40775632,0.13,10,68,78,622812
chr1,40775640,0.47,34,38,72,622813
chr1,40775783,0.88,56,8,64,622814
chr1,40775800,0.94,60,4,64,622815
chr1,40775806,0.93,50,4,54,622816
chr1,40775936,0.45,19,23,42,622817
chr1,40776386,0.92,55,5,60,622818
chr1,40776537,0.98,50,1,51,622819
chr1,40776552,0.93,53,4,57,622820
chr1,40776618,0.96,51,2,53,622821
chr1,40776645,0.98,43,1,44,622822
chr1,40776691,0.9,36,4,40,622823
chr1,40776727,0.96,47,2,49,622824
chr1,40776765,0.95,35,2,37,622825
chr1,40776800,0.85,22,4,26,622826
chr1,40776802,0.83,20,4,24,622827
chr1,40776810,1,21,0,21,622828
chr1,40776844,0.77,30,9,39,622829
chr1,40777005,1,53,0,53,622830
chr1,40777026,0.58,26,19,45,622831
chr1,40777038,1,41,0,41,622832
chr1,40777101,0.47,18,20,38,622833
chr1,40777109,0.64,18,10,28,622834
chr1,40777131,0.79,23,6,29,622835
chr1,40777150,0.78,28,8,36,622836
chr1,40777162,0.73,38,14,52,622837
chr1,40777181,0.94,51,3,54,622838
chr1,40777211,0.86,38,6,44,622839
chr1,40777215,0.83,30,6,36,622840
chr1,40777262,1,29,0,29,622841
chr1,40777265,1,31,0,31,622842
chr1,40777313,0.88,37,5,42,622843
chr1,40777361,0.96,52,2,54,622844
chr1,40777491,1,63,0,63,622845
chr1,40777555,0.95,62,3,65,622846
chr1,40777558,0.88,52,7,59,622847
chr1,40777579,0.94,61,4,65,622848
chr1,40777741,0.95,52,3,55,622849
chr1,40777868,0.71,22,9,31,622850
chr1,40778059,0.31,24,53,77,622851
chr1,40778246,0.85,52,9,61,622852
chr1,40778272,0.86,43,7,50,622853
chr1,40778294,0.57,29,22,51,622854
chr1,40778323,0.82,42,9,51,622855
chr1,40778357,0.8,53,13,66,622856
chr1,40778377,0.9,64,7,71,622857
chr1,40778549,0.9,38,4,42,622858
chr1,40778724,0.63,60,35,95,622859
chr1,40778926,0.96,100,4,104,622860
chr1,40778989,0.99,88,1,89,622861
chr1,40778997,0.96,80,3,83,622862
chr1,40779037,0.97,62,2,64,622863
chr1,40779092,0.94,72,5,77,622864
chr1,40779132,0.96,89,4,93,622865
chr1,40779237,0.87,68,10,78,622866
chr1,40779525,0.86,30,5,35,622867
chr1,40779675,0.94,49,3,52,622868
chr1,40779859,0.87,39,6,45,622869
chr1,40779885,0.92,57,5,62,622870
chr1,40779894,0.87,58,9,67,622871
chr1,40779927,0.98,82,2,84,622872
chr1,40780024,0.62,39,24,63,622873
chr1,40780093,0.81,50,12,62,622874
chr1,40780137,0.95,58,3,61,622875
chr1,40780273,0.58,63,46,109,622876
chr1,40780396,0.23,20,66,86,622877
chr1,40780429,0.13,11,75,86,622878
chr1,40780445,0.5,35,35,70,622879
chr1,40780488,0.35,24,45,69,622880
chr1,40780607,0.07,4,55,59,622881
chr1,40780617,0.07,3,42,45,622882
chr1,40780676,0.14,8,48,56,622883
chr1,40780754,0.07,4,51,55,622884
chr1,40780765,0.02,1,54,55,622885
chr1,40780831,0.03,2,65,67,622886
chr1,40780845,0.06,4,66,70,622887
chr1,40780880,0.03,2,66,68,622888
chr1,40780905,0.03,2,58,60,622889
chr1,40780919,0.04,2,53,55,622890
chr1,40780956,0,0,34,34,622891
chr1,40781005,0,0,28,28,622892
chr1,40781017,0,0,26,26,622893
chr1,40781021,0,0,25,25,622894
chr1,40781024,0,0,19,19,622895
chr1,40781051,0,0,30,30,622896
chr1,40781054,0,0,23,23,622897
chr1,40781063,0.07,2,28,30,622898
chr1,40781070,0,0,35,35,622899
chr1,40781108,0,0,34,34,622900
chr1,40781111,0,0,33,33,622901
chr1,40781124,0,0,36,36,622902
chr1,40781129,0,0,31,31,622903
chr1,40781132,0,0,21,21,622904
chr1,40781135,0,0,29,29,622905
chr1,40781145,0,0,32,32,622906
chr1,40781148,0,0,37,37,622907
chr1,40781166,0,0,36,36,622908
chr1,40781175,0.02,1,40,41,622909
chr1,40781198,0,0,36,36,622910
chr1,40781224,0,0,15,15,622911
chr1,40781235,0,0,21,21,622912
chr1,40781261,0,0,50,50,622913
chr1,40781264,0,0,50,50,622914
chr1,40781270,0,0,51,51,622915
chr1,40781273,0.02,1,50,51,622916
chr1,40781289,0.04,2,53,55,622917
chr1,40781292,0,0,54,54,622918
chr1,40781298,0,0,63,63,622919
chr1,40781307,0.01,1,67,68,622920
chr1,40781317,0.02,1,46,47,622921
chr1,40781325,0,0,74,74,622922
chr1,40781351,0.01,1,82,83,622923
chr1,40781389,0.16,9,48,57,622924
chr1,40781395,0.01,1,110,111,622925
chr1,40781407,0.05,7,128,135,622926
chr1,40781419,0.08,5,55,60,622927
chr1,40781433,0.01,1,81,82,622928
chr1,40781444,0.04,3,82,85,622929
chr1,40781446,0.06,5,78,83,622930
chr1,40781456,0.04,3,77,80,622931
chr1,40781531,0.03,2,78,80,622932
chr1,40781538,0.08,5,55,60,622933
chr1,40781542,0.19,13,55,68,622934
chr1,40781550,0.06,5,79,84,622935
chr1,40781568,0.03,3,83,86,622936
chr1,40781587,0,0,91,91,622937
chr1,40781617,0,0,63,63,622938
chr1,40781620,0,0,58,58,622939
chr1,40781623,0.02,1,57,58,622940
chr1,40781634,0,0,45,45,622941
chr1,40781649,0,0,74,74,622942
chr1,40781680,0.02,1,65,66,622943
chr1,40781682,0.02,1,65,66,622944
chr1,40781686,0,0,64,64,622945
chr1,40781688,0,0,64,64,622946
chr1,40781708,0,0,74,74,622947
chr1,40781764,0,0,58,58,622948
chr1,40781778,0,0,60,60,622949
chr1,40781786,0,0,61,61,622950
chr1,40781802,0,0,46,46,622951
chr1,40781808,0,0,42,42,622952
chr1,40781824,0,0,26,26,622953
chr1,40781847,0,0,18,18,622954
chr1,40781857,0.05,1,18,19,622955
chr1,40781860,0,0,18,18,622956
chr1,40781877,0.2,1,4,5,622957
chr1,40781907,0.27,7,19,26,622958
chr1,40781926,0.11,4,33,37,622959
chr1,40781931,0.26,7,20,27,622960
chr1,40781939,0.06,2,34,36,622961
chr1,40781955,0.09,3,30,33,622962
chr1,40782004,0.16,6,32,38,622963
chr1,40782041,0,0,57,57,622964
chr1,40782114,0.06,3,51,54,622965
chr1,40782180,0.15,8,45,53,622966
chr1,40782202,0.02,1,55,56,622967
chr1,40782221,0.02,1,57,58,622968
chr1,40782230,0.02,1,57,58,622969
chr1,40782244,0,0,65,65,622970
chr1,40782246,0.03,2,67,69,622971
chr1,40782262,0.03,1,35,36,622972
chr1,40782267,0,0,70,70,622973
chr1,40782273,0,0,64,64,622974
chr1,40782279,0.02,1,63,64,622975
chr1,40782298,0,0,62,62,622976
chr1,40782302,0,0,62,62,622977
chr1,40782324,0,0,49,49,622978
chr1,40782326,0.02,1,43,44,622979
chr1,40782328,0,0,42,42,622980
chr1,40782332,0.02,1,47,48,622981
chr1,40782341,0,0,50,50,622982
chr1,40782344,0.02,1,42,43,622983
chr1,40782351,0,0,48,48,622984
chr1,40782362,0,0,42,42,622985
chr1,40782372,0,0,34,34,622986
chr1,40782382,0,0,35,35,622987
chr1,40782390,0,0,25,25,622988
chr1,40782395,0.03,1,38,39,622989
chr1,40782400,0,0,23,23,622990
chr1,40782406,0,0,37,37,622991
chr1,40782409,0,0,32,32,622992
chr1,40782423,0,0,31,31,622993
chr1,40782426,0,0,15,15,622994
chr1,40782440,0,0,18,18,622995
chr1,40782443,0.05,1,18,19,622996
chr1,40782449,0,0,18,18,622997
chr1,40782458,0,0,28,28,622998
chr1,40782463,0,0,33,33,622999
chr1,40782490,0,0,35,35,623000
chr1,40782506,0,0,54,54,623001
chr1,40782520,0,0,63,63,623002
chr1,40782524,0,0,35,35,623003
chr1,40782541,0,0,67,67,623004
chr1,40782553,0,0,71,71,623005
chr1,40782558,0,0,69,69,623006
chr1,40782563,0,0,61,61,623007
chr1,40782565,0,0,65,65,623008
chr1,40782567,0,0,65,65,623009
chr1,40782577,0.02,1,54,55,623010
chr1,40782584,0.02,1,64,65,623011
chr1,40782596,0,0,66,66,623012
chr1,40782617,0,0,58,58,623013
chr1,40782623,0.02,1,54,55,623014
chr1,40782625,0.02,1,57,58,623015
chr1,40782650,0,0,61,61,623016
chr1,40782664,0.02,1,58,59,623017
chr1,40782666,0.02,1,62,63,623018
chr1,40782669,0.02,1,53,54,623019
chr1,40782690,0.03,2,65,67,623020
chr1,40782711,0.02,1,57,58,623021
chr1,40782713,0.05,3,58,61,623022
chr1,40782740,0,0,64,64,623023
chr1,40782754,0,0,63,63,623024
chr1,40782774,0.06,3,50,53,623025
chr1,40782785,0.09,5,53,58,623026
chr1,40782801,0.04,2,46,48,623027
chr1,40782809,0.1,4,38,42,623028
chr1,40782844,0,0,49,49,623029
chr1,40782855,0,0,40,40,623030
chr1,40782860,0,0,46,46,623031
chr1,40782863,0,0,33,33,623032
chr1,40782876,0.03,1,32,33,623033
chr1,40782879,0,0,27,27,623034
chr1,40782894,0,0,35,35,623035
chr1,40782900,0,0,29,29,623036
chr1,40782906,0.03,1,35,36,623037
chr1,40782908,0.03,1,34,35,623038
chr1,40782912,0,0,34,34,623039
chr1,40782917,0,0,37,37,623040
chr1,40782920,0,0,38,38,623041
chr1,40782933,0,0,35,35,623042
chr1,40782936,0,0,23,23,623043
chr1,40782947,0,0,28,28,623044
chr1,40782958,0,0,30,30,623045
chr1,40782960,0,0,28,28,623046
chr1,40782991,0,0,25,25,623047
chr1,40782998,0.07,1,13,14,623048
chr1,40783003,0.06,1,16,17,623049
chr1,40783010,0,0,21,21,623050
chr1,40783013,0.04,1,23,24,623051
chr1,40783036,0.06,2,32,34,623052
chr1,40783039,0.1,2,19,21,623053
chr1,40783048,0.06,2,33,35,623054
chr1,40783060,0.03,1,33,34,623055
chr1,40783063,0.18,4,18,22,623056
chr1,40783080,0.39,16,25,41,623057
chr1,40783085,0.15,6,34,40,623058
chr1,40783089,0.09,4,40,44,623059
chr1,40783104,0.37,13,22,35,623060
chr1,40783121,0.11,4,32,36,623061
chr1,40783128,0.46,11,13,24,623062
chr1,40783132,0.26,9,25,34,623063
chr1,40783139,0.31,9,20,29,623064
chr1,40783144,0.32,10,21,31,623065
chr1,40783185,0.19,4,17,21,623066
chr1,40783201,0.24,5,16,21,623067
chr1,40783234,0.6,18,12,30,623068
chr1,40783264,0.63,24,14,38,623069
chr1,40783285,0.71,32,13,45,623070
chr1,40783296,0.66,31,16,47,623071
chr1,40783335,1,54,0,54,623072
chr1,40783433,0.38,33,55,88,623073
chr1,40783452,0.71,55,23,78,623074
chr1,40783500,0.87,79,12,91,623075
chr1,40783515,0.97,87,3,90,623076
chr1,40783590,0.86,78,13,91,623077
chr1,40783785,0.92,73,6,79,623078
chr1,40783792,0.97,86,3,89,623079
chr1,40783809,0.88,74,10,84,623080
chr1,40784034,0.97,57,2,59,623081
chr1,40784056,0.96,74,3,77,623082
chr1,40784061,0.91,75,7,82,623083
chr1,40784063,0.96,77,3,80,623084
chr1,40784095,0.85,79,14,93,623085
chr1,40784167,0.99,88,1,89,623086
chr1,40784260,0.84,86,16,102,623087
chr1,40784323,0.95,106,5,111,623088
chr1,40784338,0.78,93,26,119,623089
chr1,40784971,0.97,71,2,73,623090
chr1,40785084,0.97,75,2,77,623091
chr1,40785093,0.91,72,7,79,623092
chr1,40785254,0.96,67,3,70,623093
chr1,40785439,0.6,39,26,65,623094
chr1,40785464,0.99,89,1,90,623095
chr1,40785481,0.91,75,7,82,623096
chr1,40785523,0.94,77,5,82,623097
chr1,40785527,0.97,76,2,78,623098
chr1,40785539,0.89,71,9,80,623099
chr1,40785598,0.97,58,2,60,623100
chr1,40785619,0.98,46,1,47,623101
chr1,40785623,0.96,46,2,48,623102
chr1,40785628,0.94,48,3,51,623103
chr1,40785639,1,43,0,43,623104
chr1,40785682,1,43,0,43,623105
chr1,40785684,1,41,0,41,623106
chr1,40785895,0.95,61,3,64,623107
chr1,40785987,0.88,35,5,40,623108
chr1,40786011,1,44,0,44,623109
chr1,40786043,0.8,24,6,30,623110
chr1,40786063,1,33,0,33,623111
chr1,40786170,0.81,46,11,57,623112
chr1,40786198,0.76,48,15,63,623113
chr1,40786204,0.92,58,5,63,623114
chr1,40786512,0.92,78,7,85,623115
chr1,40786540,0.95,84,4,88,623116
chr1,40786564,0.71,59,24,83,623117
chr1,40786630,0.83,44,9,53,623118
chr1,40786715,0.97,35,1,36,623119
chr1,40786731,0.93,27,2,29,623120
chr1,40787373,0.84,49,9,58,623121
chr1,40787971,0.96,99,4,103,623122
chr1,40788106,0.94,75,5,80,623123
chr1,40788199,0.98,63,1,64,623124
chr1,40788201,0.95,61,3,64,623125
chr1,40788211,0.95,54,3,57,623126
chr1,40788248,0.93,57,4,61,623127
chr1,40788388,0.97,57,2,59,623128
chr1,40788422,0.87,47,7,54,623129
chr1,40788430,0.98,50,1,51,623130
chr1,40788452,0.93,39,3,42,623131
chr1,40788461,0.95,37,2,39,623132
chr1,40788647,0.95,83,4,87,623133
chr1,40788699,0.66,47,24,71,623134
chr1,40788709,0.84,53,10,63,623135
chr1,40788915,0.89,64,8,72,623136
chr1,40788928,0.92,67,6,73,623137
chr1,40788969,0.69,51,23,74,623138
chr1,40789392,0.83,62,13,75,623139
chr1,40789413,0.83,69,14,83,623140
chr1,40789502,0.73,69,26,95,623141
chr1,40789511,0.77,71,21,92,623142
chr1,40789640,0.55,52,43,95,623143
chr1,40789789,0.91,87,9,96,623144
chr1,40789799,0.93,98,7,105,623145
chr1,40789854,0.85,83,15,98,623146
chr1,40789927,0.76,74,24,98,623147
chr1,40790135,0.88,65,9,74,623148
chr1,40790245,0.79,50,13,63,623149
chr1,40790280,0.9,61,7,68,623150
chr1,40790291,0.95,62,3,65,623151
chr1,40790361,0.89,39,5,44,623152
chr1,40790415,0.94,48,3,51,623153
chr1,40790469,0.82,88,19,107,623154
chr1,40790565,0.92,47,4,51,623155
chr1,40790596,0.91,29,3,32,623156
chr1,40790621,0.93,28,2,30,623157
chr1,40790664,0.98,43,1,44,623158
chr1,40790666,0.98,45,1,46,623159
chr1,40790670,0.93,42,3,45,623160
chr1,40790674,0.93,43,3,46,623161
chr1,40790959,0.97,65,2,67,623162
chr1,40791108,0.73,29,11,40,623163
chr1,40791194,0.92,67,6,73,623164
chr1,40791200,0.97,77,2,79,623165
chr1,40791208,0.97,85,3,88,623166
chr1,40791224,0.96,100,4,104,623167
chr1,40791243,0.96,112,5,117,623168
chr1,40791304,0.95,105,5,110,623169
chr1,40791321,0.98,90,2,92,623170
chr1,40791352,0.96,66,3,69,623171
chr1,40791375,0.98,49,1,50,623172
chr1,40791379,0.99,66,1,67,623173
chr1,40791384,0.96,75,3,78,623174
chr1,40791412,0.94,80,5,85,623175
chr1,40791452,0.98,80,2,82,623176
chr1,40791456,0.96,74,3,77,623177
chr1,40791458,0.96,79,3,82,623178
chr1,40791496,0.91,52,5,57,623179
chr1,40791526,0.81,34,8,42,623180
chr1,40791546,0.83,29,6,35,623181
chr1,40791557,0.89,33,4,37,623182
chr1,40791590,0.93,41,3,44,623183
chr1,40791602,1,36,0,36,623184
chr1,40791646,1,45,0,45,623185
chr1,40791661,1,50,0,50,623186
chr1,40791684,0.96,50,2,52,623187
chr1,40791686,0.92,46,4,50,623188
chr1,40791711,0.77,49,15,64,623189
chr1,40791719,0.94,67,4,71,623190
chr1,40791771,0.63,55,33,88,623191
chr1,40791955,0.69,42,19,61,623192
chr1,40791960,0.8,48,12,60,623193
chr1,40791971,0.59,27,19,46,623194
chr1,40792092,0.94,61,4,65,623195
chr1,40792122,0.88,67,9,76,623196
chr1,40792151,0.86,77,13,90,623197
chr1,40792414,1,102,0,102,623198
chr1,40792460,0.93,94,7,101,623199
chr1,40792612,0.92,112,10,122,623200
chr1,40792660,0.86,92,15,107,623201
chr1,40792692,0.97,59,2,61,623202
chr1,40792732,0.97,36,1,37,623203
chr1,40792738,0.94,34,2,36,623204
chr1,40792755,0.97,34,1,35,623205
chr1,40792818,0.97,74,2,76,623206
chr1,40792873,0.93,77,6,83,623207
chr1,40792923,0.96,72,3,75,623208
chr1,40792961,0.93,66,5,71,623209
chr1,40792971,0.96,72,3,75,623210
chr1,40792977,0.93,67,5,72,623211
chr1,40793232,0.98,103,2,105,623212
chr1,40793435,0.98,82,2,84,623213
chr1,40793683,0.98,50,1,51,623214
chr1,40793809,0.99,80,1,81,623215
chr1,40793867,0.84,46,9,55,623216
chr1,40794128,0.37,27,46,73,623217
chr1,40794160,0.29,26,65,91,623218
chr1,40794192,0.55,46,37,83,623219
chr1,40794214,0.9,71,8,79,623220
chr1,40794266,0.63,48,28,76,623221
chr1,40794314,0.87,65,10,75,623222
chr1,40794327,0.85,60,11,71,623223
chr1,40794369,0.82,56,12,68,623224
chr1,40794540,0.94,94,6,100,623225
chr1,40794580,0.79,81,22,103,623226
chr1,40794750,0.87,80,12,92,623227
chr1,40794794,0.84,65,12,77,623228
chr1,40794870,0.8,39,10,49,623229
chr1,40794986,0.95,75,4,79,623230
chr1,40795003,0.98,79,2,81,623231
chr1,40795026,0.97,67,2,69,623232
chr1,40795059,0.92,61,5,66,623233
chr1,40795115,0.95,83,4,87,623234
chr1,40795787,0.84,76,15,91,623235
chr1,40795969,0.88,77,11,88,623236
chr1,40795987,0.98,86,2,88,623237
chr1,40796156,0.91,62,6,68,623238
chr1,40796229,0.94,99,6,105,623239
chr1,40796365,0.86,88,14,102,623240
chr1,40796937,0.75,44,15,59,623241
chr1,40797074,0.46,38,44,82,623242
chr1,40797398,0.59,33,23,56,623243
chr1,40797494,0.82,37,8,45,623244
chr1,40797526,0.8,20,5,25,623245
chr1,40797571,0.87,13,2,15,623246
chr1,40797582,0.95,37,2,39,623247
chr1,40797615,0.99,67,1,68,623248
chr1,40797627,0.93,67,5,72,623249
chr1,40797672,0.94,85,5,90,623250
chr1,40798042,1,81,0,81,623251
chr1,40798110,0.73,60,22,82,623252
chr1,40798213,0.98,40,1,41,623253
chr1,40798261,0.94,46,3,49,623254
chr1,40798718,0.86,54,9,63,623255
chr1,40798848,0.85,83,15,98,623256
chr1,40798908,0.77,61,18,79,623257
chr1,40798926,0.93,83,6,89,623258
chr1,40799136,0.92,36,3,39,623259
chr1,40799196,0.94,50,3,53,623260
chr1,40799236,1,58,0,58,623261
chr1,40799254,0.97,73,2,75,623262
chr1,40799264,0.94,73,5,78,623263
chr1,40799363,0.94,109,7,116,623264
chr1,40799505,0.88,73,10,83,623265
chr1,40799766,0.89,50,6,56,623266
chr1,40799883,0.89,62,8,70,623267
chr1,40799910,1,79,0,79,623268
chr1,40799922,1,79,0,79,623269
chr1,40799955,0.95,72,4,76,623270
chr1,40799959,0.96,72,3,75,623271
chr1,40800183,0.93,97,7,104,623272
chr1,40800217,0.87,77,12,89,623273
chr1,40800381,0.78,80,22,102,623274
chr1,40800398,0.93,93,7,100,623275
chr1,40800482,0.53,62,54,116,623276
chr1,40800513,0.73,80,30,110,623277
chr1,40800819,0.86,77,13,90,623278
chr1,40800871,0.87,58,9,67,623279
chr1,40800873,0.84,58,11,69,623280
chr1,40800883,0.7,48,21,69,623281
chr1,40800974,0.89,56,7,63,623282
chr1,40801006,0.97,66,2,68,623283
chr1,40801046,0.89,66,8,74,623284
chr1,40801059,0.94,79,5,84,623285
chr1,40801079,1,85,0,85,623286
chr1,40801095,0.97,93,3,96,623287
chr1,40801126,0.91,94,9,103,623288
chr1,40801134,0.72,78,31,109,623289
chr1,40801162,0.93,99,8,107,623290
chr1,40801415,0.95,73,4,77,623291
chr1,40801540,0.9,60,7,67,623292
chr1,40801731,0.46,40,47,87,623293
chr1,40801902,0.91,60,6,66,623294
chr1,40801924,0.96,77,3,80,623295
chr1,40801942,0.98,79,2,81,623296
chr1,40801995,0.96,64,3,67,623297
chr1,40802085,0.97,37,1,38,623298
chr1,40802090,1,41,0,41,623299
chr1,40802118,0.97,56,2,58,623300
chr1,40802130,1,55,0,55,623301
chr1,40802134,0.91,50,5,55,623302
chr1,40802138,0.94,58,4,62,623303
chr1,40802190,0.93,43,3,46,623304
chr1,40802231,0.93,43,3,46,623305
chr1,40802237,0.94,45,3,48,623306
chr1,40802261,0.91,61,6,67,623307
chr1,40802271,0.96,65,3,68,623308
chr1,40802293,0.84,62,12,74,623309
chr1,40802403,0.93,70,5,75,623310
chr1,40802419,0.95,71,4,75,623311
chr1,40802708,0.84,61,12,73,623312
chr1,40802788,0.95,84,4,88,623313
chr1,40802861,0.93,80,6,86,623314
chr1,40802888,0.92,96,8,104,623315
chr1,40802921,0.9,91,10,101,623316
chr1,40802933,0.96,100,4,104,623317
chr1,40802971,0.86,84,14,98,623318
chr1,40803057,0.63,43,25,68,623319
chr1,40803213,0.63,26,15,41,623320
chr1,40803234,0.71,30,12,42,623321
chr1,40803285,0.95,71,4,75,623322
chr1,40803291,0.88,72,10,82,623323
chr1,40803351,0.93,103,8,111,623324
chr1,40803363,0.92,101,9,110,623325
chr1,40803367,0.9,103,11,114,623326
chr1,40803386,0.82,101,22,123,623327
chr1,40803575,0.89,72,9,81,623328
chr1,40803582,0.68,54,25,79,623329
chr1,40803687,0.97,61,2,63,623330
chr1,40803729,0.85,53,9,62,623331
chr1,40803973,0.97,61,2,63,623332
chr1,40804145,0.9,55,6,61,623333
chr1,40804153,0.83,59,12,71,623334
chr1,40804175,0.88,78,11,89,623335
chr1,40804242,0.59,44,30,74,623336
chr1,40804246,0.55,46,37,83,623337
chr1,40804274,0.37,26,45,71,623338
chr1,40804305,0.53,31,27,58,623339
chr1,40804362,0.71,39,16,55,623340
chr1,40804365,0.64,32,18,50,623341
chr1,40804374,0.24,12,37,49,623342
chr1,40804377,0.46,19,22,41,623343
chr1,40804381,0.17,9,43,52,623344
chr1,40804420,0,0,37,37,623345
chr1,40804436,0.14,5,31,36,623346
chr1,40804512,0.02,1,54,55,623347
chr1,40804554,0,0,64,64,623348
chr1,40804574,0,0,99,99,623349
chr1,40804606,0,0,108,108,623350
chr1,40804640,0,0,89,89,623351
chr1,40804650,0,0,99,99,623352
chr1,40804687,0.01,1,67,68,623353
chr1,40804699,0,0,71,71,623354
chr1,40804884,0.2,18,73,91,623355
chr1,40804903,0.56,56,44,100,623356
chr1,40804919,0.19,19,80,99,623357
chr1,40804945,0.41,39,55,94,623358
chr1,40804953,0.8,78,20,98,623359
chr1,40804975,0.88,82,11,93,623360
chr1,40805007,0.8,79,20,99,623361
chr1,40805017,0.84,82,16,98,623362
chr1,40805059,0.81,63,15,78,623363
chr1,40805063,0.76,68,21,89,623364
chr1,40805075,0.59,57,39,96,623365
chr1,40805199,0.3,14,32,46,623366
chr1,40805251,0.17,10,50,60,623367
chr1,40805521,0.63,55,33,88,623368
chr1,40805684,0.88,91,13,104,623369
chr1,40805926,0.82,76,17,93,623370
chr1,40805939,0.91,83,8,91,623371
chr1,40806349,0.99,78,1,79,623372
chr1,40806366,0.97,101,3,104,623373
chr1,40806437,0.74,75,26,101,623374
chr1,40806468,0.8,67,17,84,623375
chr1,40806479,0.8,72,18,90,623376
chr1,40806528,0.84,62,12,74,623377
chr1,40806571,0.84,54,10,64,623378
chr1,40806575,0.79,46,12,58,623379
chr1,40806794,0.79,88,24,112,623380
chr1,40806840,0.89,111,14,125,623381
chr1,40806989,0.76,68,21,89,623382
chr1,40807027,0.9,61,7,68,623383
chr1,40807033,0.93,63,5,68,623384
chr1,40807398,0.77,72,22,94,623385
chr1,40807453,0.89,83,10,93,623386
chr1,40807466,0.78,67,19,86,623387
chr1,40807818,0.85,44,8,52,623388
chr1,40807916,0.75,66,22,88,623389
chr1,40807973,0.38,44,71,115,623390
chr1,40808228,0.94,44,3,47,623391
chr1,40808234,0.92,47,4,51,623392
chr1,40808322,0.96,72,3,75,623393
chr1,40808411,0.94,50,3,53,623394
chr1,40808460,0.96,54,2,56,623395
chr1,40808594,0.86,68,11,79,623396
chr1,40808636,0.93,94,7,101,623397
chr1,40808868,0.76,68,21,89,623398
chr1,40808963,0.91,67,7,74,623399
chr1,40809009,0.91,64,6,70,623400
chr1,40809040,0.91,63,6,69,623401
chr1,40809126,0.92,23,2,25,623402
chr1,40809136,0.92,23,2,25,623403
chr1,40809143,1,21,0,21,623404
chr1,40809160,0.92,24,2,26,623405
chr1,40809168,1,25,0,25,623406
chr1,40809197,1,47,0,47,623407
chr1,40809205,0.98,52,1,53,623408
chr1,40809311,0.92,65,6,71,623409
chr1,40809320,0.92,66,6,72,623410
chr1,40809337,0.69,50,22,72,623411
chr1,40809669,0.62,36,22,58,623412
chr1,40809740,0.96,27,1,28,623413
chr1,40809838,0.58,51,37,88,623414
chr1,40809966,0.74,67,24,91,623415
chr1,40810118,0.62,63,39,102,623416
chr1,40810189,0.71,72,30,102,623417
chr1,40810194,0.66,63,32,95,623418
chr1,40810291,0.26,29,83,112,623419
chr1,40810365,0.07,8,106,114,623420
chr1,40810414,0.01,1,90,91,623421
chr1,40810467,0.15,4,23,27,623422
chr1,40810484,0,0,64,64,623423
chr1,40810553,0,0,71,71,623424
chr1,40810846,0.81,60,14,74,623425
chr1,40811019,0.9,37,4,41,623426
chr1,40811108,0.8,45,11,56,623427
chr1,40811350,0.86,95,15,110,623428
chr1,40811443,0.81,66,15,81,623429
chr1,40811857,0.91,89,9,98,623430
chr1,40812084,0.68,52,24,76,623431
chr1,40812134,0.86,67,11,78,623432
chr1,40812166,0.95,82,4,86,623433
chr1,40812646,0.91,73,7,80,623434
chr1,40812666,0.81,66,15,81,623435
chr1,40812740,0.7,28,12,40,623436
chr1,40812770,0.89,54,7,61,623437
chr1,40812784,0.91,60,6,66,623438
chr1,40812818,0.93,75,6,81,623439
chr1,40812870,0.78,31,9,40,623440
chr1,40812964,0.38,11,18,29,623441
chr1,40812982,0.88,36,5,41,623442
chr1,40813445,0.81,74,17,91,623443
chr1,40813734,0.64,49,28,77,623444
chr1,40813789,0.95,79,4,83,623445
chr1,40814104,0.86,65,11,76,623446
chr1,40814132,0.78,49,14,63,623447
chr1,40814184,0.63,38,22,60,623448
chr1,40814235,0.67,46,23,69,623449
chr1,40814263,0.75,54,18,72,623450
chr1,40814305,1,58,0,58,623451
chr1,40814308,1,64,0,64,623452
chr1,40814481,0.86,38,6,44,623453
chr1,40814545,0.91,58,6,64,623454
chr1,40814567,0.59,43,30,73,623455
chr1,40814693,0.9,46,5,51,623456
chr1,40814717,0.93,53,4,57,623457
chr1,40814721,0.95,55,3,58,623458
chr1,40814899,0.81,66,15,81,623459
chr1,40814954,0.9,76,8,84,623460
chr1,40814976,0.95,74,4,78,623461
chr1,40815074,0.97,98,3,101,623462
chr1,40815165,0.92,90,8,98,623463
chr1,40815300,0.94,99,6,105,623464
chr1,40815315,0.87,82,12,94,623465
chr1,40815337,0.91,74,7,81,623466
chr1,40815442,0.93,63,5,68,623467
chr1,40815470,0.92,68,6,74,623468
chr1,40815696,0.89,75,9,84,623469
chr1,40816041,0.97,114,3,117,623470
chr1,40816047,0.87,102,15,117,623471
chr1,40816079,0.95,114,6,120,623472
chr1,40816158,0.86,95,16,111,623473
chr1,40816719,0.72,78,31,109,623474
chr1,40816803,0.95,69,4,73,623475
chr1,40816866,0.84,37,7,44,623476
chr1,40817013,0.83,68,14,82,623477
chr1,40817231,0.92,66,6,72,623478
chr1,40817239,0.95,72,4,76,623479
chr1,40817278,0.96,75,3,78,623480
chr1,40817287,0.96,68,3,71,623481
chr1,40817299,0.93,65,5,70,623482
chr1,40817320,0.98,62,1,63,623483
chr1,40817336,0.97,57,2,59,623484
chr1,40817388,0.87,61,9,70,623485
chr1,40817393,0.99,70,1,71,623486
chr1,40817463,0.95,73,4,77,623487
chr1,40817465,0.97,72,2,74,623488
chr1,40817529,0.93,75,6,81,623489
chr1,40817561,0.92,76,7,83,623490
chr1,40817599,0.93,91,7,98,623491
chr1,40817684,0.89,75,9,84,623492
chr1,40817960,0.88,52,7,59,623493
chr1,40818102,0.87,87,13,100,623494
chr1,40818135,0.83,87,18,105,623495
chr1,40818396,0.9,89,10,99,623496
chr1,40818437,0.97,112,3,115,623497
chr1,40818493,0.86,79,13,92,623498
chr1,40818495,0.95,84,4,88,623499
chr1,40818498,0.57,43,33,76,623500
chr1,40818555,0.74,55,19,74,623501
chr1,40818639,0.81,59,14,73,623502
chr1,40818664,0.32,25,54,79,623503
chr1,40818711,0.85,67,12,79,623504
chr1,40818859,0.82,81,18,99,623505
chr1,40819126,0.96,79,3,82,623506
chr1,40819133,0.94,72,5,77,623507
chr1,40819201,0.86,50,8,58,623508
chr1,40819261,0.67,33,16,49,623509
chr1,40819552,0.79,77,20,97,623510
chr1,40820043,0.96,68,3,71,623511
chr1,40820051,0.92,60,5,65,623512
chr1,40820073,0.93,57,4,61,623513
chr1,40820081,0.91,51,5,56,623514
chr1,40820096,0.71,34,14,48,623515
chr1,40820103,0.98,47,1,48,623516
chr1,40820135,0.89,25,3,28,623517
chr1,40820155,0.96,26,1,27,623518
chr1,40820260,0.9,85,9,94,623519
chr1,40820288,1,95,0,95,623520
chr1,40820298,0.89,91,11,102,623521
chr1,40820509,0.8,37,9,46,623522
chr1,40820517,0.65,30,16,46,623523
chr1,40820548,0.88,63,9,72,623524
chr1,40820606,0.87,46,7,53,623525
chr1,40820702,0.86,25,4,29,623526
chr1,40820903,0.93,67,5,72,623527
chr1,40821024,0.88,75,10,85,623528
chr1,40821204,0.9,77,9,86,623529
chr1,40821316,0.88,52,7,59,623530
chr1,40821357,0.94,60,4,64,623531
chr1,40821470,0.63,51,30,81,623532
chr1,40821519,0.56,39,31,70,623533
chr1,40821626,0.84,75,14,89,623534
chr1,40821873,0.92,84,7,91,623535
chr1,40821983,0.95,89,5,94,623536
chr1,40822113,0.67,16,8,24,623537
chr1,40822121,0.87,20,3,23,623538
chr1,40822143,0.81,21,5,26,623539
chr1,40822175,0.76,38,12,50,623540
chr1,40822272,0.92,55,5,60,623541
chr1,40822303,0.98,60,1,61,623542
chr1,40822324,0.95,54,3,57,623543
chr1,40822328,0.92,56,5,61,623544
chr1,40822361,0.89,51,6,57,623545
chr1,40822371,0.8,47,12,59,623546
chr1,40822461,0.84,67,13,80,623547
chr1,40822497,0.71,45,18,63,623548
chr1,40822924,0.34,27,53,80,623549
chr1,40822995,0.95,76,4,80,623550
chr1,40823113,0.7,38,16,54,623551
chr1,40823275,0.51,48,47,95,623552
chr1,40823744,0.7,65,28,93,623553
chr1,40823936,0.85,88,15,103,623554
chr1,40824012,0.93,87,7,94,623555
chr1,40824030,0.78,74,21,95,623556
chr1,40824076,0.94,82,5,87,623557
chr1,40824147,0.97,62,2,64,623558
chr1,40824194,0.95,53,3,56,623559
chr1,40824370,0.92,89,8,97,623560
chr1,40824412,0.9,86,10,96,623561
chr1,40824921,0.97,83,3,86,623562
chr1,40824963,0.91,71,7,78,623563
chr1,40824994,0.88,66,9,75,623564
chr1,40825064,0.97,60,2,62,623565
chr1,40825447,0.99,86,1,87,623566
chr1,40825614,0.87,68,10,78,623567
chr1,40825709,1,17,0,17,623568
chr1,40825741,0.95,20,1,21,623569
chr1,40825747,0.81,17,4,21,623570
chr1,40825764,1,22,0,22,623571
chr1,40825839,0.98,40,1,41,623572
chr1,40825868,1,31,0,31,623573
chr1,40825899,0.93,26,2,28,623574
chr1,40825920,0.97,29,1,30,623575
chr1,40825929,0.93,28,2,30,623576
chr1,40825957,0.85,29,5,34,623577
chr1,40825967,0.94,31,2,33,623578
chr1,40826131,0.92,76,7,83,623579
chr1,40826226,0.99,75,1,76,623580
chr1,40826996,0.92,100,9,109,623581
chr1,40827297,0.82,68,15,83,623582
chr1,40827373,0.86,85,14,99,623583
chr1,40827525,0.84,81,15,96,623584
chr1,40827629,0.89,79,10,89,623585
chr1,40827706,0.94,73,5,78,623586
chr1,40827787,0.84,51,10,61,623587
chr1,40827830,0.98,46,1,47,623588
chr1,40827905,0.65,24,13,37,623589
chr1,40828081,0.91,83,8,91,623590
chr1,40828443,0.67,50,25,75,623591
chr1,40828599,0.63,54,32,86,623592
chr1,40829428,0.42,25,34,59,623593
chr1,40829600,0.25,23,68,91,623594
chr1,40830194,0.97,71,2,73,623595
chr1,40830288,0.91,93,9,102,623596
chr1,40830348,0.87,77,12,89,623597
chr1,40830370,0.9,74,8,82,623598
chr1,40830499,0.9,86,10,96,623599
chr1,40830730,0.9,77,9,86,623600
chr1,40830829,0.75,71,24,95,623601
chr1,40830843,0.73,69,25,94,623602
chr1,40831199,0.92,98,8,106,623603
chr1,40831219,0.86,86,14,100,623604
chr1,40831235,0.89,88,11,99,623605
chr1,40831252,0.87,78,12,90,623606
chr1,40831258,0.95,83,4,87,623607
chr1,40831261,0.92,82,7,89,623608
chr1,40831271,0.94,79,5,84,623609
chr1,40831486,0.85,17,3,20,623610
chr1,40831536,0.67,4,2,6,623611
chr1,40831744,1,14,0,14,623612
chr1,40831749,1,21,0,21,623613
chr1,40831804,0.53,31,28,59,623614
chr1,40832375,1,1,0,1,623615
chr1,40832399,1,1,0,1,623616
chr1,40833929,0.86,6,1,7,623617
chr1,40835063,0.86,6,1,7,623618
chr1,40835218,1,7,0,7,623619
chr1,40835221,1,6,0,6,623620
chr1,40836384,0,0,4,4,623621
chr1,40836398,0.75,3,1,4,623622
chr1,40836451,0,0,2,2,623623
chr1,40836572,0.88,44,6,50,623624
chr1,40836574,0.49,24,25,49,623625
chr1,40836621,0.93,52,4,56,623626
chr1,40836628,0.84,49,9,58,623627
chr1,40836715,0.67,42,21,63,623628
chr1,40836776,0.91,53,5,58,623629
chr1,40836793,0.41,31,44,75,623630
chr1,40836799,0.7,45,19,64,623631
chr1,40836822,0.49,35,36,71,623632
chr1,40836830,0.46,35,41,76,623633
chr1,40836837,0.29,27,65,92,623634
chr1,40837411,0.89,95,12,107,623635
chr1,40837434,0.91,103,10,113,623636
chr1,40837822,0.08,7,83,90,623637
chr1,40837929,0.94,67,4,71,623638
chr1,40837978,0.8,49,12,61,623639
chr1,40838477,0.52,45,42,87,623640
chr1,40838541,0.55,46,37,83,623641
chr1,40838645,0.79,59,16,75,623642
chr1,40838740,0.01,1,73,74,623643
chr1,40838769,0.17,15,72,87,623644
chr1,40838941,0.06,5,81,86,623645
chr1,40839057,0.13,7,49,56,623646
chr1,40839093,0.12,6,44,50,623647
chr1,40839112,0.04,2,45,47,623648
chr1,40839216,0.04,1,23,24,623649
chr1,40839225,0,0,17,17,623650
chr1,40839244,0,0,13,13,623651
chr1,40839261,0,0,16,16,623652
chr1,40839268,0,0,32,32,623653
chr1,40839278,0,0,35,35,623654
chr1,40839290,0,0,41,41,623655
chr1,40839297,0.04,1,27,28,623656
chr1,40839321,0,0,40,40,623657
chr1,40839324,0.03,1,31,32,623658
chr1,40839326,0.06,2,32,34,623659
chr1,40839335,0,0,11,11,623660
chr1,40839340,0.07,1,13,14,623661
chr1,40839346,0,0,42,42,623662
chr1,40839348,0,0,41,41,623663
chr1,40839385,0,0,31,31,623664
chr1,40839395,0,0,24,24,623665
chr1,40839410,0,0,26,26,623666
chr1,40839419,0,0,34,34,623667
chr1,40839438,0.03,1,28,29,623668
chr1,40839443,0,0,18,18,623669
chr1,40839445,0,0,22,22,623670
chr1,40839450,0,0,28,28,623671
chr1,40839470,0,0,37,37,623672
chr1,40839488,0,0,36,36,623673
chr1,40839492,0,0,38,38,623674
chr1,40839508,0.03,1,37,38,623675
chr1,40839515,0,0,38,38,623676
chr1,40839546,0.02,1,44,45,623677
chr1,40839564,0,0,21,21,623678
chr1,40839582,0,0,46,46,623679
chr1,40839592,0.05,1,20,21,623680
chr1,40839595,0,0,40,40,623681
chr1,40839597,0,0,34,34,623682
chr1,40839600,0,0,47,47,623683
chr1,40839610,0,0,37,37,623684
chr1,40839622,0,0,35,35,623685
chr1,40839626,0,0,28,28,623686
chr1,40839632,0,0,38,38,623687
chr1,40839637,0,0,40,40,623688
chr1,40839647,0,0,17,17,623689
chr1,40839651,0,0,36,36,623690
chr1,40839654,0,0,28,28,623691
chr1,40839660,0,0,33,33,623692
chr1,40839679,0,0,35,35,623693
chr1,40839700,0.04,1,23,24,623694
chr1,40839708,0,0,41,41,623695
chr1,40839724,0.02,1,44,45,623696
chr1,40839750,0,0,28,28,623697
chr1,40839759,0,0,24,24,623698
chr1,40839761,0,0,33,33,623699
chr1,40839777,0,0,51,51,623700
chr1,40839780,0,0,58,58,623701
chr1,40839806,0,0,66,66,623702
chr1,40839816,0,0,66,66,623703
chr1,40839823,0,0,67,67,623704
chr1,40839900,0,0,54,54,623705
chr1,40839914,0,0,57,57,623706
chr1,40839931,0.02,1,59,60,623707
chr1,40839933,0,0,64,64,623708
chr1,40839936,0,0,65,65,623709
chr1,40839957,0,0,46,46,623710
chr1,40839967,0,0,28,28,623711
chr1,40839986,0,0,56,56,623712
chr1,40839995,0,0,63,63,623713
chr1,40840012,0,0,68,68,623714
chr1,40840014,0,0,68,68,623715
chr1,40840021,0,0,69,69,623716
chr1,40840080,0.02,1,59,60,623717
chr1,40840086,0,0,23,23,623718
chr1,40840101,0.04,2,55,57,623719
chr1,40840124,0,0,49,49,623720
chr1,40840142,0.02,1,43,44,623721
chr1,40840193,0,0,59,59,623722
chr1,40840252,0,0,50,50,623723
chr1,40840256,0,0,49,49,623724
chr1,40840260,0,0,44,44,623725
chr1,40840264,0,0,43,43,623726
chr1,40840268,0,0,38,38,623727
chr1,40840319,0,0,37,37,623728
chr1,40840348,0.02,1,40,41,623729
chr1,40840520,0.03,3,100,103,623730
chr1,40840557,0.01,1,99,100,623731
chr1,40840595,0.03,3,90,93,623732
chr1,40840619,0.18,18,84,102,623733
chr1,40840650,0.52,65,61,126,623734
chr1,40840673,0.62,79,48,127,623735
chr1,40840923,0.88,67,9,76,623736
chr1,40840949,0.96,73,3,76,623737
chr1,40840999,0.9,74,8,82,623738
chr1,40841006,0.98,84,2,86,623739
chr1,40841047,0.9,77,9,86,623740
chr1,40841653,0.97,71,2,73,623741
chr1,40841661,0.91,61,6,67,623742
chr1,40841691,0.96,52,2,54,623743
chr1,40841715,0.94,46,3,49,623744
chr1,40841747,0.9,37,4,41,623745
chr1,40841767,0.98,46,1,47,623746
chr1,40841771,0.54,27,23,50,623747
chr1,40841869,0.96,50,2,52,623748
chr1,40841923,0.94,100,6,106,623749
chr1,40841932,0.93,107,8,115,623750
chr1,40842078,0.94,91,6,97,623751
chr1,40842322,0.74,94,33,127,623752
chr1,40842352,0.99,147,2,149,623753
chr1,40842539,0.9,81,9,90,623754
chr1,40842667,0.89,78,10,88,623755
chr1,40842898,0.93,57,4,61,623756
chr1,40842932,1,70,0,70,623757
chr1,40843028,0.9,102,11,113,623758
chr1,40843072,0.9,97,11,108,623759
chr1,40843455,0.75,58,19,77,623760
chr1,40843819,0.78,50,14,64,623761
chr1,40843859,0.99,79,1,80,623762
chr1,40843940,0.97,125,4,129,623763
chr1,40843949,0.94,126,8,134,623764
chr1,40843968,0.89,118,14,132,623765
chr1,40844279,0.95,76,4,80,623766
chr1,40844560,0.92,79,7,86,623767
chr1,40844611,0.95,72,4,76,623768
chr1,40844681,0.96,27,1,28,623769
chr1,40844702,0.45,25,31,56,623770
chr1,40844706,0.78,59,17,76,623771
chr1,40844776,0.96,78,3,81,623772
chr1,40844788,0.99,67,1,68,623773
chr1,40844800,0.97,69,2,71,623774
chr1,40844863,0.97,59,2,61,623775
chr1,40844877,0.95,55,3,58,623776
chr1,40844950,0.99,68,1,69,623777
chr1,40844963,0.96,71,3,74,623778
chr1,40845256,0.97,29,1,30,623779
chr1,40845311,0.82,54,12,66,623780
chr1,40845992,0.05,5,88,93,623781
chr1,40846232,1,35,0,35,623782
chr1,40846294,0.73,51,19,70,623783
chr1,40846326,0.78,51,14,65,623784
chr1,40846346,0.84,52,10,62,623785
chr1,40846421,0.43,41,55,96,623786
chr1,40846443,0.96,81,3,84,623787
chr1,40846487,0.96,74,3,77,623788
chr1,40846490,0.92,68,6,74,623789
chr1,40846535,0.95,75,4,79,623790
chr1,40846580,0.96,94,4,98,623791
chr1,40846833,0.9,70,8,78,623792
chr1,40846919,0.89,106,13,119,623793
chr1,40847079,0.9,94,10,104,623794
chr1,40847198,0.8,90,22,112,623795
chr1,40847230,0.85,84,15,99,623796
chr1,40847347,0.81,85,20,105,623797
chr1,40847465,0.86,105,17,122,623798
chr1,40847476,0.85,112,20,132,623799
chr1,40847509,0.47,61,70,131,623800
chr1,40847932,0.83,101,20,121,623801
chr1,40847945,0.94,117,8,125,623802
chr1,40847954,0.97,119,4,123,623803
chr1,40848820,0.34,31,61,92,623804
chr1,40848893,0.83,55,11,66,623805
chr1,40848911,0.98,59,1,60,623806
chr1,40848957,0.89,31,4,35,623807
chr1,40848969,0.97,34,1,35,623808
chr1,40849091,0.97,69,2,71,623809
chr1,40849113,0.97,66,2,68,623810
chr1,40849202,0.83,53,11,64,623811
chr1,40849215,0.78,54,15,69,623812
chr1,40849232,0.81,58,14,72,623813
chr1,40849394,0.59,54,37,91,623814
chr1,40849538,0.97,83,3,86,623815
chr1,40849577,0.52,33,30,63,623816
chr1,40849631,0.91,78,8,86,623817
chr1,40849661,0.89,80,10,90,623818
chr1,40849869,0.78,73,21,94,623819
chr1,40850135,0.27,36,98,134,623820
chr1,40850341,0.27,20,54,74,623821
chr1,40850612,0.8,55,14,69,623822
chr1,40850684,0.96,64,3,67,623823
chr1,40850767,0.82,84,18,102,623824
chr1,40850773,0.9,92,10,102,623825
chr1,40850793,0.78,73,20,93,623826
chr1,40850888,0.96,85,4,89,623827
chr1,40851249,0.85,61,11,72,623828
chr1,40851382,0.88,61,8,69,623829
chr1,40851486,0.87,74,11,85,623830
chr1,40851862,0.73,100,37,137,623831
chr1,40852012,0.84,87,16,103,623832
chr1,40852025,0.86,82,13,95,623833
chr1,40852152,0.8,73,18,91,623834
chr1,40852196,0.68,66,31,97,623835
chr1,40852244,0.62,63,39,102,623836
chr1,40852465,0.46,40,47,87,623837
chr1,40852559,0.95,38,2,40,623838
chr1,40852564,0.93,42,3,45,623839
chr1,40852567,0.93,43,3,46,623840
chr1,40852591,0.93,53,4,57,623841
chr1,40852681,0.74,67,23,90,623842
chr1,40852744,0.95,86,5,91,623843
chr1,40852776,0.97,87,3,90,623844
chr1,40852784,0.98,92,2,94,623845
chr1,40852935,0.78,74,21,95,623846
chr1,40853157,0.98,113,2,115,623847
chr1,40853241,0.98,87,2,89,623848
chr1,40853330,0.99,70,1,71,623849
chr1,40853357,0.97,69,2,71,623850
chr1,40853381,0.95,60,3,63,623851
chr1,40853385,0.98,62,1,63,623852
chr1,40853391,1,60,0,60,623853
chr1,40853402,0.96,55,2,57,623854
chr1,40853424,0.98,59,1,60,623855
chr1,40853483,0.98,52,1,53,623856
chr1,40853489,0.94,48,3,51,623857
chr1,40853504,0.98,54,1,55,623858
chr1,40853511,0.98,58,1,59,623859
chr1,40853537,0.97,63,2,65,623860
chr1,40853544,1,61,0,61,623861
chr1,40853557,1,60,0,60,623862
chr1,40853582,0.94,45,3,48,623863
chr1,40853601,0.97,38,1,39,623864
chr1,40853608,1,42,0,42,623865
chr1,40853623,0.98,41,1,42,623866
chr1,40853673,1,42,0,42,623867
chr1,40853709,1,24,0,24,623868
chr1,40853717,0.92,22,2,24,623869
chr1,40853720,1,24,0,24,623870
chr1,40853725,1,23,0,23,623871
chr1,40853740,0.47,8,9,17,623872
chr1,40853761,1,8,0,8,623873
chr1,40853773,0.9,9,1,10,623874
chr1,40853787,0.93,13,1,14,623875
chr1,40853808,1,25,0,25,623876
chr1,40853846,0.83,53,11,64,623877
chr1,40853852,1,64,0,64,623878
chr1,40853866,0.95,75,4,79,623879
chr1,40853873,0.91,71,7,78,623880
chr1,40853910,0.99,70,1,71,623881
chr1,40853917,1,75,0,75,623882
chr1,40853919,1,71,0,71,623883
chr1,40853928,0.98,56,1,57,623884
chr1,40853955,1,36,0,36,623885
chr1,40854048,1,12,0,12,623886
chr1,40854130,1,21,0,21,623887
chr1,40854300,0.88,57,8,65,623888
chr1,40854330,0.95,77,4,81,623889
chr1,40854335,0.97,74,2,76,623890
chr1,40854398,0.81,39,9,48,623891
chr1,40854421,0.96,43,2,45,623892
chr1,40854529,0.86,59,10,69,623893
chr1,40854531,0.93,64,5,69,623894
chr1,40854562,0.93,76,6,82,623895
chr1,40854570,0.89,71,9,80,623896
chr1,40854579,0.89,77,10,87,623897
chr1,40854588,0.88,71,10,81,623898
chr1,40854602,0.9,79,9,88,623899
chr1,40854604,0.98,82,2,84,623900
chr1,40854631,0.89,74,9,83,623901
chr1,40854633,0.89,72,9,81,623902
chr1,40854663,0.97,58,2,60,623903
chr1,40854671,0.95,52,3,55,623904
chr1,40854697,0.96,27,1,28,623905
chr1,40854707,0.85,22,4,26,623906
chr1,40854730,1,16,0,16,623907
chr1,40854736,0.93,13,1,14,623908
chr1,40854739,1,13,0,13,623909
chr1,40854766,0.98,42,1,43,623910
chr1,40854776,0.98,53,1,54,623911
chr1,40854820,0.94,102,7,109,623912
chr1,40854847,0.93,110,8,118,623913
chr1,40854861,0.97,115,3,118,623914
chr1,40855062,0.94,74,5,79,623915
chr1,40855317,0.94,99,6,105,623916
chr1,40855452,0.91,67,7,74,623917
chr1,40855528,0.81,44,10,54,623918
chr1,40855596,0.98,42,1,43,623919
chr1,40855730,0.53,50,45,95,623920
chr1,40855749,0.35,37,70,107,623921
chr1,40856032,0.63,66,38,104,623922
chr1,40856541,0.95,88,5,93,623923
chr1,40856785,0.91,81,8,89,623924
chr1,40856840,0.91,85,8,93,623925
chr1,40856995,0.99,86,1,87,623926
chr1,40856998,0.99,86,1,87,623927
chr1,40857088,1,94,0,94,623928
chr1,40857104,0.98,90,2,92,623929
chr1,40857228,0.96,78,3,81,623930
chr1,40857305,0.97,58,2,60,623931
chr1,40857424,0.8,65,16,81,623932
chr1,40857922,0.93,80,6,86,623933
chr1,40857943,0.94,78,5,83,623934
chr1,40858062,0.66,60,31,91,623935
chr1,40858493,0.95,80,4,84,623936
chr1,40858519,0.99,92,1,93,623937
chr1,40858526,0.97,90,3,93,623938
chr1,40858537,0.97,88,3,91,623939
chr1,40858567,0.98,92,2,94,623940
chr1,40858598,0.96,104,4,108,623941
chr1,40858634,1,113,0,113,623942
chr1,40858666,0.97,100,3,103,623943
chr1,40858698,0.92,79,7,86,623944
chr1,40858705,1,77,0,77,623945
chr1,40858760,1,41,0,41,623946
chr1,40858858,0.98,61,1,62,623947
chr1,40859052,0.96,66,3,69,623948
chr1,40859055,0.89,68,8,76,623949
chr1,40859256,0.82,28,6,34,623950
chr1,40859320,0.95,80,4,84,623951
chr1,40859362,0.95,87,5,92,623952
chr1,40859463,0.99,70,1,71,623953
chr1,40859496,0.98,79,2,81,623954
chr1,40859506,0.99,76,1,77,623955
chr1,40859508,1,84,0,84,623956
chr1,40859512,1,85,0,85,623957
chr1,40859544,0.96,86,4,90,623958
chr1,40859902,0.95,82,4,86,623959
chr1,40859924,0.98,86,2,88,623960
chr1,40860022,0.97,117,4,121,623961
chr1,40860144,0.09,7,72,79,623962
chr1,40860415,0.08,8,97,105,623963
chr1,40860418,0.04,4,100,104,623964
chr1,40860592,0.77,57,17,74,623965
chr1,40861387,0.84,76,15,91,623966
chr1,40861633,0.99,84,1,85,623967
chr1,40861748,0.99,93,1,94,623968
chr1,40861911,0.94,83,5,88,623969
chr1,40861943,0.96,77,3,80,623970
chr1,40861980,0.99,70,1,71,623971
chr1,40862240,0.57,79,59,138,623972
chr1,40862658,0.44,51,65,116,623973
chr1,40862775,0.92,97,8,105,623974
chr1,40862849,0.45,50,60,110,623975
chr1,40863166,0.22,23,80,103,623976
chr1,40863262,0.58,70,50,120,623977
chr1,40863407,0.52,62,58,120,623978
chr1,40863715,0.98,80,2,82,623979
chr1,40863731,0.93,79,6,85,623980
chr1,40863840,0.94,74,5,79,623981
chr1,40863891,1,79,0,79,623982
chr1,40863893,0.97,75,2,77,623983
chr1,40864013,0.95,71,4,75,623984
chr1,40864060,0.74,68,24,92,623985
chr1,40864188,1,100,0,100,623986
chr1,40864272,0.92,92,8,100,623987
chr1,40864543,0.95,93,5,98,623988
chr1,40864606,0.95,84,4,88,623989
chr1,40864877,0.98,41,1,42,623990
chr1,40864885,0.97,38,1,39,623991
chr1,40864902,1,48,0,48,623992
chr1,40864917,0.96,50,2,52,623993
chr1,40864973,0.88,35,5,40,623994
chr1,40865111,0.97,36,1,37,623995
chr1,40865121,0.97,30,1,31,623996
chr1,40865234,0.96,82,3,85,623997
chr1,40865328,0.96,77,3,80,623998
chr1,40865632,0.72,83,33,116,623999
chr1,40865694,0.32,38,80,118,624000
chr1,40865927,0.34,33,65,98,624001
chr1,40866148,0.24,25,81,106,624002
chr1,40866286,0.85,69,12,81,624003
chr1,40866657,0.97,63,2,65,624004
chr1,40866659,0.94,59,4,63,624005
chr1,40866697,0.97,62,2,64,624006
chr1,40866706,0.95,57,3,60,624007
chr1,40866727,0.99,66,1,67,624008
chr1,40866758,0.95,73,4,77,624009
chr1,40866791,0.96,65,3,68,624010
chr1,40866795,0.97,61,2,63,624011
chr1,40866801,0.97,57,2,59,624012
chr1,40866803,0.9,55,6,61,624013
chr1,40866807,0.98,54,1,55,624014
chr1,40866827,0.88,36,5,41,624015
chr1,40866851,0.5,14,14,28,624016
chr1,40866859,0.97,30,1,31,624017
chr1,40866866,1,30,0,30,624018
chr1,40866883,0.97,36,1,37,624019
chr1,40866889,0.95,41,2,43,624020
chr1,40866891,0.98,40,1,41,624021
chr1,40866921,0.99,67,1,68,624022
chr1,40866929,1,70,0,70,624023
chr1,40866963,0.88,77,11,88,624024
chr1,40867075,0.95,74,4,78,624025
chr1,40867077,0.96,70,3,73,624026
chr1,40867088,0.81,58,14,72,624027
chr1,40867109,0.87,62,9,71,624028
chr1,40867254,0.92,77,7,84,624029
chr1,40867370,0.79,74,20,94,624030
chr1,40867414,0.93,90,7,97,624031
chr1,40867486,0.86,76,12,88,624032
chr1,40867506,0.98,85,2,87,624033
chr1,40867644,0.98,80,2,82,624034
chr1,40867707,0.94,74,5,79,624035
chr1,40867972,0.93,99,7,106,624036
chr1,40868154,1,60,0,60,624037
chr1,40868190,0.96,64,3,67,624038
chr1,40868268,0.88,57,8,65,624039
chr1,40868322,0.62,39,24,63,624040
chr1,40868387,0.97,67,2,69,624041
chr1,40868415,0.9,76,8,84,624042
chr1,40868903,1,64,0,64,624043
chr1,40868905,0.97,62,2,64,624044
chr1,40868915,0.95,63,3,66,624045
chr1,40868948,0.99,67,1,68,624046
chr1,40868998,0.93,64,5,69,624047
chr1,40869006,0.94,72,5,77,624048
chr1,40869047,0.92,65,6,71,624049
chr1,40869049,0.99,68,1,69,624050
chr1,40869069,0.91,64,6,70,624051
chr1,40869108,0.96,67,3,70,624052
chr1,40869133,0.99,69,1,70,624053
chr1,40869136,0.96,68,3,71,624054
chr1,40869155,0.87,59,9,68,624055
chr1,40869163,0.99,66,1,67,624056
chr1,40869204,0.9,57,6,63,624057
chr1,40869384,0.86,83,13,96,624058
chr1,40869541,0.99,115,1,116,624059
chr1,40869684,0.95,77,4,81,624060
chr1,40869693,0.97,74,2,76,624061
chr1,40870152,0.84,83,16,99,624062
chr1,40870515,0.2,26,102,128,624063
chr1,40870545,0.11,15,123,138,624064
chr1,40870576,0.12,16,113,129,624065
chr1,40870640,0.02,2,115,117,624066
chr1,40870683,0,0,68,68,624067
chr1,40870740,0.06,5,79,84,624068
chr1,40870918,0.99,81,1,82,624069
chr1,40871033,0.67,44,22,66,624070
chr1,40871075,0.96,80,3,83,624071
chr1,40871093,0.97,89,3,92,624072
chr1,40871115,0.91,88,9,97,624073
chr1,40871136,0.84,84,16,100,624074
chr1,40871146,0.82,83,18,101,624075
chr1,40871239,0.94,112,7,119,624076
chr1,40871245,0.96,121,5,126,624077
chr1,40871254,0.97,119,4,123,624078
chr1,40871496,0.9,93,10,103,624079
chr1,40871670,0.86,80,13,93,624080
chr1,40871781,0.76,45,14,59,624081
chr1,40871834,0.57,39,29,68,624082
chr1,40871869,0.88,60,8,68,624083
chr1,40871944,0.87,73,11,84,624084
chr1,40872411,0.9,81,9,90,624085
chr1,40872413,0.9,84,9,93,624086
chr1,40872452,0.96,103,4,107,624087
chr1,40872514,0.73,89,33,122,624088
chr1,40872764,0.95,101,5,106,624089
chr1,40872787,0.92,108,10,118,624090
chr1,40872878,0.88,80,11,91,624091
chr1,40872884,0.91,77,8,85,624092
chr1,40872922,0.98,83,2,85,624093
chr1,40873033,0.83,78,16,94,624094
chr1,40873102,0.94,67,4,71,624095
chr1,40873623,0.88,79,11,90,624096
chr1,40873671,0.98,80,2,82,624097
chr1,40873719,0.98,85,2,87,624098
chr1,40873856,0.85,88,16,104,624099
chr1,40874292,0.78,69,19,88,624100
chr1,40874358,0.79,84,23,107,624101
chr1,40874391,0.96,104,4,108,624102
chr1,40874394,0.91,86,9,95,624103
chr1,40874410,0.83,86,18,104,624104
chr1,40874587,0.95,70,4,74,624105
chr1,40874600,0.9,70,8,78,624106
chr1,40875074,0.95,72,4,76,624107
chr1,40875207,0.84,88,17,105,624108
chr1,40875352,0.91,84,8,92,624109
chr1,40875448,0.91,79,8,87,624110
chr1,40875481,0.95,84,4,88,624111
chr1,40875576,0.63,50,30,80,624112
chr1,40875834,1,103,0,103,624113
chr1,40875899,0.86,75,12,87,624114
chr1,40875996,0.98,98,2,100,624115
chr1,40876608,0.99,93,1,94,624116
chr1,40876988,0.97,123,4,127,624117
chr1,40877096,0.93,92,7,99,624118
chr1,40877204,0.88,84,11,95,624119
chr1,40877211,0.95,91,5,96,624120
chr1,40877348,0.89,104,13,117,624121
chr1,40877439,0.91,95,9,104,624122
chr1,40877643,0.53,50,45,95,624123
chr1,40877863,0.95,101,5,106,624124
chr1,40878408,0.99,81,1,82,624125
chr1,40878424,0.88,72,10,82,624126
chr1,40878463,0.98,55,1,56,624127
chr1,40878467,1,58,0,58,624128
chr1,40878487,0.98,60,1,61,624129
chr1,40878492,1,65,0,65,624130
chr1,40878550,0.92,60,5,65,624131
chr1,40878576,0.93,71,5,76,624132
chr1,40878610,1,83,0,83,624133
chr1,40878720,0.99,98,1,99,624134
chr1,40878851,0.9,60,7,67,624135
chr1,40878936,0.83,68,14,82,624136
chr1,40878975,1,96,0,96,624137
chr1,40879344,0.92,85,7,92,624138
chr1,40879618,0.93,71,5,76,624139
chr1,40879754,0.9,69,8,77,624140
chr1,40879861,0.96,64,3,67,624141
chr1,40879874,0.98,81,2,83,624142
chr1,40879886,0.98,78,2,80,624143
chr1,40880105,0.95,88,5,93,624144
chr1,40880152,0.95,101,5,106,624145
chr1,40880223,0.83,67,14,81,624146
chr1,40880558,0.93,92,7,99,624147
chr1,40880718,0.93,70,5,75,624148
chr1,40880805,0.89,77,10,87,624149
chr1,40880928,0.93,75,6,81,624150
chr1,40881040,0.96,77,3,80,624151
chr1,40881128,0.93,68,5,73,624152
chr1,40881324,0.92,83,7,90,624153
chr1,40881388,0.99,76,1,77,624154
chr1,40881395,0.97,72,2,74,624155
chr1,40881830,1,52,0,52,624156
chr1,40881880,1,60,0,60,624157
chr1,40881912,0.94,82,5,87,624158
chr1,40881993,0.94,97,6,103,624159
chr1,40882150,0.94,83,5,88,624160
chr1,40882215,0.98,101,2,103,624161
chr1,40882266,0.94,83,5,88,624162
chr1,40882301,0.97,76,2,78,624163
chr1,40882394,0.98,48,1,49,624164
chr1,40882468,0.98,50,1,51,624165
chr1,40882507,0.97,69,2,71,624166
chr1,40882656,0.94,66,4,70,624167
chr1,40882825,0.94,73,5,78,624168
chr1,40883151,0.99,67,1,68,624169
chr1,40883265,0.95,74,4,78,624170
chr1,40883384,0.95,60,3,63,624171
chr1,40883454,0.93,52,4,56,624172
chr1,40883700,0.92,89,8,97,624173
chr1,40883920,0.92,115,10,125,624174
chr1,40883979,0.88,98,14,112,624175
chr1,40884698,0.96,72,3,75,624176
chr1,40884802,0.92,78,7,85,624177
chr1,40884834,0.93,68,5,73,624178
chr1,40884913,0.77,46,14,60,624179
chr1,40885021,0.95,59,3,62,624180
chr1,40885038,1,77,0,77,624181
chr1,40885066,1,99,0,99,624182
chr1,40885077,0.97,87,3,90,624183
chr1,40885101,0.98,81,2,83,624184
chr1,40885113,0.98,82,2,84,624185
chr1,40885145,0.8,47,12,59,624186
chr1,40885248,0.95,62,3,65,624187
chr1,40885754,0.9,86,10,96,624188
chr1,40885826,0.94,101,7,108,624189
chr1,40885850,0.9,98,11,109,624190
chr1,40885869,0.93,110,8,118,624191
chr1,40885947,0.81,95,22,117,624192
chr1,40886006,0.92,101,9,110,624193
chr1,40886132,0.83,75,15,90,624194
chr1,40886418,0.81,88,21,109,624195
chr1,40886623,0.92,107,9,116,624196
chr1,40886696,0.71,59,24,83,624197
chr1,40887040,0.88,46,6,52,624198
chr1,40887129,0.88,46,6,52,624199
chr1,40887135,0.97,74,2,76,624200
chr1,40887140,0.88,65,9,74,624201
chr1,40887146,0.92,72,6,78,624202
chr1,40887198,0.57,43,33,76,624203
chr1,40887216,0.93,64,5,69,624204
chr1,40887260,0.96,47,2,49,624205
chr1,40887388,0.42,33,46,79,624206
chr1,40887441,0.97,60,2,62,624207
chr1,40887472,0.91,67,7,74,624208
chr1,40887476,0.87,65,10,75,624209
chr1,40887602,0.9,89,10,99,624210
chr1,40887722,0.96,48,2,50,624211
chr1,40887813,0.95,42,2,44,624212
chr1,40887988,0.43,32,43,75,624213
chr1,40888357,0.98,61,1,62,624214
chr1,40888467,1,76,0,76,624215
chr1,40888500,0.94,78,5,83,624216
chr1,40888544,0.54,40,34,74,624217
chr1,40888565,0.94,65,4,69,624218
chr1,40888598,0.98,56,1,57,624219
chr1,40888723,0.81,46,11,57,624220
chr1,40888764,0.88,36,5,41,624221
chr1,40888819,0.93,68,5,73,624222
chr1,40888833,0.95,79,4,83,624223
chr1,40888846,0.93,83,6,89,624224
chr1,40889021,0.84,56,11,67,624225
chr1,40889042,0.8,49,12,61,624226
chr1,40889239,0.98,83,2,85,624227
chr1,40889277,0.82,61,13,74,624228
chr1,40889328,0.94,67,4,71,624229
chr1,40889486,0.94,63,4,67,624230
chr1,40889530,0.95,83,4,87,624231
chr1,40889545,0.97,92,3,95,624232
chr1,40889740,0.56,48,37,85,624233
chr1,40889886,0.06,6,95,101,624234
chr1,40890087,0.75,74,25,99,624235
chr1,40890156,0.08,8,92,100,624236
chr1,40890218,0.27,30,80,110,624237
chr1,40890243,0.32,37,78,115,624238
chr1,40890397,0.89,55,7,62,624239
chr1,40890421,0.98,56,1,57,624240
chr1,40890429,0.98,57,1,58,624241
chr1,40890536,0.97,73,2,75,624242
chr1,40890637,0.92,85,7,92,624243
chr1,40890681,0.92,105,9,114,624244
chr1,40890907,0.88,86,12,98,624245
chr1,40891039,0.94,85,5,90,624246
chr1,40891078,0.87,76,11,87,624247
chr1,40891137,0.89,55,7,62,624248
chr1,40891369,0.95,90,5,95,624249
chr1,40891559,0.76,67,21,88,624250
chr1,40891688,0.97,93,3,96,624251
chr1,40891715,0.99,93,1,94,624252
chr1,40891754,0.95,104,5,109,624253
chr1,40891765,0.95,104,5,109,624254
chr1,40891808,0.99,123,1,124,624255
chr1,40891880,0.96,126,5,131,624256
chr1,40891918,0.99,119,1,120,624257
chr1,40891924,0.97,116,3,119,624258
chr1,40891936,0.93,100,7,107,624259
chr1,40892400,0.94,74,5,79,624260
chr1,40892508,0.98,110,2,112,624261
chr1,40892609,0.97,109,3,112,624262
chr1,40892629,0.95,100,5,105,624263
chr1,40892736,0.91,69,7,76,624264
chr1,40892740,1,70,0,70,624265
chr1,40892742,1,70,0,70,624266
chr1,40892780,0.97,57,2,59,624267
chr1,40892785,1,59,0,59,624268
chr1,40892810,1,52,0,52,624269
chr1,40892830,0.97,67,2,69,624270
chr1,40892840,0.96,72,3,75,624271
chr1,40892869,0.96,81,3,84,624272
chr1,40892893,0.89,76,9,85,624273
chr1,40892917,0.94,75,5,80,624274
chr1,40892932,0.99,71,1,72,624275
chr1,40892949,0.92,60,5,65,624276
chr1,40892985,0.98,53,1,54,624277
chr1,40892993,0.96,50,2,52,624278
chr1,40893300,0.99,84,1,85,624279
chr1,40893315,0.99,82,1,83,624280
chr1,40893343,0.96,74,3,77,624281
chr1,40893348,0.99,71,1,72,624282
chr1,40893404,0.93,55,4,59,624283
chr1,40893468,0.94,50,3,53,624284
chr1,40893563,0.98,54,1,55,624285
chr1,40893612,0.86,51,8,59,624286
chr1,40893642,1,73,0,73,624287
chr1,40893741,0.97,68,2,70,624288
chr1,40893743,0.99,70,1,71,624289
chr1,40893751,0.99,79,1,80,624290
chr1,40893795,1,86,0,86,624291
chr1,40893812,0.98,85,2,87,624292
chr1,40893850,0.99,78,1,79,624293
chr1,40893879,0.88,74,10,84,624294
chr1,40893939,0.94,80,5,85,624295
chr1,40894043,0.96,44,2,46,624296
chr1,40894132,0.84,85,16,101,624297
chr1,40894140,0.95,87,5,92,624298
chr1,40894164,0.95,89,5,94,624299
chr1,40894228,0.96,67,3,70,624300
chr1,40894376,0.95,84,4,88,624301
chr1,40894417,0.9,74,8,82,624302
chr1,40894422,0.98,80,2,82,624303
chr1,40894525,0.93,54,4,58,624304
chr1,40894562,0.95,62,3,65,624305
chr1,40894912,0.92,79,7,86,624306
chr1,40894940,0.87,95,14,109,624307
chr1,40895410,0.67,29,14,43,624308
chr1,40895434,0.84,36,7,43,624309
chr1,40895532,0.9,44,5,49,624310
chr1,40895546,0.94,47,3,50,624311
chr1,40895606,0.95,76,4,80,624312
chr1,40895646,0.94,78,5,83,624313
chr1,40895666,0.87,67,10,77,624314
chr1,40895674,0.95,73,4,77,624315
chr1,40895681,1,65,0,65,624316
chr1,40895789,0.62,31,19,50,624317
chr1,40895907,1,56,0,56,624318
chr1,40895996,0.97,35,1,36,624319
chr1,40896028,1,38,0,38,624320
chr1,40896261,0.93,74,6,80,624321
chr1,40896361,0.97,71,2,73,624322
chr1,40896373,0.89,65,8,73,624323
chr1,40896435,0.93,71,5,76,624324
chr1,40896451,0.95,72,4,76,624325
chr1,40896461,0.99,76,1,77,624326
chr1,40896574,0.98,87,2,89,624327
chr1,40896584,0.69,62,28,90,624328
chr1,40896628,0.76,71,22,93,624329
chr1,40896700,0.99,91,1,92,624330
chr1,40897051,0.86,73,12,85,624331
chr1,40897556,0.97,59,2,61,624332
chr1,40897558,0.88,51,7,58,624333
chr1,40897698,0.59,66,45,111,624334
chr1,40897949,0.93,64,5,69,624335
chr1,40898005,1,66,0,66,624336
chr1,40898013,0.97,60,2,62,624337
chr1,40898146,0.88,79,11,90,624338
chr1,40898345,0.14,9,56,65,624339
chr1,40898601,0.21,24,90,114,624340
chr1,40898647,0.78,96,27,123,624341
chr1,40899144,0.92,98,9,107,624342
chr1,40899195,0.92,101,9,110,624343
chr1,40899681,0.74,64,22,86,624344
chr1,40899703,0.86,64,10,74,624345
chr1,40899711,0.97,73,2,75,624346
chr1,40899719,0.94,67,4,71,624347
chr1,40899829,0.99,74,1,75,624348
chr1,40899837,0.96,72,3,75,624349
chr1,40899900,0.97,71,2,73,624350
chr1,40900007,0.97,86,3,89,624351
chr1,40900094,0.94,118,7,125,624352
chr1,40900154,0.9,76,8,84,624353
chr1,40900759,0.45,34,41,75,624354
chr1,40900953,0.92,44,4,48,624355
chr1,40901007,0.91,75,7,82,624356
chr1,40901059,0.92,35,3,38,624357
chr1,40901170,0.81,51,12,63,624358
chr1,40901207,0.79,67,18,85,624359
chr1,40901209,0.82,70,15,85,624360
chr1,40901363,0.23,22,74,96,624361
chr1,40901392,0.4,36,54,90,624362
chr1,40901633,0.48,44,48,92,624363
chr1,40901675,0.24,27,87,114,624364
chr1,40901816,0.58,59,42,101,624365
chr1,40901896,0.74,90,31,121,624366
chr1,40901964,0.86,96,15,111,624367
chr1,40902003,0.9,79,9,88,624368
chr1,40902073,0.77,40,12,52,624369
chr1,40902287,0.95,81,4,85,624370
chr1,40902291,0.99,81,1,82,624371
chr1,40902330,0.96,69,3,72,624372
chr1,40902368,0.88,60,8,68,624373
chr1,40902435,0.98,43,1,44,624374
chr1,40902457,1,32,0,32,624375
chr1,40902459,0.97,31,1,32,624376
chr1,40902465,0.86,25,4,29,624377
chr1,40902499,0.95,19,1,20,624378
chr1,40902521,0.93,14,1,15,624379
chr1,40902541,0.96,24,1,25,624380
chr1,40902545,0.94,30,2,32,624381
chr1,40902553,1,35,0,35,624382
chr1,40902557,0.97,38,1,39,624383
chr1,40902619,1,38,0,38,624384
chr1,40902644,1,32,0,32,624385
chr1,40902649,0.97,33,1,34,624386
chr1,40902677,0.97,36,1,37,624387
chr1,40902689,1,44,0,44,624388
chr1,40902697,0.96,50,2,52,624389
chr1,40902779,0.96,45,2,47,624390
chr1,40902822,0.35,19,36,55,624391
chr1,40902824,0.58,32,23,55,624392
chr1,40902849,0.55,41,34,75,624393
chr1,40902863,0.83,57,12,69,624394
chr1,40903328,0.8,52,13,65,624395
chr1,40903606,0.58,63,46,109,624396
chr1,40903811,0.92,78,7,85,624397
chr1,40904200,0.26,20,56,76,624398
chr1,40904420,0.75,51,17,68,624399
chr1,40904539,0.92,89,8,97,624400
chr1,40904757,0.19,21,87,108,624401
chr1,40904939,0.54,40,34,74,624402
chr1,40905021,0.97,103,3,106,624403
chr1,40905045,1,124,0,124,624404
chr1,40905074,0.79,107,29,136,624405
chr1,40905153,0.96,131,6,137,624406
chr1,40905342,0.97,93,3,96,624407
chr1,40905354,0.96,81,3,84,624408
chr1,40905382,0.59,36,25,61,624409
chr1,40905412,0.96,54,2,56,624410
chr1,40905483,1,66,0,66,624411
chr1,40905487,0.91,62,6,68,624412
chr1,40905546,0.97,77,2,79,624413
chr1,40905592,0.93,62,5,67,624414
chr1,40905660,0.79,77,20,97,624415
chr1,40905970,0.95,38,2,40,624416
chr1,40906062,0.96,71,3,74,624417
chr1,40906125,0.94,83,5,88,624418
chr1,40906164,0.99,76,1,77,624419
chr1,40906172,0.99,71,1,72,624420
chr1,40906180,0.97,69,2,71,624421
chr1,40906238,0.96,72,3,75,624422
chr1,40906252,0.99,69,1,70,624423
chr1,40906330,0.92,35,3,38,624424
chr1,40906349,0.9,44,5,49,624425
chr1,40906615,0.92,65,6,71,624426
chr1,40906623,0.93,65,5,70,624427
chr1,40906659,0.91,77,8,85,624428
chr1,40906688,0.87,75,11,86,624429
chr1,40906699,0.9,72,8,80,624430
chr1,40906713,0.89,68,8,76,624431
chr1,40906809,0.92,34,3,37,624432
chr1,40906818,0.8,32,8,40,624433
chr1,40906846,0.93,55,4,59,624434
chr1,40906862,0.99,68,1,69,624435
chr1,40907372,0.95,52,3,55,624436
chr1,40907377,0.94,58,4,62,624437
chr1,40907408,0.97,77,2,79,624438
chr1,40907412,0.88,74,10,84,624439
chr1,40907434,0.88,71,10,81,624440
chr1,40907466,0.97,83,3,86,624441
chr1,40907470,0.97,88,3,91,624442
chr1,40907599,0.93,68,5,73,624443
chr1,40907630,0.94,65,4,69,624444
chr1,40907807,0.93,104,8,112,624445
chr1,40907867,0.96,97,4,101,624446
chr1,40907909,0.96,85,4,89,624447
chr1,40908010,0.94,83,5,88,624448
chr1,40908061,0.96,70,3,73,624449
chr1,40908071,0.97,69,2,71,624450
chr1,40908337,0.87,89,13,102,624451
chr1,40908393,0.96,66,3,69,624452
chr1,40908619,0.96,95,4,99,624453
chr1,40908712,0.99,76,1,77,624454
chr1,40908720,0.95,75,4,79,624455
chr1,40908812,0.92,71,6,77,624456
chr1,40908928,0.9,35,4,39,624457
chr1,40908944,0.88,21,3,24,624458
chr1,40909125,0.85,79,14,93,624459
chr1,40909394,0.98,90,2,92,624460
chr1,40909403,0.97,94,3,97,624461
chr1,40909562,0.99,98,1,99,624462
chr1,40909600,0.94,103,7,110,624463
chr1,40909627,0.73,85,31,116,624464
chr1,40909757,0.89,68,8,76,624465
chr1,40909813,0.96,79,3,82,624466
chr1,40909815,0.95,79,4,83,624467
chr1,40909972,0.93,83,6,89,624468
chr1,40909998,0.88,77,11,88,624469
chr1,40910388,0.92,66,6,72,624470
chr1,40910476,0.92,69,6,75,624471
chr1,40910480,0.92,70,6,76,624472
chr1,40910540,0.94,48,3,51,624473
chr1,40910598,0.9,62,7,69,624474
chr1,40911215,0.96,64,3,67,624475
chr1,40911220,0.9,63,7,70,624476
chr1,40911361,0.8,86,21,107,624477
chr1,40911416,0.95,96,5,101,624478
chr1,40911449,0.97,89,3,92,624479
chr1,40911497,0.95,83,4,87,624480
chr1,40911560,0.97,68,2,70,624481
chr1,40911631,0.96,71,3,74,624482
chr1,40911639,0.83,67,14,81,624483
chr1,40912256,0.73,82,30,112,624484
chr1,40912322,0.87,113,17,130,624485
chr1,40912480,0.97,73,2,75,624486
chr1,40912488,0.96,77,3,80,624487
chr1,40912525,0.82,72,16,88,624488
chr1,40912701,0.93,96,7,103,624489
chr1,40912753,0.93,99,7,106,624490
chr1,40912816,0.99,118,1,119,624491
chr1,40912893,0.92,98,8,106,624492
chr1,40912902,0.98,101,2,103,624493
chr1,40913323,0.9,85,9,94,624494
chr1,40913401,0.69,63,28,91,624495
chr1,40913676,0.93,54,4,58,624496
chr1,40913770,0.97,63,2,65,624497
chr1,40913784,0.99,69,1,70,624498
chr1,40913793,0.97,74,2,76,624499
chr1,40913820,0.95,87,5,92,624500
chr1,40913869,0.99,86,1,87,624501
chr1,40913873,0.92,78,7,85,624502
chr1,40913960,0.9,82,9,91,624503
chr1,40914120,0.98,100,2,102,624504
chr1,40914462,0.91,96,9,105,624505
chr1,40914474,0.98,95,2,97,624506
chr1,40914478,0.97,88,3,91,624507
chr1,40914518,0.97,76,2,78,624508
chr1,40914523,0.96,79,3,82,624509
chr1,40914534,0.99,79,1,80,624510
chr1,40914579,0.91,82,8,90,624511
chr1,40914612,0.97,77,2,79,624512
chr1,40914615,0.97,72,2,74,624513
chr1,40914620,0.97,66,2,68,624514
chr1,40914624,1,45,0,45,624515
chr1,40914666,1,59,0,59,624516
chr1,40914683,0.97,62,2,64,624517
chr1,40914700,0.96,71,3,74,624518
chr1,40914708,0.97,83,3,86,624519
chr1,40914729,0.96,91,4,95,624520
chr1,40914738,0.95,91,5,96,624521
chr1,40914783,0.68,69,33,102,624522
chr1,40914830,0.86,86,14,100,624523
chr1,40914841,0.6,62,41,103,624524
chr1,40914961,0.78,75,21,96,624525
chr1,40915113,0.93,93,7,100,624526
chr1,40915149,0.67,86,43,129,624527
chr1,40915198,0.6,81,54,135,624528
chr1,40915343,0.38,36,59,95,624529
chr1,40915432,0,0,109,109,624530
chr1,40915447,0,0,105,105,624531
chr1,40915455,0.02,2,109,111,624532
chr1,40915474,0,0,97,97,624533
chr1,40915497,0,0,92,92,624534
chr1,40915503,0,0,93,93,624535
chr1,40915518,0,0,88,88,624536
chr1,40915563,0.01,1,93,94,624537
chr1,40915582,0.01,1,86,87,624538
chr1,40915606,0.01,1,82,83,624539
chr1,40915615,0,0,79,79,624540
chr1,40915636,0,0,69,69,624541
chr1,40915647,0,0,72,72,624542
chr1,40915650,0,0,60,60,624543
chr1,40915652,0.02,1,60,61,624544
chr1,40915657,0,0,66,66,624545
chr1,40915666,0,0,45,45,624546
chr1,40915672,0,0,55,55,624547
chr1,40915678,0,0,48,48,624548
chr1,40915683,0,0,47,47,624549
chr1,40915691,0,0,63,63,624550
chr1,40915699,0,0,54,54,624551
chr1,40915724,0,0,54,54,624552
chr1,40915729,0,0,52,52,624553
chr1,40915735,0,0,47,47,624554
chr1,40915747,0.02,1,55,56,624555
chr1,40915755,0,0,51,51,624556
chr1,40915758,0.02,1,60,61,624557
chr1,40915763,0,0,51,51,624558
chr1,40915768,0,0,57,57,624559
chr1,40915782,0,0,51,51,624560
chr1,40915784,0,0,45,45,624561
chr1,40915792,0,0,55,55,624562
chr1,40915799,0,0,53,53,624563
chr1,40915808,0.02,1,45,46,624564
chr1,40915819,0,0,25,25,624565
chr1,40915825,0,0,17,17,624566
chr1,40915830,0.03,1,38,39,624567
chr1,40915838,0,0,32,32,624568
chr1,40915853,0.04,1,26,27,624569
chr1,40915866,0,0,38,38,624570
chr1,40915884,0.03,1,28,29,624571
chr1,40915889,0,0,45,45,624572
chr1,40915896,0,0,37,37,624573
chr1,40915898,0,0,39,39,624574
chr1,40915905,0,0,37,37,624575
chr1,40915909,0.02,1,44,45,624576
chr1,40915911,0,0,45,45,624577
chr1,40915923,0,0,46,46,624578
chr1,40915925,0,0,43,43,624579
chr1,40915927,0,0,42,42,624580
chr1,40915929,0,0,45,45,624581
chr1,40915939,0,0,44,44,624582
chr1,40915947,0,0,42,42,624583
chr1,40915953,0,0,41,41,624584
chr1,40915984,0.06,2,31,33,624585
chr1,40915990,0,0,13,13,624586
chr1,40916039,0,0,11,11,624587
chr1,40916049,0,0,38,38,624588
chr1,40916055,0,0,38,38,624589
chr1,40916057,0,0,38,38,624590
chr1,40916071,0,0,43,43,624591
chr1,40916103,0,0,48,48,624592
chr1,40916153,0,0,65,65,624593
chr1,40916179,0,0,77,77,624594
chr1,40916181,0.01,1,78,79,624595
chr1,40916216,0,0,102,102,624596
chr1,40916222,0.01,1,106,107,624597
chr1,40916268,0.01,1,110,111,624598
chr1,40916361,0.01,1,73,74,624599
chr1,40916411,0.03,3,92,95,624600
chr1,40916423,0.01,1,105,106,624601
chr1,40916448,0.05,5,99,104,624602
chr1,40916507,0.16,14,76,90,624603
chr1,40916510,0.22,16,56,72,624604
chr1,40916523,0.11,10,77,87,624605
chr1,40916623,0.23,18,60,78,624606
chr1,40916627,0.15,12,67,79,624607
chr1,40916630,0.13,11,75,86,624608
chr1,40916666,0.12,12,89,101,624609
chr1,40916691,0.18,19,84,103,624610
chr1,40916704,0.24,18,56,74,624611
chr1,40916710,0.12,12,86,98,624612
chr1,40916715,0.2,15,59,74,624613
chr1,40916855,0.11,6,50,56,624614
chr1,40916874,0.16,8,41,49,624615
chr1,40917226,0.93,52,4,56,624616
chr1,40917323,0.86,74,12,86,624617
chr1,40917476,0.99,113,1,114,624618
chr1,40917557,0.97,69,2,71,624619
chr1,40917657,0.97,64,2,66,624620
chr1,40917689,1,69,0,69,624621
chr1,40917704,0.97,72,2,74,624622
chr1,40917711,1,66,0,66,624623
chr1,40917753,0.98,65,1,66,624624
chr1,40917849,0.88,64,9,73,624625
chr1,40918012,0.96,86,4,90,624626
chr1,40918486,0.97,120,4,124,624627
chr1,40918680,0.89,39,5,44,624628
chr1,40918725,0.94,51,3,54,624629
chr1,40918777,1,41,0,41,624630
chr1,40918789,1,42,0,42,624631
chr1,40918821,0.98,46,1,47,624632
chr1,40918866,0.97,57,2,59,624633
chr1,40918920,0.97,77,2,79,624634
chr1,40919224,0.98,96,2,98,624635
chr1,40919404,0.99,69,1,70,624636
chr1,40919416,0.99,75,1,76,624637
chr1,40919436,0.95,57,3,60,624638
chr1,40919451,0.98,50,1,51,624639
chr1,40919752,1,82,0,82,624640
chr1,40919776,0.85,64,11,75,624641
chr1,40919909,0.98,50,1,51,624642
chr1,40920014,1,69,0,69,624643
chr1,40920093,0.96,52,2,54,624644
chr1,40920131,1,37,0,37,624645
chr1,40920139,1,33,0,33,624646
chr1,40920156,0.95,21,1,22,624647
chr1,40920171,1,11,0,11,624648
chr1,40920260,0.98,54,1,55,624649
chr1,40920271,0.98,65,1,66,624650
chr1,40920320,1,72,0,72,624651
chr1,40920360,0.97,60,2,62,624652
chr1,40920368,1,63,0,63,624653
chr1,40920522,0.98,49,1,50,624654
chr1,40920858,0.57,49,37,86,624655
chr1,40921169,0.96,66,3,69,624656
chr1,40921331,1,56,0,56,624657
chr1,40921386,0.61,14,9,23,624658
chr1,40921480,1,64,0,64,624659
chr1,40921524,0.95,63,3,66,624660
chr1,40921740,0.97,84,3,87,624661
chr1,40921848,0.97,59,2,61,624662
chr1,40921987,0.99,103,1,104,624663
chr1,40921997,0.98,99,2,101,624664
chr1,40922052,0.91,75,7,82,624665
chr1,40922124,0.91,78,8,86,624666
chr1,40922212,0.93,91,7,98,624667
chr1,40922600,0.95,102,5,107,624668
chr1,40922637,0.96,110,4,114,624669
chr1,40922689,0.98,100,2,102,624670
chr1,40922701,1,96,0,96,624671
chr1,40922773,0.96,68,3,71,624672
chr1,40922828,0.9,44,5,49,624673
chr1,40922935,0.97,71,2,73,624674
chr1,40923038,1,64,0,64,624675
chr1,40923490,0.96,129,5,134,624676
chr1,40923645,0.86,110,18,128,624677
chr1,40923906,0.96,92,4,96,624678
chr1,40923935,0.98,114,2,116,624679
chr1,40924091,0.98,112,2,114,624680
chr1,40924244,0.96,53,2,55,624681
chr1,40924257,0.98,60,1,61,624682
chr1,40924380,0.99,72,1,73,624683
chr1,40924388,0.96,70,3,73,624684
chr1,40924411,0.99,74,1,75,624685
chr1,40924511,0.99,80,1,81,624686
chr1,40924780,0.97,68,2,70,624687
chr1,40924794,0.97,71,2,73,624688
chr1,40925367,0.8,90,23,113,624689
chr1,40926093,0.79,56,15,71,624690
chr1,40926254,0.94,51,3,54,624691
chr1,40926282,0.98,54,1,55,624692
chr1,40926287,0.98,54,1,55,624693
chr1,40926380,1,75,0,75,624694
chr1,40926420,1,60,0,60,624695
chr1,40926425,1,57,0,57,624696
chr1,40926429,0.98,39,1,40,624697
chr1,40926450,0.98,52,1,53,624698
chr1,40926521,0.99,71,1,72,624699
chr1,40926686,1,23,0,23,624700
chr1,40926703,1,32,0,32,624701
chr1,40926749,1,46,0,46,624702
chr1,40926772,1,43,0,43,624703
chr1,40926985,0.98,95,2,97,624704
chr1,40927232,0.89,50,6,56,624705
chr1,40927415,0.98,60,1,61,624706
chr1,40927645,0.51,32,31,63,624707
chr1,40927653,0.97,68,2,70,624708
chr1,40927811,0.98,54,1,55,624709
chr1,40927881,0.53,36,32,68,624710
chr1,40927959,0.97,91,3,94,624711
chr1,40928031,0.97,95,3,98,624712
chr1,40928144,0.97,101,3,104,624713
chr1,40928407,0.99,69,1,70,624714
chr1,40928562,0.98,81,2,83,624715
chr1,40928627,0.96,72,3,75,624716
chr1,40928702,0.95,78,4,82,624717
chr1,40928730,0.97,90,3,93,624718
chr1,40928852,0.96,78,3,81,624719
chr1,40929361,0.95,98,5,103,624720
chr1,40929537,1,31,0,31,624721
chr1,40929567,1,48,0,48,624722
chr1,40929726,0.96,46,2,48,624723
chr1,40929744,0.96,44,2,46,624724
chr1,40929753,1,48,0,48,624725
chr1,40929791,0.97,37,1,38,624726
chr1,40929814,0.98,44,1,45,624727
chr1,40930109,0.99,78,1,79,624728
chr1,40930129,0.95,73,4,77,624729
chr1,40930160,0.87,81,12,93,624730
chr1,40930234,0.95,82,4,86,624731
chr1,40930435,0.96,119,5,124,624732
chr1,40930514,0.99,71,1,72,624733
chr1,40930639,0.96,81,3,84,624734
chr1,40931054,0.98,109,2,111,624735
chr1,40931131,0.98,97,2,99,624736
chr1,40931184,0.92,93,8,101,624737
chr1,40931487,0.96,71,3,74,624738
chr1,40931624,0.84,71,14,85,624739
chr1,40931942,0.92,97,8,105,624740
chr1,40931992,0.99,97,1,98,624741
chr1,40932022,0.96,97,4,101,624742
chr1,40932145,0.99,109,1,110,624743
chr1,40932329,0.94,90,6,96,624744
chr1,40932509,1,64,0,64,624745
chr1,40932637,0.98,48,1,49,624746
chr1,40932658,0.98,50,1,51,624747
chr1,40932682,1,68,0,68,624748
chr1,40932767,0.95,87,5,92,624749
chr1,40933221,1,45,0,45,624750
chr1,40933310,1,81,0,81,624751
chr1,40933354,0.93,101,8,109,624752
chr1,40933648,0.97,62,2,64,624753
chr1,40933707,0.99,78,1,79,624754
chr1,40933788,0.9,81,9,90,624755
chr1,40933827,0.96,80,3,83,624756
chr1,40933883,0.96,81,3,84,624757
chr1,40933897,1,83,0,83,624758
chr1,40934284,0.89,47,6,53,624759
chr1,40934316,0.92,36,3,39,624760
chr1,40934354,0.92,45,4,49,624761
chr1,40934378,1,60,0,60,624762
chr1,40934422,0.88,50,7,57,624763
chr1,40934507,1,53,0,53,624764
chr1,40934528,1,51,0,51,624765
chr1,40934999,0.98,86,2,88,624766
chr1,40935089,0.95,73,4,77,624767
chr1,40935115,0.94,63,4,67,624768
chr1,40935786,0.71,80,32,112,624769
chr1,40935954,0.95,56,3,59,624770
chr1,40935962,0.95,56,3,59,624771
chr1,40935990,0.97,65,2,67,624772
chr1,40935993,0.97,62,2,64,624773
chr1,40936001,0.99,68,1,69,624774
chr1,40936009,0.99,72,1,73,624775
chr1,40936014,0.96,73,3,76,624776
chr1,40936025,0.95,77,4,81,624777
chr1,40936121,0.89,41,5,46,624778
chr1,40936152,1,37,0,37,624779
chr1,40936212,0.95,54,3,57,624780
chr1,40936469,0.93,102,8,110,624781
chr1,40936623,0.86,105,17,122,624782
chr1,40936688,0.59,77,53,130,624783
chr1,40936989,0.98,53,1,54,624784
chr1,40937091,0.97,72,2,74,624785
chr1,40937134,0.94,79,5,84,624786
chr1,40937222,0.91,68,7,75,624787
chr1,40937228,0.95,62,3,65,624788
chr1,40937297,0.94,61,4,65,624789
chr1,40937405,0.6,45,30,75,624790
chr1,40937634,0.83,53,11,64,624791
chr1,40937658,0.93,62,5,67,624792
chr1,40937726,0.93,42,3,45,624793
chr1,40937734,0.96,48,2,50,624794
chr1,40937758,0.91,60,6,66,624795
chr1,40937808,0.49,35,37,72,624796
chr1,40937849,0.88,38,5,43,624797
chr1,40937954,0.88,56,8,64,624798
chr1,40937966,0.94,63,4,67,624799
chr1,40938005,0.55,43,35,78,624800
chr1,40938105,0.93,26,2,28,624801
chr1,40938111,0.71,17,7,24,624802
chr1,40938276,0.67,2,1,3,624803
chr1,40938282,1,3,0,3,624804
chr1,40938307,1,15,0,15,624805
chr1,40938310,0.84,16,3,19,624806
chr1,40938450,0.85,90,16,106,624807
chr1,40938466,0.8,89,22,111,624808
chr1,40938750,0.51,49,47,96,624809
chr1,40939078,0.63,82,49,131,624810
chr1,40939336,0.86,79,13,92,624811
chr1,40939450,0.45,35,43,78,624812
chr1,40939490,0.97,67,2,69,624813
chr1,40939707,0.99,88,1,89,624814
chr1,40940341,0.85,64,11,75,624815
chr1,40940561,0.94,72,5,77,624816
chr1,40940578,0.98,63,1,64,624817
chr1,40940884,0.91,79,8,87,624818
chr1,40941063,0.93,71,5,76,624819
chr1,40941077,0.99,77,1,78,624820
chr1,40941491,0.96,95,4,99,624821
chr1,40941527,0.96,95,4,99,624822
chr1,40941651,0.92,83,7,90,624823
chr1,40941742,0.9,114,12,126,624824
chr1,40941905,0.69,59,27,86,624825
chr1,40942166,0.96,49,2,51,624826
chr1,40942226,0.87,61,9,70,624827
chr1,40942280,0.97,65,2,67,624828
chr1,40942296,0.98,63,1,64,624829
chr1,40942310,0.93,55,4,59,624830
chr1,40942312,0.97,59,2,61,624831
chr1,40942343,0.96,54,2,56,624832
chr1,40942351,0.75,44,15,59,624833
chr1,40942425,0.68,28,13,41,624834
chr1,40942541,0.44,30,38,68,624835
chr1,40942625,0.03,3,102,105,624836
chr1,40942646,0.06,6,100,106,624837
chr1,40942747,0,0,37,37,624838
chr1,40942755,0.01,1,90,91,624839
chr1,40942785,0,0,59,59,624840
chr1,40942798,0,0,51,51,624841
chr1,40942805,0,0,10,10,624842
chr1,40942808,0.21,3,11,14,624843
chr1,40942822,0,0,28,28,624844
chr1,40942831,0,0,34,34,624845
chr1,40942837,0,0,34,34,624846
chr1,40942841,0,0,30,30,624847
chr1,40942848,0,0,35,35,624848
chr1,40942854,0.09,1,10,11,624849
chr1,40942856,0,0,11,11,624850
chr1,40942860,0,0,38,38,624851
chr1,40942864,0,0,26,26,624852
chr1,40942878,0,0,43,43,624853
chr1,40942884,0,0,53,53,624854
chr1,40942892,0,0,32,32,624855
chr1,40942894,0.02,1,55,56,624856
chr1,40942904,0,0,55,55,624857
chr1,40942914,0,0,49,49,624858
chr1,40942921,0.01,1,78,79,624859
chr1,40942940,0.02,1,59,60,624860
chr1,40942946,0.01,1,82,83,624861
chr1,40942949,0,0,62,62,624862
chr1,40942967,0.02,1,65,66,624863
chr1,40942970,0,0,61,61,624864
chr1,40942977,0.01,1,73,74,624865
chr1,40942979,0,0,66,66,624866
chr1,40942981,0,0,64,64,624867
chr1,40943000,0,0,47,47,624868
chr1,40943006,0.02,1,63,64,624869
chr1,40943008,0,0,55,55,624870
chr1,40943022,0.02,1,55,56,624871
chr1,40943028,0,0,50,50,624872
chr1,40943042,0,0,51,51,624873
chr1,40943048,0.03,1,35,36,624874
chr1,40943052,0,0,46,46,624875
chr1,40943055,0,0,32,32,624876
chr1,40943064,0,0,36,36,624877
chr1,40943068,0,0,45,45,624878
chr1,40943076,0.04,1,25,26,624879
chr1,40943078,0,0,30,30,624880
chr1,40943082,0,0,49,49,624881
chr1,40943099,0,0,30,30,624882
chr1,40943108,0,0,52,52,624883
chr1,40943114,0.02,1,44,45,624884
chr1,40943152,0,0,46,46,624885
chr1,40943155,0.02,1,51,52,624886
chr1,40943161,0,0,59,59,624887
chr1,40943171,0.02,1,46,47,624888
chr1,40943197,0,0,52,52,624889
chr1,40943211,0,0,43,43,624890
chr1,40943214,0,0,55,55,624891
chr1,40943238,0.02,1,59,60,624892
chr1,40943253,0.02,1,52,53,624893
chr1,40943265,0,0,34,34,624894
chr1,40943285,0.02,1,63,64,624895
chr1,40943293,0,0,55,55,624896
chr1,40943325,0,0,71,71,624897
chr1,40943334,0,0,76,76,624898
chr1,40943341,0,0,68,68,624899
chr1,40943352,0.01,1,70,71,624900
chr1,40943360,0,0,69,69,624901
chr1,40943370,0,0,65,65,624902
chr1,40943379,0,0,59,59,624903
chr1,40943386,0.02,1,47,48,624904
chr1,40943406,0,0,43,43,624905
chr1,40943440,0.03,1,36,37,624906
chr1,40943472,0,0,43,43,624907
chr1,40943496,0,0,53,53,624908
chr1,40943526,0,0,57,57,624909
chr1,40943532,0,0,69,69,624910
chr1,40943560,0,0,79,79,624911
chr1,40943599,0,0,75,75,624912
chr1,40943642,0,0,67,67,624913
chr1,40943675,0,0,59,59,624914
chr1,40943686,0.02,1,53,54,624915
chr1,40943694,0.02,1,50,51,624916
chr1,40943770,0,0,31,31,624917
chr1,40943887,0.05,4,77,81,624918
chr1,40943895,0.05,4,77,81,624919
chr1,40943913,0.05,4,77,81,624920
chr1,40943934,0.09,7,67,74,624921
chr1,40944146,0.06,7,105,112,624922
chr1,40944158,0.03,3,109,112,624923
chr1,40944505,0.33,35,71,106,624924
chr1,40944626,0.25,22,66,88,624925
chr1,40944969,0.91,73,7,80,624926
chr1,40945066,0.78,85,24,109,624927
chr1,40945108,0.84,70,13,83,624928
chr1,40945119,0.96,72,3,75,624929
chr1,40945345,0.91,40,4,44,624930
chr1,40945913,0.94,58,4,62,624931
chr1,40945916,0.87,62,9,71,624932
chr1,40945968,1,47,0,47,624933
chr1,40945976,1,47,0,47,624934
chr1,40946040,0.98,54,1,55,624935
chr1,40946094,0.99,69,1,70,624936
chr1,40946609,0.92,110,10,120,624937
chr1,40946637,0.98,120,3,123,624938
chr1,40946700,0.98,98,2,100,624939
chr1,40946714,0.99,102,1,103,624940
chr1,40946730,1,102,0,102,624941
chr1,40946770,0.95,108,6,114,624942
chr1,40946774,0.95,105,6,111,624943
chr1,40947259,0.89,85,11,96,624944
chr1,40947460,0.88,42,6,48,624945
chr1,40947510,0.96,85,4,89,624946
chr1,40947833,0.99,88,1,89,624947
chr1,40948034,0.87,116,18,134,624948
chr1,40948115,0.91,104,10,114,624949
chr1,40948346,0.92,81,7,88,624950
chr1,40948392,0.96,78,3,81,624951
chr1,40948669,0.5,60,61,121,624952
chr1,40948679,0.91,103,10,113,624953
chr1,40948744,0.96,81,3,84,624954
chr1,40948794,0.91,68,7,75,624955
chr1,40948818,0.87,71,11,82,624956
chr1,40949152,0.98,94,2,96,624957
chr1,40949180,0.9,76,8,84,624958
chr1,40949330,0.96,74,3,77,624959
chr1,40949352,0.96,82,3,85,624960
chr1,40949470,0.9,65,7,72,624961
chr1,40949567,0.96,76,3,79,624962
chr1,40949577,0.95,75,4,79,624963
chr1,40949608,0.96,85,4,89,624964
chr1,40949644,0.99,87,1,88,624965
chr1,40949672,0.99,95,1,96,624966
chr1,40949679,0.99,93,1,94,624967
chr1,40949695,0.99,85,1,86,624968
chr1,40949703,0.99,84,1,85,624969
chr1,40949742,0.96,70,3,73,624970
chr1,40949934,0.96,54,2,56,624971
chr1,40949974,0.96,73,3,76,624972
chr1,40949996,0.97,77,2,79,624973
chr1,40950129,0.97,60,2,62,624974
chr1,40950160,0.95,75,4,79,624975
chr1,40950340,0.96,92,4,96,624976
chr1,40950394,0.98,85,2,87,624977
chr1,40950396,0.98,89,2,91,624978
chr1,40950410,0.98,86,2,88,624979
chr1,40950443,0.93,69,5,74,624980
chr1,40950488,1,50,0,50,624981
chr1,40950495,0.98,44,1,45,624982
chr1,40950499,0.96,43,2,45,624983
chr1,40950544,1,19,0,19,624984
chr1,40950633,0.98,41,1,42,624985
chr1,40950667,0.98,46,1,47,624986
chr1,40950689,0.98,46,1,47,624987
chr1,40950773,0.95,54,3,57,624988
chr1,40950784,1,65,0,65,624989
chr1,40950844,0.84,53,10,63,624990
chr1,40951058,0.88,95,13,108,624991
chr1,40951598,0.91,62,6,68,624992
chr1,40951736,0.9,55,6,61,624993
chr1,40952239,0.7,16,7,23,624994
chr1,40952657,1,45,0,45,624995
chr1,40952665,0.96,46,2,48,624996
chr1,40952682,0.98,54,1,55,624997
chr1,40952689,0.97,56,2,58,624998
chr1,40952721,1,44,0,44,624999
chr1,40952837,0.99,76,1,77,625000
chr1,40952841,0.96,75,3,78,625001
chr1,40952886,0.99,73,1,74,625002
chr1,40952890,0.97,76,2,78,625003
chr1,40952915,1,77,0,77,625004
chr1,40953133,1,92,0,92,625005
chr1,40953326,0.99,72,1,73,625006
chr1,40953400,0.96,82,3,85,625007
chr1,40953440,0.97,86,3,89,625008
chr1,40953444,0.99,82,1,83,625009
chr1,40953446,0.99,85,1,86,625010
chr1,40953456,0.99,78,1,79,625011
chr1,40953493,0.98,91,2,93,625012
chr1,40953516,0.99,85,1,86,625013
chr1,40953546,0.99,101,1,102,625014
chr1,40953579,0.96,97,4,101,625015
chr1,40953587,0.99,100,1,101,625016
chr1,40953591,0.98,98,2,100,625017
chr1,40953643,0.96,91,4,95,625018
chr1,40953667,0.97,66,2,68,625019
chr1,40953744,0.98,41,1,42,625020
chr1,40953750,0.93,42,3,45,625021
chr1,40953771,1,58,0,58,625022
chr1,40953906,0.83,63,13,76,625023
chr1,40954172,1,57,0,57,625024
chr1,40954395,0.96,94,4,98,625025
chr1,40954729,0.98,99,2,101,625026
chr1,40954844,0.95,72,4,76,625027
chr1,40955573,0.92,22,2,24,625028
chr1,40955581,1,30,0,30,625029
chr1,40955602,1,53,0,53,625030
chr1,40955627,1,78,0,78,625031
chr1,40955644,0.97,87,3,90,625032
chr1,40955666,0.93,78,6,84,625033
chr1,40955690,0.97,77,2,79,625034
chr1,40955698,0.54,40,34,74,625035
chr1,40955767,1,64,0,64,625036
chr1,40955789,0.97,68,2,70,625037
chr1,40955829,0.97,75,2,77,625038
chr1,40956073,0.98,55,1,56,625039
chr1,40956129,0.62,45,28,73,625040
chr1,40956408,0.92,111,10,121,625041
chr1,40956510,0.96,121,5,126,625042
chr1,40956709,0.9,101,11,112,625043
chr1,40957600,0.95,91,5,96,625044
chr1,40957754,0.91,69,7,76,625045
chr1,40958108,0.87,75,11,86,625046
chr1,40958578,0.92,57,5,62,625047
chr1,40958625,0.98,61,1,62,625048
chr1,40958668,0.98,56,1,57,625049
chr1,40958695,1,51,0,51,625050
chr1,40958762,0.98,61,1,62,625051
chr1,40958789,0.96,46,2,48,625052
chr1,40958811,0.92,34,3,37,625053
chr1,40958821,0.91,29,3,32,625054
chr1,40958853,0.85,22,4,26,625055
chr1,40958856,0.92,24,2,26,625056
chr1,40959129,0.98,105,2,107,625057
chr1,40959264,0.94,65,4,69,625058
chr1,40959763,0.97,77,2,79,625059
chr1,40959979,0.59,13,9,22,625060
chr1,40960033,0,0,3,3,625061
chr1,40960041,0,0,4,4,625062
chr1,40960161,1,5,0,5,625063
chr1,40960175,0.4,4,6,10,625064
chr1,40960182,1,11,0,11,625065
chr1,40960186,1,25,0,25,625066
chr1,40960191,0.9,26,3,29,625067
chr1,40960219,0.98,44,1,45,625068
chr1,40960229,0.96,50,2,52,625069
chr1,40960231,0.98,53,1,54,625070
chr1,40960235,0.98,54,1,55,625071
chr1,40960652,0.98,115,2,117,625072
chr1,40960710,0.95,113,6,119,625073
chr1,40960901,0.99,88,1,89,625074
chr1,40961165,0.96,64,3,67,625075
chr1,40961368,1,85,0,85,625076
chr1,40961421,0.99,77,1,78,625077
chr1,40961561,0.97,68,2,70,625078
chr1,40961635,0.96,91,4,95,625079
chr1,40961644,0.97,91,3,94,625080
chr1,40961684,0.97,99,3,102,625081
chr1,40961710,0.93,96,7,103,625082
chr1,40961717,0.93,95,7,102,625083
chr1,40962068,0.95,80,4,84,625084
chr1,40962242,0.98,98,2,100,625085
chr1,40962707,1,20,0,20,625086
chr1,40962747,1,37,0,37,625087
chr1,40962749,1,37,0,37,625088
chr1,40962761,1,43,0,43,625089
chr1,40962777,0.96,45,2,47,625090
chr1,40962878,1,62,0,62,625091
chr1,40962990,0.9,75,8,83,625092
chr1,40963035,0.96,77,3,80,625093
chr1,40963073,0.99,69,1,70,625094
chr1,40963098,0.98,60,1,61,625095
chr1,40963137,1,51,0,51,625096
chr1,40963201,0.96,47,2,49,625097
chr1,40963255,1,64,0,64,625098
chr1,40963264,1,67,0,67,625099
chr1,40963306,0.97,73,2,75,625100
chr1,40963419,0.49,42,44,86,625101
chr1,40963427,0.99,86,1,87,625102
chr1,40963461,0.97,90,3,93,625103
chr1,40963505,0.97,88,3,91,625104
chr1,40963610,0.95,54,3,57,625105
chr1,40963638,1,63,0,63,625106
chr1,40963650,0.59,33,23,56,625107
chr1,40963652,1,59,0,59,625108
chr1,40963692,1,28,0,28,625109
chr1,40964542,0.52,40,37,77,625110
chr1,40964546,0.95,70,4,74,625111
chr1,40964605,0.96,79,3,82,625112
chr1,40964622,1,79,0,79,625113
chr1,40964849,0.81,67,16,83,625114
chr1,40964934,0.88,107,14,121,625115
chr1,40964967,0.78,93,27,120,625116
chr1,40965288,0.91,59,6,65,625117
chr1,40965304,0.91,49,5,54,625118
chr1,40965326,0.97,36,1,37,625119
chr1,40965328,0.97,34,1,35,625120
chr1,40965334,1,31,0,31,625121
chr1,40965351,0.95,20,1,21,625122
chr1,40965366,0.85,11,2,13,625123
chr1,40965390,0.91,10,1,11,625124
chr1,40965414,1,21,0,21,625125
chr1,40965422,1,26,0,26,625126
chr1,40965455,0.93,39,3,42,625127
chr1,40965466,0.98,46,1,47,625128
chr1,40965511,1,51,0,51,625129
chr1,40965524,0.98,57,1,58,625130
chr1,40965551,1,59,0,59,625131
chr1,40965554,0.98,57,1,58,625132
chr1,40965556,0.98,57,1,58,625133
chr1,40965642,0.93,65,5,70,625134
chr1,40965663,0.99,67,1,68,625135
chr1,40965765,0.97,65,2,67,625136
chr1,40965958,0.86,49,8,57,625137
chr1,40966457,0.65,64,34,98,625138
chr1,40966489,0.96,118,5,123,625139
chr1,40966520,0.8,103,26,129,625140
chr1,40966600,0.94,111,7,118,625141
chr1,40966740,0.97,70,2,72,625142
chr1,40966771,0.96,71,3,74,625143
chr1,40966779,0.95,73,4,77,625144
chr1,40966835,0.55,47,38,85,625145
chr1,40966965,0.97,65,2,67,625146
chr1,40967057,0.95,80,4,84,625147
chr1,40967167,0.9,52,6,58,625148
chr1,40967357,0.99,81,1,82,625149
chr1,40967432,0.94,95,6,101,625150
chr1,40967529,0.98,100,2,102,625151
chr1,40967603,0.98,103,2,105,625152
chr1,40967892,1,91,0,91,625153
chr1,40968051,1,73,0,73,625154
chr1,40968059,0.99,78,1,79,625155
chr1,40968105,0.98,102,2,104,625156
chr1,40968114,0.99,105,1,106,625157
chr1,40968144,0.98,89,2,91,625158
chr1,40968184,0.96,72,3,75,625159
chr1,40968254,0.97,75,2,77,625160
chr1,40968602,0.92,55,5,60,625161
chr1,40968648,0.94,84,5,89,625162
chr1,40968682,0.97,110,3,113,625163
chr1,40968704,0.97,94,3,97,625164
chr1,40968733,0.94,84,5,89,625165
chr1,40968775,0.97,59,2,61,625166
chr1,40968866,0.98,57,1,58,625167
chr1,40969063,0.95,77,4,81,625168
chr1,40969114,0.94,65,4,69,625169
chr1,40969187,0.93,57,4,61,625170
chr1,40969220,0.72,21,8,29,625171
chr1,40969475,0.89,42,5,47,625172
chr1,40969561,0.93,54,4,58,625173
chr1,40969597,0.81,58,14,72,625174
chr1,40969665,0.88,79,11,90,625175
chr1,40969802,0.99,86,1,87,625176
chr1,40970431,0.98,41,1,42,625177
chr1,40970438,0.97,31,1,32,625178
chr1,40970542,0.99,74,1,75,625179
chr1,40970564,0.96,71,3,74,625180
chr1,40970898,0.99,101,1,102,625181
chr1,40971545,0.95,71,4,75,625182
chr1,40971575,0.99,81,1,82,625183
chr1,40971622,0.98,89,2,91,625184
chr1,40971678,0.97,65,2,67,625185
chr1,40971680,0.99,67,1,68,625186
chr1,40971703,1,59,0,59,625187
chr1,40971742,0.96,50,2,52,625188
chr1,40971762,0.94,46,3,49,625189
chr1,40971894,0.97,58,2,60,625190
chr1,40972034,0.94,46,3,49,625191
chr1,40972047,0.95,55,3,58,625192
chr1,40972218,1,78,0,78,625193
chr1,40972242,0.94,83,5,88,625194
chr1,40972252,0.98,88,2,90,625195
chr1,40972274,0.97,71,2,73,625196
chr1,40972310,0.98,56,1,57,625197
chr1,40972391,1,25,0,25,625198
chr1,40972400,0.97,28,1,29,625199
chr1,40972428,0.98,49,1,50,625200
chr1,40972438,1,50,0,50,625201
chr1,40972580,0.98,81,2,83,625202
chr1,40972608,0.96,75,3,78,625203
chr1,40972650,0.99,98,1,99,625204
chr1,40972711,0.98,97,2,99,625205
chr1,40972919,0.99,76,1,77,625206
chr1,40972936,0.99,88,1,89,625207
chr1,40973040,0.98,89,2,91,625208
chr1,40973093,0.99,91,1,92,625209
chr1,40973342,1,51,0,51,625210
chr1,40973389,0.93,56,4,60,625211
chr1,40973405,0.99,66,1,67,625212
chr1,40973412,0.99,77,1,78,625213
chr1,40973421,0.97,76,2,78,625214
chr1,40973539,0.98,47,1,48,625215
chr1,40973553,0.94,51,3,54,625216
chr1,40973560,0.96,49,2,51,625217
chr1,40973597,0.98,60,1,61,625218
chr1,40973607,1,71,0,71,625219
chr1,40973613,0.96,75,3,78,625220
chr1,40973710,0.93,93,7,100,625221
chr1,40973720,0.92,88,8,96,625222
chr1,40973810,0.88,88,12,100,625223
chr1,40973868,0.85,79,14,93,625224
chr1,40974006,0.17,11,54,65,625225
chr1,40974031,0.01,1,78,79,625226
chr1,40974057,0,0,80,80,625227
chr1,40974060,0.03,2,60,62,625228
chr1,40974092,0,0,83,83,625229
chr1,40974104,0,0,49,49,625230
chr1,40974110,0,0,66,66,625231
chr1,40974112,0,0,62,62,625232
chr1,40974123,0,0,66,66,625233
chr1,40974132,0,0,52,52,625234
chr1,40974152,0,0,63,63,625235
chr1,40974162,0.02,1,54,55,625236
chr1,40974182,0,0,51,51,625237
chr1,40974211,0,0,42,42,625238
chr1,40974215,0,0,52,52,625239
chr1,40974225,0,0,53,53,625240
chr1,40974239,0,0,56,56,625241
chr1,40974242,0,0,48,48,625242
chr1,40974291,0,0,44,44,625243
chr1,40974323,0,0,22,22,625244
chr1,40974331,0,0,15,15,625245
chr1,40974340,0,0,33,33,625246
chr1,40974348,0,0,37,37,625247
chr1,40974350,0,0,45,45,625248
chr1,40974359,0,0,39,39,625249
chr1,40974362,0,0,35,35,625250
chr1,40974365,0,0,37,37,625251
chr1,40974367,0,0,48,48,625252
chr1,40974385,0,0,46,46,625253
chr1,40974390,0,0,60,60,625254
chr1,40974400,0,0,58,58,625255
chr1,40974402,0.02,1,57,58,625256
chr1,40974429,0,0,55,55,625257
chr1,40974440,0,0,57,57,625258
chr1,40974447,0.02,1,48,49,625259
chr1,40974452,0,0,60,60,625260
chr1,40974465,0,0,53,53,625261
chr1,40974470,0,0,63,63,625262
chr1,40974476,0,0,50,50,625263
chr1,40974478,0,0,52,52,625264
chr1,40974487,0,0,65,65,625265
chr1,40974505,0,0,61,61,625266
chr1,40974508,0,0,64,64,625267
chr1,40974514,0.02,1,40,41,625268
chr1,40974518,0,0,63,63,625269
chr1,40974530,0.02,1,59,60,625270
chr1,40974536,0,0,51,51,625271
chr1,40974538,0,0,50,50,625272
chr1,40974541,0,0,45,45,625273
chr1,40974558,0,0,55,55,625274
chr1,40974565,0,0,55,55,625275
chr1,40974594,0,0,45,45,625276
chr1,40974616,0,0,45,45,625277
chr1,40974621,0,0,49,49,625278
chr1,40974644,0,0,43,43,625279
chr1,40974648,0,0,40,40,625280
chr1,40974651,0,0,43,43,625281
chr1,40974653,0,0,39,39,625282
chr1,40974673,0.05,1,18,19,625283
chr1,40974675,0,0,23,23,625284
chr1,40974682,0,0,28,28,625285
chr1,40974689,0.04,1,24,25,625286
chr1,40974694,0,0,27,27,625287
chr1,40974699,0,0,33,33,625288
chr1,40974716,0,0,46,46,625289
chr1,40974724,0,0,50,50,625290
chr1,40974737,0,0,41,41,625291
chr1,40974743,0,0,66,66,625292
chr1,40974763,0,0,81,81,625293
chr1,40974776,0,0,91,91,625294
chr1,40974785,0,0,90,90,625295
chr1,40974913,0.01,1,86,87,625296
chr1,40974917,0.01,1,104,105,625297
chr1,40974919,0.02,2,101,103,625298
chr1,40974934,0,0,110,110,625299
chr1,40974939,0.01,1,101,102,625300
chr1,40974967,0.02,2,103,105,625301
chr1,40975010,0.07,6,83,89,625302
chr1,40975076,0.11,10,80,90,625303
chr1,40975160,0.41,39,55,94,625304
chr1,40975168,0.48,46,50,96,625305
chr1,40975206,0.87,80,12,92,625306
chr1,40975210,0.76,62,20,82,625307
chr1,40975281,0.21,15,56,71,625308
chr1,40975319,0.85,50,9,59,625309
chr1,40975452,0.87,52,8,60,625310
chr1,40975513,0.95,42,2,44,625311
chr1,40975566,0.93,71,5,76,625312
chr1,40975580,1,82,0,82,625313
chr1,40975606,0.93,78,6,84,625314
chr1,40975719,1,81,0,81,625315
chr1,40976001,0.95,82,4,86,625316
chr1,40976006,0.98,87,2,89,625317
chr1,40976077,0.99,73,1,74,625318
chr1,40976635,1,52,0,52,625319
chr1,40976645,0.98,51,1,52,625320
chr1,40976673,1,50,0,50,625321
chr1,40976678,1,51,0,51,625322
chr1,40976689,0.98,45,1,46,625323
chr1,40976703,1,49,0,49,625324
chr1,40976723,1,60,0,60,625325
chr1,40976734,0.98,63,1,64,625326
chr1,40976767,0.96,51,2,53,625327
chr1,40976769,0.98,51,1,52,625328
chr1,40976775,1,44,0,44,625329
chr1,40976799,1,31,0,31,625330
chr1,40976823,0.95,18,1,19,625331
chr1,40976831,0.95,19,1,20,625332
chr1,40976863,1,20,0,20,625333
chr1,40977268,0.92,82,7,89,625334
chr1,40977291,0.96,96,4,100,625335
chr1,40977631,0.96,48,2,50,625336
chr1,40977636,0.95,61,3,64,625337
chr1,40977651,0.89,63,8,71,625338
chr1,40977684,0.98,90,2,92,625339
chr1,40977711,0.95,89,5,94,625340
chr1,40977750,0.94,64,4,68,625341
chr1,40977770,0.96,47,2,49,625342
chr1,40977791,1,35,0,35,625343
chr1,40977795,0.95,53,3,56,625344
chr1,40977828,0.99,73,1,74,625345
chr1,40977840,1,83,0,83,625346
chr1,40977848,0.97,86,3,89,625347
chr1,40978376,0.98,43,1,44,625348
chr1,40978398,0.98,61,1,62,625349
chr1,40978422,0.94,76,5,81,625350
chr1,40978434,0.97,85,3,88,625351
chr1,40978515,0.93,82,6,88,625352
chr1,40978539,0.92,66,6,72,625353
chr1,40978555,0.93,62,5,67,625354
chr1,40978583,0.95,54,3,57,625355
chr1,40978682,0.96,85,4,89,625356
chr1,40978714,0.98,86,2,88,625357
chr1,40978917,1,91,0,91,625358
chr1,40979096,0.97,74,2,76,625359
chr1,40979330,0.99,86,1,87,625360
chr1,40979530,0.98,42,1,43,625361
chr1,40979551,0.93,38,3,41,625362
chr1,40979556,1,47,0,47,625363
chr1,40979748,1,42,0,42,625364
chr1,40979779,1,32,0,32,625365
chr1,40979812,0.83,5,1,6,625366
chr1,40979820,1,3,0,3,625367
chr1,40979824,1,3,0,3,625368
chr1,40979844,1,11,0,11,625369
chr1,40979876,1,15,0,15,625370
chr1,40979900,1,19,0,19,625371
chr1,40979906,1,21,0,21,625372
chr1,40979908,1,23,0,23,625373
chr1,40979938,0.95,21,1,22,625374
chr1,40979946,1,19,0,19,625375
chr1,40980145,0.82,93,20,113,625376
chr1,40980800,0.98,57,1,58,625377
chr1,40980814,1,48,0,48,625378
chr1,40980820,1,47,0,47,625379
chr1,40981204,0.99,81,1,82,625380
chr1,40981224,0.99,80,1,81,625381
chr1,40981246,1,77,0,77,625382
chr1,40981250,0.99,70,1,71,625383
chr1,40981313,0.96,72,3,75,625384
chr1,40981777,0.97,90,3,93,625385
chr1,40981914,0.97,74,2,76,625386
chr1,40981940,0.99,71,1,72,625387
chr1,40982030,1,75,0,75,625388
chr1,40982041,0.99,74,1,75,625389
chr1,40982081,0.96,76,3,79,625390
chr1,40982085,0.99,76,1,77,625391
chr1,40982657,0.93,91,7,98,625392
chr1,40982661,0.96,91,4,95,625393
chr1,40983347,0.95,98,5,103,625394
chr1,40983577,0.97,72,2,74,625395
chr1,40983597,0.99,71,1,72,625396
chr1,40983624,1,66,0,66,625397
chr1,40983742,1,41,0,41,625398
chr1,40983764,1,39,0,39,625399
chr1,40983798,0.91,30,3,33,625400
chr1,40983828,1,26,0,26,625401
chr1,40983871,0.95,19,1,20,625402
chr1,40983875,1,21,0,21,625403
chr1,40983877,1,20,0,20,625404
chr1,40983887,1,27,0,27,625405
chr1,40983915,0.96,43,2,45,625406
chr1,40983920,0.98,46,1,47,625407
chr1,40983924,1,50,0,50,625408
chr1,40983965,0.93,63,5,68,625409
chr1,40984005,0.98,87,2,89,625410
chr1,40984009,0.96,82,3,85,625411
chr1,40984020,1,85,0,85,625412
chr1,40984040,0.98,84,2,86,625413
chr1,40984064,0.96,77,3,80,625414
chr1,40984096,0.98,52,1,53,625415
chr1,40984126,0.91,32,3,35,625416
chr1,40984503,0.99,69,1,70,625417
chr1,40984546,1,69,0,69,625418
chr1,40984578,0.97,62,2,64,625419
chr1,40984641,0.98,87,2,89,625420
chr1,40984718,0.5,62,61,123,625421
chr1,40984945,0.99,74,1,75,625422
chr1,40985020,0.92,72,6,78,625423
chr1,40985026,0.96,78,3,81,625424
chr1,40985043,0.98,81,2,83,625425
chr1,40985156,0.93,74,6,80,625426
chr1,40985451,0.54,40,34,74,625427
chr1,40985490,0.85,62,11,73,625428
chr1,40985645,0.97,111,4,115,625429
chr1,40985814,1,80,0,80,625430
chr1,40985954,0.98,48,1,49,625431
chr1,40986041,0.98,58,1,59,625432
chr1,40986262,0.89,92,11,103,625433
chr1,40986456,0.91,92,9,101,625434
chr1,40986500,0.94,64,4,68,625435
chr1,40986528,0.38,15,24,39,625436
chr1,40986544,0.97,29,1,30,625437
chr1,40986618,0.96,50,2,52,625438
chr1,40986622,0.91,51,5,56,625439
chr1,40986654,0.95,73,4,77,625440
chr1,40986678,0.99,72,1,73,625441
chr1,40986693,0.97,67,2,69,625442
chr1,40986710,0.98,65,1,66,625443
chr1,40986716,0.98,63,1,64,625444
chr1,40986998,0.93,100,8,108,625445
chr1,40987159,0.9,80,9,89,625446
chr1,40987300,0.51,36,35,71,625447
chr1,40987344,0.84,71,14,85,625448
chr1,40987354,0.92,80,7,87,625449
chr1,40987416,0.96,79,3,82,625450
chr1,40987448,0.89,70,9,79,625451
chr1,40987831,0.87,34,5,39,625452
chr1,40987846,0.89,31,4,35,625453
chr1,40987890,0.84,56,11,67,625454
chr1,40988161,0.91,71,7,78,625455
chr1,40988175,0.94,67,4,71,625456
chr1,40988596,0.78,64,18,82,625457
chr1,40988673,0.94,68,4,72,625458
chr1,40988718,0.98,58,1,59,625459
chr1,40988748,1,58,0,58,625460
chr1,40988756,0.92,61,5,66,625461
chr1,40988780,0.93,55,4,59,625462
chr1,40988812,1,53,0,53,625463
chr1,40988836,0.96,53,2,55,625464
chr1,40988876,0.96,71,3,74,625465
chr1,40988907,0.94,83,5,88,625466
chr1,40988977,0.93,67,5,72,625467
chr1,40989212,0.87,58,9,67,625468
chr1,40989298,0.93,40,3,43,625469
chr1,40989310,0.55,28,23,51,625470
chr1,40989428,0.93,67,5,72,625471
chr1,40989507,0.97,74,2,76,625472
chr1,40989517,0.97,66,2,68,625473
chr1,40989709,0.81,22,5,27,625474
chr1,40989718,0.94,32,2,34,625475
chr1,40989804,0.98,89,2,91,625476
chr1,40989841,0.95,79,4,83,625477
chr1,40989871,0.99,88,1,89,625478
chr1,40989882,0.86,74,12,86,625479
chr1,40989916,0.91,69,7,76,625480
chr1,40989932,1,75,0,75,625481
chr1,40989960,0.99,81,1,82,625482
chr1,40989976,0.98,87,2,89,625483
chr1,40990086,0.83,93,19,112,625484
chr1,40990122,0.96,91,4,95,625485
chr1,40990280,0.98,78,2,80,625486
chr1,40990327,0.94,74,5,79,625487
chr1,40990452,0.95,83,4,87,625488
chr1,40990560,0.86,64,10,74,625489
chr1,40990970,0.98,93,2,95,625490
chr1,40991029,0.96,77,3,80,625491
chr1,40991031,0.83,66,14,80,625492
chr1,40991041,0.84,61,12,73,625493
chr1,40991085,0.95,56,3,59,625494
chr1,40991119,0.88,46,6,52,625495
chr1,40991175,0.59,35,24,59,625496
chr1,40991195,0.76,54,17,71,625497
chr1,40991236,0.97,58,2,60,625498
chr1,40991253,0.8,41,10,51,625499
chr1,40991299,0.73,16,6,22,625500
chr1,40991507,0.97,84,3,87,625501
chr1,40991531,0.66,61,31,92,625502
chr1,40991848,0.88,80,11,91,625503
chr1,40991895,0.96,91,4,95,625504
chr1,40991910,0.97,87,3,90,625505
chr1,40992169,0.86,73,12,85,625506
chr1,40992199,0.94,76,5,81,625507
chr1,40992208,0.97,76,2,78,625508
chr1,40992292,0.95,59,3,62,625509
chr1,40992324,0.81,57,13,70,625510
chr1,40992346,0.91,79,8,87,625511
chr1,40992355,0.98,86,2,88,625512
chr1,40992648,1,46,0,46,625513
chr1,40992705,0.13,5,35,40,625514
chr1,40992872,0.57,16,12,28,625515
chr1,40992917,0,0,24,24,625516
chr1,40993425,0.52,58,53,111,625517
chr1,40993506,0.26,18,51,69,625518
chr1,40994701,0.14,12,74,86,625519
chr1,40995216,0.65,15,8,23,625520
chr1,40995319,0.95,54,3,57,625521
chr1,40995422,0.92,83,7,90,625522
chr1,40995579,0.79,77,21,98,625523
chr1,40995842,0.89,47,6,53,625524
chr1,40995880,0.91,50,5,55,625525
chr1,40995941,1,47,0,47,625526
chr1,40995949,0.98,39,1,40,625527
chr1,40995979,0.97,32,1,33,625528
chr1,40996003,0.95,39,2,41,625529
chr1,40996022,0.98,57,1,58,625530
chr1,40996055,0.95,71,4,75,625531
chr1,40996067,0.96,70,3,73,625532
chr1,40996071,0.94,75,5,80,625533
chr1,40996099,0.92,65,6,71,625534
chr1,40996112,0.86,56,9,65,625535
chr1,40996190,0.99,94,1,95,625536
chr1,40996202,0.99,93,1,94,625537
chr1,40996296,0.52,37,34,71,625538
chr1,40996318,0.86,59,10,69,625539
chr1,40996326,0.84,53,10,63,625540
chr1,40996360,0.95,74,4,78,625541
chr1,40996402,0.87,69,10,79,625542
chr1,40996589,0.34,24,46,70,625543
chr1,40996599,0.62,51,31,82,625544
chr1,40996687,0.37,41,71,112,625545
chr1,40996787,0.09,10,98,108,625546
chr1,40996996,0.04,4,107,111,625547
chr1,40997061,0,0,103,103,625548
chr1,40997064,0,0,115,115,625549
chr1,40997115,0.01,1,89,90,625550
chr1,40997127,0,0,78,78,625551
chr1,40997161,0.01,1,79,80,625552
chr1,40997171,0,0,55,55,625553
chr1,40997196,0.03,2,72,74,625554
chr1,40997203,0,0,88,88,625555
chr1,40997210,0,0,92,92,625556
chr1,40997216,0,0,97,97,625557
chr1,40997250,0.01,1,109,110,625558
chr1,40997253,0,0,111,111,625559
chr1,40997268,0.02,2,107,109,625560
chr1,40997306,0.01,1,104,105,625561
chr1,40997312,0.01,1,105,106,625562
chr1,40997314,0.01,1,102,103,625563
chr1,40997324,0.01,1,102,103,625564
chr1,40997331,0,0,102,102,625565
chr1,40997353,0.01,1,84,85,625566
chr1,40997356,0.02,2,94,96,625567
chr1,40997358,0,0,95,95,625568
chr1,40997367,0.01,1,86,87,625569
chr1,40997371,0,0,65,65,625570
chr1,40997396,0,0,82,82,625571
chr1,40997399,0.01,1,83,84,625572
chr1,40997426,0,0,76,76,625573
chr1,40997434,0,0,76,76,625574
chr1,40997438,0,0,67,67,625575
chr1,40997478,0,0,67,67,625576
chr1,40997485,0,0,61,61,625577
chr1,40997498,0.03,1,34,35,625578
chr1,40997526,0,0,67,67,625579
chr1,40997551,0.02,1,64,65,625580
chr1,40997592,0.01,1,78,79,625581
chr1,40997624,0.01,1,81,82,625582
chr1,40997767,0,0,109,109,625583
chr1,40997780,0,0,99,99,625584
chr1,40997794,0.01,1,100,101,625585
chr1,40998124,0.44,44,56,100,625586
chr1,40998206,0.63,55,33,88,625587
chr1,40998264,0.88,67,9,76,625588
chr1,40998405,0.12,9,64,73,625589
chr1,40998455,0.75,81,27,108,625590
chr1,40999238,0.98,93,2,95,625591
chr1,40999556,0.91,31,3,34,625592
chr1,40999598,0.97,59,2,61,625593
chr1,40999652,0.95,83,4,87,625594
chr1,40999684,0.9,81,9,90,625595
chr1,40999715,0.89,96,12,108,625596
chr1,40999790,0.99,83,1,84,625597
chr1,40999794,0.99,85,1,86,625598
chr1,41000061,0.93,27,2,29,625599
chr1,41000069,0.96,26,1,27,625600
chr1,41000073,0.8,20,5,25,625601
chr1,41000132,0.95,21,1,22,625602
chr1,41000202,0.97,66,2,68,625603
chr1,41000208,0.99,74,1,75,625604
chr1,41001235,0.94,72,5,77,625605
chr1,41001721,0.97,75,2,77,625606
chr1,41001787,0.95,54,3,57,625607
chr1,41001803,1,45,0,45,625608
chr1,41001836,1,21,0,21,625609
chr1,41001847,1,9,0,9,625610
chr1,41001861,1,4,0,4,625611
chr1,41001892,0.94,15,1,16,625612
chr1,41001922,0.97,31,1,32,625613
chr1,41001934,0.95,41,2,43,625614
chr1,41001938,1,44,0,44,625615
chr1,41001990,0.97,58,2,60,625616
chr1,41002014,0.94,49,3,52,625617
chr1,41002020,0.94,48,3,51,625618
chr1,41002052,1,30,0,30,625619
chr1,41002060,0.96,23,1,24,625620
chr1,41002274,1,1,0,1,625621
chr1,41002634,0.92,58,5,63,625622
chr1,41002647,0.93,71,5,76,625623
chr1,41002755,0.94,34,2,36,625624
chr1,41002921,0.99,99,1,100,625625
chr1,41003186,1,95,0,95,625626
chr1,41003240,0.98,82,2,84,625627
chr1,41003393,0.93,39,3,42,625628
chr1,41003409,0.95,37,2,39,625629
chr1,41004182,0.55,65,53,118,625630
chr1,41004300,0.92,49,4,53,625631
chr1,41004358,0.96,45,2,47,625632
chr1,41004444,0.99,79,1,80,625633
chr1,41004467,0.38,35,56,91,625634
chr1,41004525,0.9,94,10,104,625635
chr1,41004567,0.98,92,2,94,625636
chr1,41004762,1,39,0,39,625637
chr1,41004770,0.95,39,2,41,625638
chr1,41004787,0.98,46,1,47,625639
chr1,41004794,0.98,46,1,47,625640
chr1,41004846,0.98,56,1,57,625641
chr1,41004862,0.93,55,4,59,625642
chr1,41004891,1,37,0,37,625643
chr1,41004922,1,37,0,37,625644
chr1,41004936,0.95,39,2,41,625645
chr1,41004952,0.98,42,1,43,625646
chr1,41005084,0.91,60,6,66,625647
chr1,41005202,0.57,39,30,69,625648
chr1,41005205,0.67,26,13,39,625649
chr1,41005250,0.88,79,11,90,625650
chr1,41005263,0.92,82,7,89,625651
chr1,41005302,0.86,77,13,90,625652
chr1,41005354,0.96,74,3,77,625653
chr1,41006117,0.89,68,8,76,625654
chr1,41006212,0.93,100,8,108,625655
chr1,41006460,0.66,71,36,107,625656
chr1,41006477,0.94,102,6,108,625657
chr1,41006555,0.84,92,18,110,625658
chr1,41006643,0.96,71,3,74,625659
chr1,41006725,0.73,29,11,40,625660
chr1,41006813,0.89,55,7,62,625661
chr1,41006897,0.97,29,1,30,625662
chr1,41006935,0.96,49,2,51,625663
chr1,41006956,0.96,55,2,57,625664
chr1,41006980,0.9,53,6,59,625665
chr1,41007012,0.98,42,1,43,625666
chr1,41007016,0.97,38,1,39,625667
chr1,41007076,0.94,34,2,36,625668
chr1,41007097,1,42,0,42,625669
chr1,41007101,0.94,47,3,50,625670
chr1,41007123,0.94,66,4,70,625671
chr1,41007134,0.95,70,4,74,625672
chr1,41007144,0.9,66,7,73,625673
chr1,41007146,0.96,72,3,75,625674
chr1,41007359,1,60,0,60,625675
chr1,41007369,0.95,63,3,66,625676
chr1,41007554,0.74,34,12,46,625677
chr1,41007704,0.92,73,6,79,625678
chr1,41007721,0.94,82,5,87,625679
chr1,41007761,0.97,87,3,90,625680
chr1,41008077,0.96,75,3,78,625681
chr1,41008520,0.96,116,5,121,625682
chr1,41009146,0.84,46,9,55,625683
chr1,41009189,0.94,81,5,86,625684
chr1,41009214,0.99,76,1,77,625685
chr1,41009221,1,83,0,83,625686
chr1,41009229,0.96,74,3,77,625687
chr1,41009253,0.96,72,3,75,625688
chr1,41009318,1,68,0,68,625689
chr1,41009331,0.91,64,6,70,625690
chr1,41009349,0.97,66,2,68,625691
chr1,41009374,1,66,0,66,625692
chr1,41009407,1,77,0,77,625693
chr1,41009419,0.98,84,2,86,625694
chr1,41009435,0.97,87,3,90,625695
chr1,41010074,0.97,77,2,79,625696
chr1,41010082,0.99,69,1,70,625697
chr1,41010103,0.99,69,1,70,625698
chr1,41010116,0.94,63,4,67,625699
chr1,41010148,0.45,33,40,73,625700
chr1,41010168,0.99,66,1,67,625701
chr1,41010172,0.97,67,2,69,625702
chr1,41010214,0.99,67,1,68,625703
chr1,41010268,0.99,76,1,77,625704
chr1,41010311,0.97,103,3,106,625705
chr1,41010352,0.96,123,5,128,625706
chr1,41010559,0.96,96,4,100,625707
chr1,41010598,0.98,99,2,101,625708
chr1,41010789,0.91,49,5,54,625709
chr1,41010803,1,52,0,52,625710
chr1,41010895,0.99,74,1,75,625711
chr1,41010966,0.99,74,1,75,625712
chr1,41011241,0.98,128,2,130,625713
chr1,41011626,0.92,34,3,37,625714
chr1,41011655,0.98,56,1,57,625715
chr1,41011663,0.93,53,4,57,625716
chr1,41011755,0.96,74,3,77,625717
chr1,41011839,0.96,53,2,55,625718
chr1,41011844,0.95,58,3,61,625719
chr1,41011872,0.98,52,1,53,625720
chr1,41011879,0.97,57,2,59,625721
chr1,41011978,0.95,94,5,99,625722
chr1,41012003,0.99,105,1,106,625723
chr1,41012168,0.95,86,5,91,625724
chr1,41012272,0.96,88,4,92,625725
chr1,41012399,0.91,90,9,99,625726
chr1,41012466,0.99,94,1,95,625727
chr1,41012487,0.98,85,2,87,625728
chr1,41012663,0.99,69,1,70,625729
chr1,41012685,0.96,68,3,71,625730
chr1,41012778,0.95,78,4,82,625731
chr1,41012931,0.94,75,5,80,625732
chr1,41013873,0.98,92,2,94,625733
chr1,41013951,0.98,45,1,46,625734
chr1,41013979,0.95,55,3,58,625735
chr1,41014013,0.97,73,2,75,625736
chr1,41014055,0.96,70,3,73,625737
chr1,41014130,0.94,76,5,81,625738
chr1,41014144,0.98,82,2,84,625739
chr1,41014160,0.99,91,1,92,625740
chr1,41014168,0.99,94,1,95,625741
chr1,41014188,0.97,84,3,87,625742
chr1,41014200,0.99,81,1,82,625743
chr1,41014204,0.99,87,1,88,625744
chr1,41014335,0.98,62,1,63,625745
chr1,41014373,0.77,40,12,52,625746
chr1,41014398,0.92,44,4,48,625747
chr1,41014413,0.92,46,4,50,625748
chr1,41014437,0.97,38,1,39,625749
chr1,41014457,1,29,0,29,625750
chr1,41014515,0.82,9,2,11,625751
chr1,41014528,0.71,15,6,21,625752
chr1,41014546,0.97,33,1,34,625753
chr1,41014560,0.93,40,3,43,625754
chr1,41014604,0.99,67,1,68,625755
chr1,41014620,0.92,60,5,65,625756
chr1,41014679,1,34,0,34,625757
chr1,41014693,0.94,30,2,32,625758
chr1,41014709,0.97,32,1,33,625759
chr1,41014737,0.98,45,1,46,625760
chr1,41014831,0.98,79,2,81,625761
chr1,41014886,1,81,0,81,625762
chr1,41014892,0.99,80,1,81,625763
chr1,41015092,0.73,38,14,52,625764
chr1,41015112,0.89,57,7,64,625765
chr1,41015446,0.97,101,3,104,625766
chr1,41015640,0.54,43,36,79,625767
chr1,41015745,0.59,32,22,54,625768
chr1,41015907,0.9,77,9,86,625769
chr1,41016009,0.88,81,11,92,625770
chr1,41016234,0.95,59,3,62,625771
chr1,41016332,0.96,87,4,91,625772
chr1,41016351,0.98,100,2,102,625773
chr1,41016513,0.98,64,1,65,625774
chr1,41016518,1,58,0,58,625775
chr1,41016647,0.9,60,7,67,625776
chr1,41016683,0.86,43,7,50,625777
chr1,41016707,0.98,51,1,52,625778
chr1,41017284,0.81,21,5,26,625779
chr1,41017322,0.95,55,3,58,625780
chr1,41017324,1,59,0,59,625781
chr1,41017530,0.93,62,5,67,625782
chr1,41017754,0.86,78,13,91,625783
chr1,41017914,0.74,64,23,87,625784
chr1,41017954,0.41,53,77,130,625785
chr1,41017970,0.88,129,17,146,625786
chr1,41018120,0.89,92,11,103,625787
chr1,41018429,0.9,55,6,61,625788
chr1,41018457,0.91,51,5,56,625789
chr1,41018461,0.98,47,1,48,625790
chr1,41018549,0.94,46,3,49,625791
chr1,41018801,0.67,74,36,110,625792
chr1,41018839,0.86,91,15,106,625793
chr1,41018910,0.67,58,29,87,625794
chr1,41019080,0.75,71,24,95,625795
chr1,41019176,0.88,91,12,103,625796
chr1,41019263,0.89,88,11,99,625797
chr1,41019798,1,55,0,55,625798
chr1,41020047,1,17,0,17,625799
chr1,41020069,1,21,0,21,625800
chr1,41020133,0.85,41,7,48,625801
chr1,41020157,0.96,49,2,51,625802
chr1,41020197,0.9,35,4,39,625803
chr1,41020228,0.88,36,5,41,625804
chr1,41020295,0.56,37,29,66,625805
chr1,41020304,0.87,58,9,67,625806
chr1,41020308,0.88,59,8,67,625807
chr1,41020400,0.94,51,3,54,625808
chr1,41020425,0.94,67,4,71,625809
chr1,41020464,0.4,37,56,93,625810
chr1,41020500,0.79,77,21,98,625811
chr1,41020528,0.8,68,17,85,625812
chr1,41020582,0.79,46,12,58,625813
chr1,41020618,0.46,29,34,63,625814
chr1,41020628,0.35,20,37,57,625815
chr1,41020630,0.6,36,24,60,625816
chr1,41020634,0.51,35,34,69,625817
chr1,41020928,0.9,98,11,109,625818
chr1,41020968,0.87,90,14,104,625819
chr1,41021365,0.66,75,38,113,625820
chr1,41021635,0.93,64,5,69,625821
chr1,41021643,0.91,59,6,65,625822
chr1,41021689,1,72,0,72,625823
chr1,41021750,0.9,84,9,93,625824
chr1,41021760,0.98,99,2,101,625825
chr1,41021765,0.94,96,6,102,625826
chr1,41021775,0.83,90,18,108,625827
chr1,41021844,0.96,95,4,99,625828
chr1,41021891,0.91,79,8,87,625829
chr1,41022001,0.98,95,2,97,625830
chr1,41022175,0.98,136,3,139,625831
chr1,41022184,0.95,133,7,140,625832
chr1,41022385,0.75,97,32,129,625833
chr1,41022483,0.86,101,16,117,625834
chr1,41022485,0.79,93,24,117,625835
chr1,41022555,0.59,67,47,114,625836
chr1,41022575,0.68,61,29,90,625837
chr1,41022745,1,22,0,22,625838
chr1,41022747,0.89,16,2,18,625839
chr1,41022794,0.77,20,6,26,625840
chr1,41022800,0.88,30,4,34,625841
chr1,41022861,0.76,68,21,89,625842
chr1,41023090,0.58,52,37,89,625843
chr1,41023092,0.99,82,1,83,625844
chr1,41023115,0.89,76,9,85,625845
chr1,41023159,0.98,92,2,94,625846
chr1,41023169,0.99,96,1,97,625847
chr1,41023171,0.98,98,2,100,625848
chr1,41023196,0.97,95,3,98,625849
chr1,41023225,0.3,27,64,91,625850
chr1,41023229,0.93,85,6,91,625851
chr1,41023322,0.96,92,4,96,625852
chr1,41023324,0.91,83,8,91,625853
chr1,41023328,0.91,100,10,110,625854
chr1,41023356,0.93,124,10,134,625855
chr1,41023359,0.42,54,74,128,625856
chr1,41023364,0.96,129,5,134,625857
chr1,41023395,0.56,75,59,134,625858
chr1,41024083,0.91,86,8,94,625859
chr1,41024527,1,31,0,31,625860
chr1,41024531,0.98,41,1,42,625861
chr1,41024540,0.89,39,5,44,625862
chr1,41024553,1,54,0,54,625863
chr1,41024604,0.98,61,1,62,625864
chr1,41024610,1,59,0,59,625865
chr1,41024617,1,62,0,62,625866
chr1,41024628,1,49,0,49,625867
chr1,41024632,0.93,41,3,44,625868
chr1,41024649,0.97,32,1,33,625869
chr1,41024663,0.85,23,4,27,625870
chr1,41024672,0.84,21,4,25,625871
chr1,41024697,0.95,18,1,19,625872
chr1,41024699,0.96,23,1,24,625873
chr1,41024721,1,38,0,38,625874
chr1,41024729,0.98,39,1,40,625875
chr1,41024738,0.98,43,1,44,625876
chr1,41024744,0.91,41,4,45,625877
chr1,41024769,0.98,48,1,49,625878
chr1,41024797,0.98,45,1,46,625879
chr1,41024815,0.95,39,2,41,625880
chr1,41024818,1,41,0,41,625881
chr1,41024826,0.98,40,1,41,625882
chr1,41024830,0.98,39,1,40,625883
chr1,41024848,1,40,0,40,625884
chr1,41024859,1,36,0,36,625885
chr1,41024867,0.95,36,2,38,625886
chr1,41024874,0.94,34,2,36,625887
chr1,41024876,0.8,20,5,25,625888
chr1,41024890,0.94,32,2,34,625889
chr1,41024892,0.72,21,8,29,625890
chr1,41024916,1,31,0,31,625891
chr1,41024947,0.92,36,3,39,625892
chr1,41024956,0.95,41,2,43,625893
chr1,41025001,0.99,67,1,68,625894
chr1,41025042,0.98,57,1,58,625895
chr1,41025048,1,61,0,61,625896
chr1,41025082,0.96,55,2,57,625897
chr1,41025126,0.89,64,8,72,625898
chr1,41025270,1,67,0,67,625899
chr1,41025458,0.92,77,7,84,625900
chr1,41025829,0.98,79,2,81,625901
chr1,41025841,0.71,57,23,80,625902
chr1,41025989,0.88,21,3,24,625903
chr1,41026021,0.9,28,3,31,625904
chr1,41026035,0.55,22,18,40,625905
chr1,41026061,0.92,44,4,48,625906
chr1,41026083,0.96,48,2,50,625907
chr1,41026105,0.94,47,3,50,625908
chr1,41026205,0.95,55,3,58,625909
chr1,41026238,0.86,66,11,77,625910
chr1,41026254,0.97,91,3,94,625911
chr1,41026318,0.9,108,12,120,625912
chr1,41026484,0.83,97,20,117,625913
chr1,41026497,0.98,122,2,124,625914
chr1,41026809,0.97,137,4,141,625915
chr1,41026877,0.95,86,5,91,625916
chr1,41027071,0.89,47,6,53,625917
chr1,41027136,0.87,48,7,55,625918
chr1,41027168,0.96,72,3,75,625919
chr1,41027286,0.99,66,1,67,625920
chr1,41027311,0.99,75,1,76,625921
chr1,41027435,0.97,57,2,59,625922
chr1,41027443,0.95,59,3,62,625923
chr1,41027467,0.9,60,7,67,625924
chr1,41027507,0.95,61,3,64,625925
chr1,41027632,0.89,56,7,63,625926
chr1,41027952,0.88,107,15,122,625927
chr1,41028041,0.88,117,16,133,625928
chr1,41028428,0.91,71,7,78,625929
chr1,41028604,0.9,46,5,51,625930
chr1,41028606,0.98,51,1,52,625931
chr1,41028636,0.93,66,5,71,625932
chr1,41028668,0.86,68,11,79,625933
chr1,41028704,0.86,49,8,57,625934
chr1,41028731,0.97,33,1,34,625935
chr1,41028762,0.96,22,1,23,625936
chr1,41028789,0.95,42,2,44,625937
chr1,41028794,0.89,42,5,47,625938
chr1,41028831,0.95,72,4,76,625939
chr1,41028834,0.95,70,4,74,625940
chr1,41028943,0.78,58,16,74,625941
chr1,41029092,0.89,87,11,98,625942
chr1,41029112,0.91,95,9,104,625943
chr1,41029174,0.88,95,13,108,625944
chr1,41029445,0.57,39,30,69,625945
chr1,41030033,0.86,63,10,73,625946
chr1,41030259,0.65,62,34,96,625947
chr1,41030440,0.62,78,47,125,625948
chr1,41030499,0.95,127,6,133,625949
chr1,41030783,0.82,55,12,67,625950
chr1,41030879,0.96,95,4,99,625951
chr1,41030917,1,76,0,76,625952
chr1,41031097,0.97,28,1,29,625953
chr1,41031120,0.97,36,1,37,625954
chr1,41031192,1,58,0,58,625955
chr1,41031257,0.89,58,7,65,625956
chr1,41031260,0.88,56,8,64,625957
chr1,41031300,0.89,57,7,64,625958
chr1,41031319,0.92,54,5,59,625959
chr1,41031369,0.76,57,18,75,625960
chr1,41031548,0.96,85,4,89,625961
chr1,41031593,0.93,43,3,46,625962
chr1,41031715,0.92,69,6,75,625963
chr1,41031858,0.9,46,5,51,625964
chr1,41032038,0.97,121,4,125,625965
chr1,41032327,0.98,48,1,49,625966
chr1,41032358,0.98,44,1,45,625967
chr1,41032366,0.94,48,3,51,625968
chr1,41032390,0.95,58,3,61,625969
chr1,41032400,0.93,56,4,60,625970
chr1,41032442,0.93,57,4,61,625971
chr1,41032444,0.92,56,5,61,625972
chr1,41032454,0.97,60,2,62,625973
chr1,41032519,0.91,29,3,32,625974
chr1,41032546,0.92,35,3,38,625975
chr1,41032591,0.92,61,5,66,625976
chr1,41032969,0.88,68,9,77,625977
chr1,41033760,0.87,87,13,100,625978
chr1,41034260,0.89,56,7,63,625979
chr1,41034290,0.9,70,8,78,625980
chr1,41034296,0.95,74,4,78,625981
chr1,41034312,0.86,68,11,79,625982
chr1,41034476,0.91,71,7,78,625983
chr1,41034716,0.61,77,49,126,625984
chr1,41035242,0.86,66,11,77,625985
chr1,41035367,0.61,19,12,31,625986
chr1,41035383,0.89,24,3,27,625987
chr1,41035405,0.94,33,2,35,625988
chr1,41035455,0.94,50,3,53,625989
chr1,41035469,0.97,60,2,62,625990
chr1,41035489,1,72,0,72,625991
chr1,41035493,0.99,70,1,71,625992
chr1,41035763,0.9,52,6,58,625993
chr1,41035808,0.89,75,9,84,625994
chr1,41035840,0.88,69,9,78,625995
chr1,41035876,0.88,45,6,51,625996
chr1,41035936,0.91,49,5,54,625997
chr1,41036216,0.91,69,7,76,625998
chr1,41036260,0.91,72,7,79,625999
chr1,41036269,0.93,71,5,76,626000
chr1,41036292,0.97,74,2,76,626001
chr1,41036339,0.91,85,8,93,626002
chr1,41036343,0.99,92,1,93,626003
chr1,41036353,0.99,95,1,96,626004
chr1,41036355,0.99,91,1,92,626005
chr1,41036397,0.99,96,1,97,626006
chr1,41036408,0.93,98,7,105,626007
chr1,41036439,0.96,97,4,101,626008
chr1,41036477,0.85,82,15,97,626009
chr1,41037084,0.48,22,24,46,626010
chr1,41037115,0.9,26,3,29,626011
chr1,41037156,0.79,19,5,24,626012
chr1,41037228,0.93,55,4,59,626013
chr1,41037453,0.91,96,9,105,626014
chr1,41037547,0.99,70,1,71,626015
chr1,41037592,0.83,53,11,64,626016
chr1,41037605,0.96,68,3,71,626017
chr1,41037638,0.95,79,4,83,626018
chr1,41037648,0.98,85,2,87,626019
chr1,41037692,0.93,77,6,83,626020
chr1,41037695,0.93,81,6,87,626021
chr1,41037838,0.8,43,11,54,626022
chr1,41037991,0.95,41,2,43,626023
chr1,41037999,0.94,33,2,35,626024
chr1,41038073,0.68,40,19,59,626025
chr1,41038095,0.78,54,15,69,626026
chr1,41038107,0.89,72,9,81,626027
chr1,41038115,0.85,74,13,87,626028
chr1,41038159,0.86,65,11,76,626029
chr1,41038204,0.73,51,19,70,626030
chr1,41038227,0.77,54,16,70,626031
chr1,41038239,0.67,41,20,61,626032
chr1,41038275,0.74,35,12,47,626033
chr1,41038301,0.91,29,3,32,626034
chr1,41038469,0.89,8,1,9,626035
chr1,41038541,0.71,20,8,28,626036
chr1,41038625,0.68,36,17,53,626037
chr1,41038730,0.9,43,5,48,626038
chr1,41038870,0.99,70,1,71,626039
chr1,41038898,0.93,66,5,71,626040
chr1,41038958,0.83,90,18,108,626041
chr1,41039033,0.93,110,8,118,626042
chr1,41039042,0.95,110,6,116,626043
chr1,41039237,0.95,94,5,99,626044
chr1,41039375,0.95,82,4,86,626045
chr1,41039424,0.92,48,4,52,626046
chr1,41039559,1,62,0,62,626047
chr1,41039611,0.98,43,1,44,626048
chr1,41039618,0.98,41,1,42,626049
chr1,41039673,0.85,46,8,54,626050
chr1,41039843,0.8,36,9,45,626051
chr1,41039907,0.94,60,4,64,626052
chr1,41040010,0.96,66,3,69,626053
chr1,41040033,0.87,55,8,63,626054
chr1,41040065,0.58,31,22,53,626055
chr1,41040509,1,61,0,61,626056
chr1,41040867,0.85,56,10,66,626057
chr1,41040875,0.89,65,8,73,626058
chr1,41040909,0.93,75,6,81,626059
chr1,41040951,0.92,46,4,50,626060
chr1,41040963,0.98,45,1,46,626061
chr1,41040995,0.82,37,8,45,626062
chr1,41041508,0.78,73,20,93,626063
chr1,41041681,0.95,89,5,94,626064
chr1,41041786,0.94,72,5,77,626065
chr1,41041874,0.96,73,3,76,626066
chr1,41042051,0.93,66,5,71,626067
chr1,41042067,0.94,68,4,72,626068
chr1,41042450,0.9,44,5,49,626069
chr1,41042496,0.87,40,6,46,626070
chr1,41042896,0.51,45,44,89,626071
chr1,41042989,0.69,56,25,81,626072
chr1,41043012,0.9,62,7,69,626073
chr1,41043377,0.61,45,29,74,626074
chr1,41043399,0.99,81,1,82,626075
chr1,41043605,0.93,66,5,71,626076
chr1,41044189,0.73,43,16,59,626077
chr1,41044280,0.86,62,10,72,626078
chr1,41044345,0.91,75,7,82,626079
chr1,41044616,0.9,69,8,77,626080
chr1,41044921,0.98,101,2,103,626081
chr1,41045428,0.93,70,5,75,626082
chr1,41045550,0.97,61,2,63,626083
chr1,41045779,0.93,101,8,109,626084
chr1,41045784,0.91,106,10,116,626085
chr1,41045839,0.96,110,4,114,626086
chr1,41045893,0.98,99,2,101,626087
chr1,41045940,0.96,100,4,104,626088
chr1,41045957,0.95,96,5,101,626089
chr1,41045986,0.91,79,8,87,626090
chr1,41046060,0.93,42,3,45,626091
chr1,41046066,1,46,0,46,626092
chr1,41046068,0.98,41,1,42,626093
chr1,41046076,0.98,44,1,45,626094
chr1,41046273,0.69,47,21,68,626095
chr1,41046279,0.88,60,8,68,626096
chr1,41046293,0.92,61,5,66,626097
chr1,41046333,0.81,46,11,57,626098
chr1,41046364,0.92,46,4,50,626099
chr1,41046408,0.95,52,3,55,626100
chr1,41046424,1,57,0,57,626101
chr1,41046444,0.95,56,3,59,626102
chr1,41046466,0.95,57,3,60,626103
chr1,41046476,0.92,54,5,59,626104
chr1,41046487,0.98,57,1,58,626105
chr1,41046783,0.92,102,9,111,626106
chr1,41046879,0.97,87,3,90,626107
chr1,41047122,0.98,103,2,105,626108
chr1,41047153,1,112,0,112,626109
chr1,41047157,0.99,107,1,108,626110
chr1,41047175,0.99,103,1,104,626111
chr1,41047200,0.98,96,2,98,626112
chr1,41047225,0.96,92,4,96,626113
chr1,41047302,0.99,76,1,77,626114
chr1,41047321,1,60,0,60,626115
chr1,41047386,0.98,78,2,80,626116
chr1,41047435,0.91,86,8,94,626117
chr1,41047472,0.84,77,15,92,626118
chr1,41047557,1,82,0,82,626119
chr1,41047586,0.96,87,4,91,626120
chr1,41047594,0.94,78,5,83,626121
chr1,41047611,0.98,82,2,84,626122
chr1,41047650,0.96,73,3,76,626123
chr1,41047667,0.96,73,3,76,626124
chr1,41047749,0.99,77,1,78,626125
chr1,41047818,0.97,73,2,75,626126
chr1,41048029,0.69,88,40,128,626127
chr1,41048263,0.9,54,6,60,626128
chr1,41048296,0.91,43,4,47,626129
chr1,41048390,0.97,67,2,69,626130
chr1,41048479,0.94,59,4,63,626131
chr1,41048914,0.51,33,32,65,626132
chr1,41048948,0.22,12,42,54,626133
chr1,41048957,0.81,39,9,48,626134
chr1,41049037,0.1,7,62,69,626135
chr1,41049073,0.56,41,32,73,626136
chr1,41049104,0.28,18,47,65,626137
chr1,41049122,0.12,6,43,49,626138
chr1,41049566,0.67,60,29,89,626139
chr1,41049689,0.95,77,4,81,626140
chr1,41049803,0.8,85,21,106,626141
chr1,41049880,0.97,64,2,66,626142
chr1,41049965,0.77,48,14,62,626143
chr1,41050018,0.95,69,4,73,626144
chr1,41050039,0.92,76,7,83,626145
chr1,41050060,0.99,74,1,75,626146
chr1,41050659,1,91,0,91,626147
chr1,41050663,1,88,0,88,626148
chr1,41050675,0.99,78,1,79,626149
chr1,41050712,0.94,84,5,89,626150
chr1,41050778,0.97,84,3,87,626151
chr1,41050808,0.93,70,5,75,626152
chr1,41050864,0.92,44,4,48,626153
chr1,41050896,1,39,0,39,626154
chr1,41050898,0.95,35,2,37,626155
chr1,41050951,0.42,28,38,66,626156
chr1,41050985,0.85,82,14,96,626157
chr1,41051019,0.81,88,20,108,626158
chr1,41051124,0.63,75,44,119,626159
chr1,41051149,0.61,66,42,108,626160
chr1,41051160,0.81,88,20,108,626161
chr1,41051313,0.3,33,77,110,626162
chr1,41051455,0.13,8,55,63,626163
chr1,41051610,0.22,18,63,81,626164
chr1,41051614,0.29,19,47,66,626165
chr1,41051654,0.48,24,26,50,626166
chr1,41051659,0.85,41,7,48,626167
chr1,41051686,0.88,43,6,49,626168
chr1,41051709,1,46,0,46,626169
chr1,41051745,0.94,48,3,51,626170
chr1,41051749,0.98,53,1,54,626171
chr1,41051800,0.98,46,1,47,626172
chr1,41051810,0.98,46,1,47,626173
chr1,41052121,0.82,51,11,62,626174
chr1,41052333,0.97,66,2,68,626175
chr1,41052358,0.86,62,10,72,626176
chr1,41052700,0.93,98,7,105,626177
chr1,41052953,1,43,0,43,626178
chr1,41052972,0.53,26,23,49,626179
chr1,41053052,0.98,44,1,45,626180
chr1,41053395,0.68,69,32,101,626181
chr1,41053404,0.71,70,29,99,626182
chr1,41053663,0.85,55,10,65,626183
chr1,41053836,0.93,123,9,132,626184
chr1,41053955,0.96,96,4,100,626185
chr1,41054065,0.9,75,8,83,626186
chr1,41054490,0.07,7,87,94,626187
chr1,41054513,0.19,19,83,102,626188
chr1,41054760,0.95,63,3,66,626189
chr1,41054768,1,63,0,63,626190
chr1,41054776,0.93,63,5,68,626191
chr1,41054791,1,69,0,69,626192
chr1,41054805,0.87,59,9,68,626193
chr1,41054882,0.98,79,2,81,626194
chr1,41054924,0.94,77,5,82,626195
chr1,41054955,0.96,72,3,75,626196
chr1,41054985,0.98,61,1,62,626197
chr1,41055023,0.72,70,27,97,626198
chr1,41055029,0.79,71,19,90,626199
chr1,41055095,0.99,87,1,88,626200
chr1,41055223,0.98,59,1,60,626201
chr1,41055369,0.96,72,3,75,626202
chr1,41055468,0.94,87,6,93,626203
chr1,41055699,0.96,99,4,103,626204
chr1,41055834,0.92,22,2,24,626205
chr1,41055842,0.92,22,2,24,626206
chr1,41055876,1,41,0,41,626207
chr1,41055918,1,56,0,56,626208
chr1,41055920,0.95,57,3,60,626209
chr1,41055933,0.94,68,4,72,626210
chr1,41055962,0.97,72,2,74,626211
chr1,41056007,0.79,41,11,52,626212
chr1,41056014,0.94,49,3,52,626213
chr1,41056023,0.98,43,1,44,626214
chr1,41056051,1,42,0,42,626215
chr1,41056061,1,45,0,45,626216
chr1,41056063,1,45,0,45,626217
chr1,41056122,0.7,50,21,71,626218
chr1,41056195,0.95,70,4,74,626219
chr1,41056207,0.84,63,12,75,626220
chr1,41056359,0.87,48,7,55,626221
chr1,41056369,1,50,0,50,626222
chr1,41056391,0.96,52,2,54,626223
chr1,41056415,0.91,39,4,43,626224
chr1,41056421,0.98,39,1,40,626225
chr1,41056428,0.88,36,5,41,626226
chr1,41056495,0.83,45,9,54,626227
chr1,41056721,0.95,70,4,74,626228
chr1,41056759,0.63,52,30,82,626229
chr1,41056791,0.94,73,5,78,626230
chr1,41056850,0.85,50,9,59,626231
chr1,41056918,0.95,59,3,62,626232
chr1,41056925,0.98,60,1,61,626233
chr1,41056972,1,31,0,31,626234
chr1,41056980,0.88,30,4,34,626235
chr1,41056988,0.96,24,1,25,626236
chr1,41057154,0.89,75,9,84,626237
chr1,41057209,0.92,84,7,91,626238
chr1,41057225,0.83,78,16,94,626239
chr1,41057262,0.98,58,1,59,626240
chr1,41057269,0.96,54,2,56,626241
chr1,41057283,0.95,39,2,41,626242
chr1,41057303,0.96,26,1,27,626243
chr1,41057343,0.71,5,2,7,626244
chr1,41057379,0.85,22,4,26,626245
chr1,41057411,0.91,39,4,43,626246
chr1,41057435,1,48,0,48,626247
chr1,41057441,0.96,46,2,48,626248
chr1,41057465,0.72,21,8,29,626249
chr1,41057544,0.17,5,24,29,626250
chr1,41057655,0.25,16,49,65,626251
chr1,41057658,0.66,40,21,61,626252
chr1,41057803,0.65,74,40,114,626253
chr1,41057836,0.2,19,77,96,626254
chr1,41057993,0.24,17,53,70,626255
chr1,41058060,0.13,11,73,84,626256
chr1,41058097,0.09,9,94,103,626257
chr1,41058165,0.85,80,14,94,626258
chr1,41058580,0.92,56,5,61,626259
chr1,41058684,0.73,78,29,107,626260
chr1,41058801,0.78,57,16,73,626261
chr1,41058849,0.95,70,4,74,626262
chr1,41058908,0.88,93,13,106,626263
chr1,41058919,0.79,88,23,111,626264
chr1,41059188,0.44,32,41,73,626265
chr1,41059320,0.73,83,31,114,626266
chr1,41059387,0.54,61,53,114,626267
chr1,41059472,0.48,52,56,108,626268
chr1,41059499,0.19,18,77,95,626269
chr1,41059611,0.05,5,86,91,626270
chr1,41059743,0.11,11,87,98,626271
chr1,41059750,0.35,32,60,92,626272
chr1,41060019,0.09,10,107,117,626273
chr1,41060133,0.93,87,7,94,626274
chr1,41060135,0.75,69,23,92,626275
chr1,41060229,0.9,86,10,96,626276
chr1,41060273,0.86,71,12,83,626277
chr1,41060345,0.84,64,12,76,626278
chr1,41060427,0.96,76,3,79,626279
chr1,41060462,0.93,82,6,88,626280
chr1,41060465,0.88,74,10,84,626281
chr1,41060523,0.82,63,14,77,626282
chr1,41060599,0.97,103,3,106,626283
chr1,41060816,0.99,92,1,93,626284
chr1,41060936,0.75,55,18,73,626285
chr1,41060969,0.96,68,3,71,626286
chr1,41061016,0.98,60,1,61,626287
chr1,41061053,0.77,46,14,60,626288
chr1,41061063,0.98,58,1,59,626289
chr1,41061074,0.9,53,6,59,626290
chr1,41061098,0.93,51,4,55,626291
chr1,41061101,0.89,48,6,54,626292
chr1,41061209,0.97,34,1,35,626293
chr1,41061264,0.93,87,7,94,626294
chr1,41061352,0.93,111,8,119,626295
chr1,41061357,0.95,116,6,122,626296
chr1,41061407,0.89,81,10,91,626297
chr1,41061464,0.9,57,6,63,626298
chr1,41061506,0.98,65,1,66,626299
chr1,41061666,0.8,72,18,90,626300
chr1,41061678,0.49,46,48,94,626301
chr1,41061706,0.72,62,24,86,626302
chr1,41061735,0.9,74,8,82,626303
chr1,41061748,1,77,0,77,626304
chr1,41061775,0.94,64,4,68,626305
chr1,41061822,0.78,50,14,64,626306
chr1,41061918,0.83,55,11,66,626307
chr1,41061938,0.99,82,1,83,626308
chr1,41062063,0.99,71,1,72,626309
chr1,41062265,0.9,71,8,79,626310
chr1,41062381,0.95,78,4,82,626311
chr1,41062396,0.92,83,7,90,626312
chr1,41062464,0.92,81,7,88,626313
chr1,41062651,0.99,82,1,83,626314
chr1,41062657,0.99,80,1,81,626315
chr1,41062688,0.97,100,3,103,626316
chr1,41062693,1,99,0,99,626317
chr1,41062711,0.96,98,4,102,626318
chr1,41062761,0.73,71,26,97,626319
chr1,41062873,0.86,50,8,58,626320
chr1,41062896,0.85,51,9,60,626321
chr1,41062973,0.94,66,4,70,626322
chr1,41062993,0.96,68,3,71,626323
chr1,41063049,0.95,39,2,41,626324
chr1,41063228,0.87,20,3,23,626325
chr1,41063331,0.67,61,30,91,626326
chr1,41063349,0.96,99,4,103,626327
chr1,41063396,0.71,90,36,126,626328
chr1,41063687,0.73,58,22,80,626329
chr1,41063730,0.8,52,13,65,626330
chr1,41063819,0.89,67,8,75,626331
chr1,41063884,0.88,66,9,75,626332
chr1,41063970,0.83,58,12,70,626333
chr1,41064142,0.82,68,15,83,626334
chr1,41064347,0.92,90,8,98,626335
chr1,41064432,0.53,58,52,110,626336
chr1,41064492,0.61,66,43,109,626337
chr1,41064934,0.87,79,12,91,626338
chr1,41065246,0.76,28,9,37,626339
chr1,41065252,0.82,32,7,39,626340
chr1,41065363,0.51,43,42,85,626341
chr1,41065428,0.86,60,10,70,626342
chr1,41065460,0.74,58,20,78,626343
chr1,41065500,0.98,79,2,81,626344
chr1,41065504,0.92,81,7,88,626345
chr1,41065546,0.91,83,8,91,626346
chr1,41065853,0.85,74,13,87,626347
chr1,41066119,0.74,49,17,66,626348
chr1,41066221,0.68,52,24,76,626349
chr1,41066771,0.6,27,18,45,626350
chr1,41066977,0.88,72,10,82,626351
chr1,41067000,0.9,61,7,68,626352
chr1,41067007,0.77,54,16,70,626353
chr1,41067023,0.97,64,2,66,626354
chr1,41067062,0.83,58,12,70,626355
chr1,41067084,0.9,69,8,77,626356
chr1,41067088,0.82,62,14,76,626357
chr1,41067184,0.95,74,4,78,626358
chr1,41067189,0.99,75,1,76,626359
chr1,41067227,0.84,65,12,77,626360
chr1,41067280,1,74,0,74,626361
chr1,41067314,0.96,70,3,73,626362
chr1,41067316,0.93,66,5,71,626363
chr1,41067470,0.88,70,10,80,626364
chr1,41067513,0.65,49,26,75,626365
chr1,41067526,0.81,51,12,63,626366
chr1,41067553,0.36,26,46,72,626367
chr1,41067558,0.86,64,10,74,626368
chr1,41067564,0.92,65,6,71,626369
chr1,41067588,0.87,68,10,78,626370
chr1,41067623,0.94,58,4,62,626371
chr1,41067669,0.94,47,3,50,626372
chr1,41067725,0.92,44,4,48,626373
chr1,41067730,0.85,41,7,48,626374
chr1,41067760,0.7,40,17,57,626375
chr1,41067948,0.73,58,21,79,626376
chr1,41067989,0.78,86,24,110,626377
chr1,41068038,0.87,104,15,119,626378
chr1,41068044,0.91,109,11,120,626379
chr1,41068137,0.98,101,2,103,626380
chr1,41068237,0.93,56,4,60,626381
chr1,41068502,0.96,67,3,70,626382
chr1,41068575,1,48,0,48,626383
chr1,41068577,0.96,48,2,50,626384
chr1,41068620,0.95,40,2,42,626385
chr1,41068665,0.93,52,4,56,626386
chr1,41068676,0.95,60,3,63,626387
chr1,41068708,0.96,67,3,70,626388
chr1,41068716,0.96,64,3,67,626389
chr1,41068720,0.97,60,2,62,626390
chr1,41068740,0.93,54,4,58,626391
chr1,41068772,0.98,54,1,55,626392
chr1,41068870,0.81,67,16,83,626393
chr1,41068978,0.99,72,1,73,626394
chr1,41069102,0.89,103,13,116,626395
chr1,41069299,0.95,91,5,96,626396
chr1,41069441,0.22,26,92,118,626397
chr1,41069528,0.05,5,92,97,626398
chr1,41069810,0.89,102,12,114,626399
chr1,41070062,0.44,15,19,34,626400
chr1,41070100,0.93,38,3,41,626401
chr1,41070160,0.9,57,6,63,626402
chr1,41070200,0.97,86,3,89,626403
chr1,41070220,0.96,102,4,106,626404
chr1,41070267,0.98,99,2,101,626405
chr1,41070277,0.95,99,5,104,626406
chr1,41070283,0.98,107,2,109,626407
chr1,41070383,0.93,86,6,92,626408
chr1,41070571,0.95,81,4,85,626409
chr1,41070811,0.91,40,4,44,626410
chr1,41070839,0.98,59,1,60,626411
chr1,41070871,0.92,70,6,76,626412
chr1,41070934,0.95,81,4,85,626413
chr1,41070988,0.93,51,4,55,626414
chr1,41071022,0.45,20,24,44,626415
chr1,41071155,0.32,23,49,72,626416
chr1,41071202,0.11,9,70,79,626417
chr1,41071245,0.54,37,32,69,626418
chr1,41071249,0.35,27,50,77,626419
chr1,41072026,0.92,76,7,83,626420
chr1,41072098,0.35,27,51,78,626421
chr1,41072140,0.93,63,5,68,626422
chr1,41072314,0.97,58,2,60,626423
chr1,41072320,1,57,0,57,626424
chr1,41072322,0.96,53,2,55,626425
chr1,41072826,0.91,49,5,54,626426
chr1,41072890,0.83,55,11,66,626427
chr1,41073081,0.89,68,8,76,626428
chr1,41073449,0.95,97,5,102,626429
chr1,41073543,0.99,96,1,97,626430
chr1,41073673,0.88,64,9,73,626431
chr1,41074167,0.51,32,31,63,626432
chr1,41074234,0.95,59,3,62,626433
chr1,41074257,1,80,0,80,626434
chr1,41074274,0.99,87,1,88,626435
chr1,41074328,0.93,63,5,68,626436
chr1,41074392,0.45,26,32,58,626437
chr1,41074406,0.9,52,6,58,626438
chr1,41074413,0.98,54,1,55,626439
chr1,41074430,0.96,55,2,57,626440
chr1,41074462,0.98,59,1,60,626441
chr1,41074517,0.93,57,4,61,626442
chr1,41074650,0.4,29,44,73,626443
chr1,41074660,0.82,59,13,72,626444
chr1,41075049,0.91,77,8,85,626445
chr1,41075738,0.91,82,8,90,626446
chr1,41075754,0.86,78,13,91,626447
chr1,41075801,0.72,71,27,98,626448
chr1,41075849,0.9,79,9,88,626449
chr1,41075860,0.96,71,3,74,626450
chr1,41075946,0.84,65,12,77,626451
chr1,41076023,0.94,68,4,72,626452
chr1,41076038,0.95,62,3,65,626453
chr1,41076098,0.94,58,4,62,626454
chr1,41076156,0.86,51,8,59,626455
chr1,41076227,0.82,56,12,68,626456
chr1,41076278,0.93,76,6,82,626457
chr1,41076457,0.79,112,30,142,626458
chr1,41076462,0.87,118,18,136,626459
chr1,41076674,0.81,43,10,53,626460
chr1,41076701,0.98,43,1,44,626461
chr1,41076725,0.93,40,3,43,626462
chr1,41077325,0.72,68,27,95,626463
chr1,41077589,0.8,55,14,69,626464
chr1,41077645,0.42,42,58,100,626465
chr1,41077729,0.94,49,3,52,626466
chr1,41077761,0.61,31,20,51,626467
chr1,41077878,0.81,57,13,70,626468
chr1,41077926,0.36,26,47,73,626469
chr1,41077951,0.21,15,58,73,626470
chr1,41078133,0.02,1,55,56,626471
chr1,41078223,0,0,31,31,626472
chr1,41078231,0,0,38,38,626473
chr1,41078280,0.11,4,31,35,626474
chr1,41078291,0.04,2,47,49,626475
chr1,41078321,0.08,5,60,65,626476
chr1,41078385,0.07,6,80,86,626477
chr1,41078395,0.21,16,60,76,626478
chr1,41078441,0.3,21,50,71,626479
chr1,41078480,0.18,14,64,78,626480
chr1,41078495,0.16,13,66,79,626481
chr1,41078531,0.7,46,20,66,626482
chr1,41078644,0.34,30,59,89,626483
chr1,41078661,0.72,67,26,93,626484
chr1,41078749,0.79,90,24,114,626485
chr1,41079066,0.97,91,3,94,626486
chr1,41079100,0.85,79,14,93,626487
chr1,41079116,0.77,83,25,108,626488
chr1,41079192,0.71,82,34,116,626489
chr1,41079234,0.83,88,18,106,626490
chr1,41079272,0.95,79,4,83,626491
chr1,41079599,0.84,41,8,49,626492
chr1,41079629,1,39,0,39,626493
chr1,41079669,1,41,0,41,626494
chr1,41079693,0.96,45,2,47,626495
chr1,41079713,1,45,0,45,626496
chr1,41079717,0.96,49,2,51,626497
chr1,41079725,0.95,53,3,56,626498
chr1,41079758,0.88,44,6,50,626499
chr1,41079769,0.86,38,6,44,626500
chr1,41079789,0.9,37,4,41,626501
chr1,41079803,0.84,38,7,45,626502
chr1,41079810,0.91,43,4,47,626503
chr1,41079847,0.97,35,1,36,626504
chr1,41079857,0.95,39,2,41,626505
chr1,41079863,0.95,41,2,43,626506
chr1,41079967,0.71,45,18,63,626507
chr1,41079977,0.78,50,14,64,626508
chr1,41080005,0.83,55,11,66,626509
chr1,41080239,0.87,33,5,38,626510
chr1,41080325,0.76,73,23,96,626511
chr1,41080367,0.78,72,20,92,626512
chr1,41080425,0.55,47,38,85,626513
chr1,41080470,0.39,30,46,76,626514
chr1,41080474,0.3,26,60,86,626515
chr1,41080738,0.49,53,55,108,626516
chr1,41081582,0.46,52,60,112,626517
chr1,41081675,0.81,77,18,95,626518
chr1,41081693,0.55,47,38,85,626519
chr1,41081724,0.98,62,1,63,626520
chr1,41081751,0.94,31,2,33,626521
chr1,41081782,0.79,15,4,19,626522
chr1,41081810,0.79,19,5,24,626523
chr1,41081868,0.93,37,3,40,626524
chr1,41082025,0.96,81,3,84,626525
chr1,41082584,0.12,10,75,85,626526
chr1,41082792,0.94,88,6,94,626527
chr1,41082959,1,33,0,33,626528
chr1,41082999,0.98,52,1,53,626529
chr1,41083038,0.91,62,6,68,626530
chr1,41083134,0.96,24,1,25,626531
chr1,41083155,0.95,19,1,20,626532
chr1,41083159,0.97,37,1,38,626533
chr1,41083189,0.94,49,3,52,626534
chr1,41083226,0.93,69,5,74,626535
chr1,41084135,0.73,53,20,73,626536
chr1,41084265,0.86,83,14,97,626537
chr1,41084328,0.99,99,1,100,626538
chr1,41084367,0.57,54,40,94,626539
chr1,41084387,0.95,69,4,73,626540
chr1,41084391,0.91,74,7,81,626541
chr1,41084477,0.86,25,4,29,626542
chr1,41084484,0.96,27,1,28,626543
chr1,41084488,0.97,35,1,36,626544
chr1,41084509,0.9,37,4,41,626545
chr1,41084521,0.9,47,5,52,626546
chr1,41084541,0.89,67,8,75,626547
chr1,41084839,0.82,94,20,114,626548
chr1,41084938,0.82,64,14,78,626549
chr1,41085192,0.97,87,3,90,626550
chr1,41085902,0.98,82,2,84,626551
chr1,41086005,0.97,64,2,66,626552
chr1,41086014,0.95,57,3,60,626553
chr1,41086044,0.82,53,12,65,626554
chr1,41086107,0.87,45,7,52,626555
chr1,41086455,0.66,78,40,118,626556
chr1,41086464,0.74,82,29,111,626557
chr1,41086496,0.61,55,35,90,626558
chr1,41086958,0.99,96,1,97,626559
chr1,41087061,0.84,64,12,76,626560
chr1,41087184,0.89,97,12,109,626561
chr1,41087212,0.95,110,6,116,626562
chr1,41087734,0.44,22,28,50,626563
chr1,41087813,0.62,47,29,76,626564
chr1,41087836,0.6,49,32,81,626565
chr1,41087927,0.88,68,9,77,626566
chr1,41088053,0.8,44,11,55,626567
chr1,41088080,0.98,60,1,61,626568
chr1,41088577,0.53,48,43,91,626569
chr1,41088754,0.93,86,6,92,626570
chr1,41089089,0.91,48,5,53,626571
chr1,41089176,0.9,53,6,59,626572
chr1,41089262,0.97,64,2,66,626573
chr1,41089342,0.89,41,5,46,626574
chr1,41089511,0.89,72,9,81,626575
chr1,41089789,0.64,29,16,45,626576
chr1,41089979,1,60,0,60,626577
chr1,41090051,0.9,57,6,63,626578
chr1,41090082,0.93,56,4,60,626579
chr1,41090122,0.93,51,4,55,626580
chr1,41090126,0.93,51,4,55,626581
chr1,41090152,0.95,62,3,65,626582
chr1,41090272,0.84,36,7,43,626583
chr1,41090383,0.93,56,4,60,626584
chr1,41090444,0.95,57,3,60,626585
chr1,41090536,0.98,54,1,55,626586
chr1,41090702,0.96,69,3,72,626587
chr1,41090775,0.74,89,31,120,626588
chr1,41090971,0.15,9,52,61,626589
chr1,41091016,0.27,17,45,62,626590
chr1,41091024,0.68,40,19,59,626591
chr1,41091127,1,44,0,44,626592
chr1,41091164,0.88,45,6,51,626593
chr1,41091230,0.23,19,63,82,626594
chr1,41091360,0.13,10,65,75,626595
chr1,41091365,0.04,3,71,74,626596
chr1,41091451,0.02,1,44,45,626597
chr1,41091586,0.74,61,21,82,626598
chr1,41091611,0.46,37,43,80,626599
chr1,41091616,0.86,56,9,65,626600
chr1,41091668,0.94,67,4,71,626601
chr1,41091703,0.89,62,8,70,626602
chr1,41091817,0.25,14,43,57,626603
chr1,41091828,0.51,29,28,57,626604
chr1,41091921,0.43,33,43,76,626605
chr1,41091987,0.87,81,12,93,626606
chr1,41091995,0.87,86,13,99,626607
chr1,41092013,0.95,88,5,93,626608
chr1,41092017,0.46,42,49,91,626609
chr1,41092025,0.89,84,10,94,626610
chr1,41092109,0.87,62,9,71,626611
chr1,41092238,1,51,0,51,626612
chr1,41092254,0.93,50,4,54,626613
chr1,41092302,0.9,46,5,51,626614
chr1,41092309,0.96,52,2,54,626615
chr1,41092311,0.98,57,1,58,626616
chr1,41092314,1,57,0,57,626617
chr1,41092329,0.95,52,3,55,626618
chr1,41092376,0.92,46,4,50,626619
chr1,41092395,0.84,42,8,50,626620
chr1,41092478,0.69,38,17,55,626621
chr1,41092570,0.94,78,5,83,626622
chr1,41092847,0.96,75,3,78,626623
chr1,41092961,0.96,43,2,45,626624
chr1,41093135,0.89,8,1,9,626625
chr1,41093146,1,22,0,22,626626
chr1,41093151,1,24,0,24,626627
chr1,41093179,0.98,53,1,54,626628
chr1,41093195,1,69,0,69,626629
chr1,41093199,0.93,68,5,73,626630
chr1,41093262,0.98,92,2,94,626631
chr1,41093398,0.87,91,14,105,626632
chr1,41093420,0.95,88,5,93,626633
chr1,41093536,0.96,70,3,73,626634
chr1,41093828,0.87,59,9,68,626635
chr1,41093830,0.44,32,40,72,626636
chr1,41093907,0.95,90,5,95,626637
chr1,41093935,0.72,72,28,100,626638
chr1,41094083,0.9,78,9,87,626639
chr1,41094090,0.91,80,8,88,626640
chr1,41094148,0.83,66,14,80,626641
chr1,41094365,0.92,54,5,59,626642
chr1,41094508,0.91,82,8,90,626643
chr1,41094851,0.98,45,1,46,626644
chr1,41094895,0.98,43,1,44,626645
chr1,41094981,0.96,51,2,53,626646
chr1,41095017,0.94,51,3,54,626647
chr1,41095194,0.94,88,6,94,626648
chr1,41095460,0.87,48,7,55,626649
chr1,41095470,0.85,40,7,47,626650
chr1,41095474,0.96,45,2,47,626651
chr1,41095519,0.88,49,7,56,626652
chr1,41095713,0.93,51,4,55,626653
chr1,41095725,0.93,41,3,44,626654
chr1,41095737,0.97,31,1,32,626655
chr1,41095827,0.98,46,1,47,626656
chr1,41095908,0.92,49,4,53,626657
chr1,41095954,0.92,73,6,79,626658
chr1,41096201,0.95,54,3,57,626659
chr1,41096332,0.79,34,9,43,626660
chr1,41096389,0.82,56,12,68,626661
chr1,41096399,0.85,60,11,71,626662
chr1,41096411,0.97,70,2,72,626663
chr1,41096786,0.87,72,11,83,626664
chr1,41096836,0.99,71,1,72,626665
chr1,41096976,0.98,44,1,45,626666
chr1,41096995,1,46,0,46,626667
chr1,41097041,0.96,53,2,55,626668
chr1,41097119,0.97,66,2,68,626669
chr1,41097173,0.97,60,2,62,626670
chr1,41097216,0.97,89,3,92,626671
chr1,41097223,0.94,85,5,90,626672
chr1,41097243,0.92,90,8,98,626673
chr1,41097336,0.96,80,3,83,626674
chr1,41097401,0.92,57,5,62,626675
chr1,41097471,0.93,64,5,69,626676
chr1,41097604,1,55,0,55,626677
chr1,41097647,0.96,51,2,53,626678
chr1,41097899,0.97,106,3,109,626679
chr1,41097949,0.99,103,1,104,626680
chr1,41098059,0.92,67,6,73,626681
chr1,41098254,0.98,94,2,96,626682
chr1,41098400,0.97,117,4,121,626683
chr1,41098437,0.98,115,2,117,626684
chr1,41098477,0.92,110,9,119,626685
chr1,41098652,0.89,54,7,61,626686
chr1,41098694,0.97,56,2,58,626687
chr1,41098767,0.95,73,4,77,626688
chr1,41098807,0.91,70,7,77,626689
chr1,41098833,0.84,51,10,61,626690
chr1,41098875,0.94,34,2,36,626691
chr1,41098877,0.95,36,2,38,626692
chr1,41098954,0.18,10,45,55,626693
chr1,41099664,0.9,101,11,112,626694
chr1,41100342,0.94,58,4,62,626695
chr1,41100388,0.98,48,1,49,626696
chr1,41100411,0.94,47,3,50,626697
chr1,41100473,1,61,0,61,626698
chr1,41100485,0.95,53,3,56,626699
chr1,41100527,0.51,27,26,53,626700
chr1,41100585,0.9,37,4,41,626701
chr1,41100640,0.91,53,5,58,626702
chr1,41100755,0.94,81,5,86,626703
chr1,41100808,0.44,37,47,84,626704
chr1,41101039,0.46,48,56,104,626705
chr1,41101308,0.97,56,2,58,626706
chr1,41101547,0.87,26,4,30,626707
chr1,41101571,1,26,0,26,626708
chr1,41101573,0.85,23,4,27,626709
chr1,41101583,1,30,0,30,626710
chr1,41101587,1,30,0,30,626711
chr1,41101592,1,35,0,35,626712
chr1,41101595,0.95,36,2,38,626713
chr1,41101622,0.96,46,2,48,626714
chr1,41101633,0.9,46,5,51,626715
chr1,41101645,0.96,53,2,55,626716
chr1,41101654,0.98,50,1,51,626717
chr1,41101660,1,59,0,59,626718
chr1,41101671,0.97,56,2,58,626719
chr1,41101673,0.98,54,1,55,626720
chr1,41101686,0.96,49,2,51,626721
chr1,41101693,1,51,0,51,626722
chr1,41101696,1,46,0,46,626723
chr1,41101708,1,47,0,47,626724
chr1,41101925,0.96,47,2,49,626725
chr1,41101983,1,48,0,48,626726
chr1,41101991,0.98,52,1,53,626727
chr1,41101999,0.93,51,4,55,626728
chr1,41102007,1,54,0,54,626729
chr1,41102022,0.98,55,1,56,626730
chr1,41102049,0.99,66,1,67,626731
chr1,41102065,0.93,69,5,74,626732
chr1,41102306,0.86,68,11,79,626733
chr1,41102411,0.96,43,2,45,626734
chr1,41102436,0.79,33,9,42,626735
chr1,41102444,0.95,42,2,44,626736
chr1,41102467,0.81,34,8,42,626737
chr1,41102571,0.42,30,42,72,626738
chr1,41102613,0.84,49,9,58,626739
chr1,41102620,0.88,44,6,50,626740
chr1,41102661,0.64,45,25,70,626741
chr1,41102763,0.72,33,13,46,626742
chr1,41102955,0.93,68,5,73,626743
chr1,41103039,0.98,40,1,41,626744
chr1,41103240,0.93,78,6,84,626745
chr1,41103534,0.97,68,2,70,626746
chr1,41103600,0.93,57,4,61,626747
chr1,41103758,0.93,83,6,89,626748
chr1,41103846,1,86,0,86,626749
chr1,41104002,0.85,58,10,68,626750
chr1,41104034,0.95,73,4,77,626751
chr1,41104328,0.76,56,18,74,626752
chr1,41104448,0.62,48,29,77,626753
chr1,41104531,0.97,116,3,119,626754
chr1,41104548,0.91,110,11,121,626755
chr1,41104687,0.9,66,7,73,626756
chr1,41104774,0.89,34,4,38,626757
chr1,41105015,0.97,65,2,67,626758
chr1,41105085,0.96,45,2,47,626759
chr1,41105343,0.94,84,5,89,626760
chr1,41105382,0.74,49,17,66,626761
chr1,41105444,0.86,67,11,78,626762
chr1,41105829,0.79,58,15,73,626763
chr1,41105847,0.86,56,9,65,626764
chr1,41106043,0.46,52,62,114,626765
chr1,41106087,0.89,97,12,109,626766
chr1,41106098,0.68,75,36,111,626767
chr1,41106101,0.79,85,22,107,626768
chr1,41106192,0.79,63,17,80,626769
chr1,41106201,0.97,69,2,71,626770
chr1,41106274,0.92,85,7,92,626771
chr1,41106608,0.96,79,3,82,626772
chr1,41106646,0.85,66,12,78,626773
chr1,41106671,0.92,70,6,76,626774
chr1,41106802,0.94,83,5,88,626775
chr1,41106891,1,83,0,83,626776
chr1,41107335,0.97,61,2,63,626777
chr1,41107358,0.97,58,2,60,626778
chr1,41107360,1,61,0,61,626779
chr1,41107388,0.98,57,1,58,626780
chr1,41107429,0.95,53,3,56,626781
chr1,41107461,0.98,62,1,63,626782
chr1,41107464,0.94,58,4,62,626783
chr1,41107474,0.96,64,3,67,626784
chr1,41107492,0.96,68,3,71,626785
chr1,41107498,0.98,80,2,82,626786
chr1,41107513,0.85,73,13,86,626787
chr1,41107525,0.97,90,3,93,626788
chr1,41107542,0.99,99,1,100,626789
chr1,41107588,0.9,87,10,97,626790
chr1,41107604,0.94,80,5,85,626791
chr1,41107706,1,95,0,95,626792
chr1,41107848,0.98,114,2,116,626793
chr1,41107866,0.47,54,61,115,626794
chr1,41107889,0.99,132,2,134,626795
chr1,41107925,0.93,124,9,133,626796
chr1,41108218,0.99,67,1,68,626797
chr1,41108349,0.94,101,6,107,626798
chr1,41108393,0.98,49,1,50,626799
chr1,41108398,0.96,44,2,46,626800
chr1,41108402,0.93,26,2,28,626801
chr1,41108425,0.93,13,1,14,626802
chr1,41108488,0.89,17,2,19,626803
chr1,41108542,1,44,0,44,626804
chr1,41108559,0.98,40,1,41,626805
chr1,41108576,0.97,32,1,33,626806
chr1,41108582,1,34,0,34,626807
chr1,41108614,0.94,46,3,49,626808
chr1,41108691,0.7,64,28,92,626809
chr1,41108749,1,66,0,66,626810
chr1,41108872,0.95,78,4,82,626811
chr1,41108896,0.96,82,3,85,626812
chr1,41108928,0.99,78,1,79,626813
chr1,41108948,0.99,68,1,69,626814
chr1,41108952,0.97,71,2,73,626815
chr1,41109024,0.98,59,1,60,626816
chr1,41109094,0.91,39,4,43,626817
chr1,41109211,0.92,67,6,73,626818
chr1,41109217,0.93,75,6,81,626819
chr1,41109251,0.97,98,3,101,626820
chr1,41109293,0.97,77,2,79,626821
chr1,41109297,1,76,0,76,626822
chr1,41109339,0.96,76,3,79,626823
chr1,41109402,0.98,80,2,82,626824
chr1,41109442,0.52,40,37,77,626825
chr1,41109504,0.97,96,3,99,626826
chr1,41109514,0.88,83,11,94,626827
chr1,41109561,0.69,40,18,58,626828
chr1,41109831,0.99,68,1,69,626829
chr1,41109869,0.7,46,20,66,626830
chr1,41109876,0.99,82,1,83,626831
chr1,41110171,0.89,95,12,107,626832
chr1,41110522,0.82,72,16,88,626833
chr1,41110712,0.91,61,6,67,626834
chr1,41110746,0.97,77,2,79,626835
chr1,41110756,1,86,0,86,626836
chr1,41110766,0.95,87,5,92,626837
chr1,41110859,0.73,69,25,94,626838
chr1,41110907,0.8,71,18,89,626839
chr1,41110960,0.68,67,32,99,626840
chr1,41111175,0.95,78,4,82,626841
chr1,41111318,0.96,89,4,93,626842
chr1,41111729,0.92,88,8,96,626843
chr1,41111733,0.98,98,2,100,626844
chr1,41111769,0.97,97,3,100,626845
chr1,41111902,0.97,89,3,92,626846
chr1,41112073,0.78,32,9,41,626847
chr1,41112098,0.76,38,12,50,626848
chr1,41112127,0.98,43,1,44,626849
chr1,41112209,0.67,45,22,67,626850
chr1,41112535,0.67,58,28,86,626851
chr1,41112615,0.94,34,2,36,626852
chr1,41112621,0.91,29,3,32,626853
chr1,41112638,0.97,37,1,38,626854
chr1,41112697,1,58,0,58,626855
chr1,41112709,0.98,63,1,64,626856
chr1,41112772,0.96,54,2,56,626857
chr1,41112786,0.94,50,3,53,626858
chr1,41112802,0.94,45,3,48,626859
chr1,41112840,1,56,0,56,626860
chr1,41112842,0.96,54,2,56,626861
chr1,41112846,0.97,57,2,59,626862
chr1,41112879,1,62,0,62,626863
chr1,41113210,0.98,89,2,91,626864
chr1,41113340,0.92,82,7,89,626865
chr1,41113368,0.99,80,1,81,626866
chr1,41113498,0.86,63,10,73,626867
chr1,41113984,0.77,65,19,84,626868
chr1,41114021,0.96,76,3,79,626869
chr1,41114200,0.97,69,2,71,626870
chr1,41114318,0.9,60,7,67,626871
chr1,41114409,0.98,59,1,60,626872
chr1,41114487,1,56,0,56,626873
chr1,41114592,0.97,75,2,77,626874
chr1,41114667,0.89,51,6,57,626875
chr1,41114707,0.96,43,2,45,626876
chr1,41114775,1,29,0,29,626877
chr1,41114791,1,28,0,28,626878
chr1,41114794,0.96,24,1,25,626879
chr1,41114830,0.97,32,1,33,626880
chr1,41114846,0.72,26,10,36,626881
chr1,41114878,0.62,33,20,53,626882
chr1,41114968,0.99,72,1,73,626883
chr1,41115036,0.87,59,9,68,626884
chr1,41115049,0.85,58,10,68,626885
chr1,41115150,0.87,53,8,61,626886
chr1,41115186,0.83,55,11,66,626887
chr1,41115236,0.97,70,2,72,626888
chr1,41115248,0.73,52,19,71,626889
chr1,41115315,1,44,0,44,626890
chr1,41115332,0.98,40,1,41,626891
chr1,41115340,0.97,37,1,38,626892
chr1,41115357,0.84,31,6,37,626893
chr1,41115527,0.78,46,13,59,626894
chr1,41115768,0.79,34,9,43,626895
chr1,41115836,0.97,60,2,62,626896
chr1,41115882,0.36,20,36,56,626897
chr1,41116011,0.91,60,6,66,626898
chr1,41116178,0.99,71,1,72,626899
chr1,41116256,0.92,108,9,117,626900
chr1,41116260,0.57,62,47,109,626901
chr1,41116313,0.98,97,2,99,626902
chr1,41116315,0.96,98,4,102,626903
chr1,41116351,0.81,67,16,83,626904
chr1,41116430,0.88,57,8,65,626905
chr1,41116486,0.82,37,8,45,626906
chr1,41116854,0.89,74,9,83,626907
chr1,41116858,0.88,67,9,76,626908
chr1,41116950,0.64,36,20,56,626909
chr1,41116964,0.57,29,22,51,626910
chr1,41116973,1,48,0,48,626911
chr1,41116983,0.85,39,7,46,626912
chr1,41116986,0.82,37,8,45,626913
chr1,41117007,0.89,39,5,44,626914
chr1,41117009,0.91,39,4,43,626915
chr1,41117017,0.96,47,2,49,626916
chr1,41117027,0.89,40,5,45,626917
chr1,41117070,0.89,57,7,64,626918
chr1,41117194,0.73,65,24,89,626919
chr1,41117248,0.15,15,82,97,626920
chr1,41117268,0.55,36,30,66,626921
chr1,41117308,0,0,86,86,626922
chr1,41117311,0.02,2,82,84,626923
chr1,41117657,0.79,71,19,90,626924
chr1,41117783,0.85,41,7,48,626925
chr1,41117898,0.42,31,43,74,626926
chr1,41117912,0.73,57,21,78,626927
chr1,41118235,0.99,75,1,76,626928
chr1,41118266,0.38,32,52,84,626929
chr1,41118285,0.55,39,32,71,626930
chr1,41118297,0.99,83,1,84,626931
chr1,41118326,0.95,83,4,87,626932
chr1,41118568,0.98,88,2,90,626933
chr1,41118579,0.73,68,25,93,626934
chr1,41118592,0.77,69,21,90,626935
chr1,41118724,0.96,92,4,96,626936
chr1,41118770,0.9,98,11,109,626937
chr1,41118832,0.96,94,4,98,626938
chr1,41118836,0.97,93,3,96,626939
chr1,41119101,0.98,81,2,83,626940
chr1,41119146,0.95,73,4,77,626941
chr1,41119275,0.93,26,2,28,626942
chr1,41119283,0.63,12,7,19,626943
chr1,41119404,0.81,51,12,63,626944
chr1,41119441,0.56,48,38,86,626945
chr1,41119518,0.78,69,19,88,626946
chr1,41119556,0.69,56,25,81,626947
chr1,41119634,0.4,10,15,25,626948
chr1,41119745,0.08,1,11,12,626949
chr1,41119756,0,0,12,12,626950
chr1,41119763,0,0,9,9,626951
chr1,41119770,0,0,7,7,626952
chr1,41119775,0,0,4,4,626953
chr1,41119793,0,0,3,3,626954
chr1,41119826,0,0,1,1,626955
chr1,41119842,0,0,2,2,626956
chr1,41119853,0,0,5,5,626957
chr1,41119855,0.2,1,4,5,626958
chr1,41119858,0,0,6,6,626959
chr1,41119864,0,0,10,10,626960
chr1,41119870,0.08,1,12,13,626961
chr1,41119914,0,0,19,19,626962
chr1,41119924,0.2,4,16,20,626963
chr1,41119931,0.5,5,5,10,626964
chr1,41119934,0.1,2,18,20,626965
chr1,41119938,0.22,5,18,23,626966
chr1,41119940,0.19,4,17,21,626967
chr1,41119988,0.29,8,20,28,626968
chr1,41120010,0.19,6,25,31,626969
chr1,41120026,0.06,3,44,47,626970
chr1,41120052,0.08,5,61,66,626971
chr1,41120077,0.12,8,61,69,626972
chr1,41120081,0.24,16,51,67,626973
chr1,41120098,0.31,23,52,75,626974
chr1,41120111,0.6,41,27,68,626975
chr1,41120114,0.52,34,32,66,626976
chr1,41120116,0.69,49,22,71,626977
chr1,41120126,0.83,60,12,72,626978
chr1,41120135,0.65,45,24,69,626979
chr1,41120154,0.85,57,10,67,626980
chr1,41120344,0.96,74,3,77,626981
chr1,41120348,0.9,75,8,83,626982
chr1,41120367,0.75,60,20,80,626983
chr1,41120388,0.96,79,3,82,626984
chr1,41120758,0.56,34,27,61,626985
chr1,41120780,0.86,59,10,69,626986
chr1,41120812,0.97,62,2,64,626987
chr1,41120824,0.96,65,3,68,626988
chr1,41120857,0.98,58,1,59,626989
chr1,41121226,0.98,57,1,58,626990
chr1,41121306,0.98,42,1,43,626991
chr1,41121404,0.88,89,12,101,626992
chr1,41121414,0.95,103,5,108,626993
chr1,41121489,0.92,119,11,130,626994
chr1,41121505,0.96,123,5,128,626995
chr1,41121541,0.99,111,1,112,626996
chr1,41121555,0.97,98,3,101,626997
chr1,41121599,0.96,70,3,73,626998
chr1,41121639,0.97,67,2,69,626999
chr1,41121663,0.99,66,1,67,627000
chr1,41121675,1,75,0,75,627001
chr1,41121884,0.99,72,1,73,627002
chr1,41121905,0.99,77,1,78,627003
chr1,41122177,1,71,0,71,627004
chr1,41122181,0.99,71,1,72,627005
chr1,41122183,1,74,0,74,627006
chr1,41122193,0.97,67,2,69,627007
chr1,41122245,0.96,67,3,70,627008
chr1,41122284,0.91,74,7,81,627009
chr1,41122311,0.97,67,2,69,627010
chr1,41122315,0.96,64,3,67,627011
chr1,41122347,0.98,49,1,50,627012
chr1,41122411,1,22,0,22,627013
chr1,41122442,0.93,13,1,14,627014
chr1,41122450,0.75,9,3,12,627015
chr1,41122531,0.9,52,6,58,627016
chr1,41122559,0.9,69,8,77,627017
chr1,41122653,0.94,87,6,93,627018
chr1,41122667,0.99,97,1,98,627019
chr1,41122754,0.87,76,11,87,627020
chr1,41122798,0.97,74,2,76,627021
chr1,41122838,0.96,66,3,69,627022
chr1,41122881,0.9,53,6,59,627023
chr1,41122895,0.96,55,2,57,627024
chr1,41123002,0.96,64,3,67,627025
chr1,41123052,0.96,88,4,92,627026
chr1,41123146,0.97,74,2,76,627027
chr1,41123367,0.93,66,5,71,627028
chr1,41123527,0.98,86,2,88,627029
chr1,41123846,0.71,29,12,41,627030
chr1,41124106,0.92,104,9,113,627031
chr1,41124146,0.94,104,7,111,627032
chr1,41124167,0.95,83,4,87,627033
chr1,41124462,1,65,0,65,627034
chr1,41124613,0.96,96,4,100,627035
chr1,41124621,0.98,94,2,96,627036
chr1,41124660,0.93,100,7,107,627037
chr1,41124663,0.95,100,5,105,627038
chr1,41124691,0.95,93,5,98,627039
chr1,41124760,0.99,83,1,84,627040
chr1,41124785,0.97,88,3,91,627041
chr1,41124803,0.6,53,35,88,627042
chr1,41124944,0.95,59,3,62,627043
chr1,41124973,0.98,49,1,50,627044
chr1,41125012,0.4,25,38,63,627045
chr1,41125072,0.96,46,2,48,627046
chr1,41125229,0.8,70,17,87,627047
chr1,41125244,0.86,86,14,100,627048
chr1,41125301,0.87,104,15,119,627049
chr1,41125387,0.95,96,5,101,627050
chr1,41125396,0.76,81,25,106,627051
chr1,41125400,0.72,78,30,108,627052
chr1,41125455,0.97,90,3,93,627053
chr1,41125481,0.47,44,50,94,627054
chr1,41125561,0.95,95,5,100,627055
chr1,41125570,0.98,91,2,93,627056
chr1,41125640,0.43,45,59,104,627057
chr1,41125670,0.98,96,2,98,627058
chr1,41125762,0.96,71,3,74,627059
chr1,41125774,0.9,65,7,72,627060
chr1,41125841,0.9,69,8,77,627061
chr1,41125853,0.99,79,1,80,627062
chr1,41125900,1,74,0,74,627063
chr1,41125903,1,72,0,72,627064
chr1,41125920,0.99,77,1,78,627065
chr1,41126080,1,22,0,22,627066
chr1,41126152,0.98,64,1,65,627067
chr1,41126198,0.97,66,2,68,627068
chr1,41126248,0.99,77,1,78,627069
chr1,41126294,0.98,84,2,86,627070
chr1,41126354,0.95,84,4,88,627071
chr1,41126417,0.93,71,5,76,627072
chr1,41126427,0.94,65,4,69,627073
chr1,41126733,1,77,0,77,627074
chr1,41126827,0.99,90,1,91,627075
chr1,41126922,0.97,72,2,74,627076
chr1,41127075,0.98,95,2,97,627077
chr1,41127161,0.99,86,1,87,627078
chr1,41127199,0.98,78,2,80,627079
chr1,41127211,0.95,73,4,77,627080
chr1,41127267,0.78,66,19,85,627081
chr1,41127363,0.49,41,42,83,627082
chr1,41127422,0.54,48,41,89,627083
chr1,41127578,0.08,7,80,87,627084
chr1,41127660,0.36,21,38,59,627085
chr1,41127674,0.18,11,51,62,627086
chr1,41127865,0.04,2,43,45,627087
chr1,41127911,0.22,14,49,63,627088
chr1,41127976,0.23,15,51,66,627089
chr1,41128021,0.71,60,24,84,627090
chr1,41128166,0.68,63,29,92,627091
chr1,41128181,0.9,88,10,98,627092
chr1,41128293,0.86,51,8,59,627093
chr1,41128556,1,63,0,63,627094
chr1,41128694,0.82,55,12,67,627095
chr1,41128848,0.54,37,32,69,627096
chr1,41128874,0.73,51,19,70,627097
chr1,41129335,0.85,75,13,88,627098
chr1,41129371,0.34,24,47,71,627099
chr1,41129374,0.23,16,53,69,627100
chr1,41129446,0.12,5,36,41,627101
chr1,41129484,0.5,14,14,28,627102
chr1,41129488,0.59,22,15,37,627103
chr1,41129572,0.46,28,33,61,627104
chr1,41129755,0.59,44,30,74,627105
chr1,41129925,1,54,0,54,627106
chr1,41130426,0.79,46,12,58,627107
chr1,41130641,0.07,3,39,42,627108
chr1,41130649,0.04,2,43,45,627109
chr1,41130871,0.04,2,52,54,627110
chr1,41130939,0.16,3,16,19,627111
chr1,41130963,0,0,49,49,627112
chr1,41130968,0.08,3,34,37,627113
chr1,41130996,0.05,2,40,42,627114
chr1,41131030,0,0,27,27,627115
chr1,41131044,0.06,2,29,31,627116
chr1,41131067,0,0,40,40,627117
chr1,41131079,0.02,1,40,41,627118
chr1,41131112,0.02,1,46,47,627119
chr1,41131117,0,0,34,34,627120
chr1,41131123,0.02,1,52,53,627121
chr1,41131130,0,0,41,41,627122
chr1,41131147,0.08,4,48,52,627123
chr1,41131155,0,0,33,33,627124
chr1,41131160,0,0,47,47,627125
chr1,41131162,0.02,1,43,44,627126
chr1,41131168,0,0,45,45,627127
chr1,41131178,0,0,30,30,627128
chr1,41131180,0.03,1,37,38,627129
chr1,41131185,0,0,40,40,627130
chr1,41131199,0,0,30,30,627131
chr1,41131201,0,0,33,33,627132
chr1,41131208,0,0,40,40,627133
chr1,41131222,0,0,31,31,627134
chr1,41131224,0,0,36,36,627135
chr1,41131229,0,0,20,20,627136
chr1,41131239,0,0,16,16,627137
chr1,41131242,0,0,21,21,627138
chr1,41131255,0.03,1,32,33,627139
chr1,41131264,0,0,26,26,627140
chr1,41131268,0,0,26,26,627141
chr1,41131276,0,0,35,35,627142
chr1,41131288,0,0,28,28,627143
chr1,41131293,0,0,33,33,627144
chr1,41131297,0,0,33,33,627145
chr1,41131309,0,0,48,48,627146
chr1,41131315,0.05,2,39,41,627147
chr1,41131327,0,0,46,46,627148
chr1,41131337,0,0,40,40,627149
chr1,41131340,0,0,41,41,627150
chr1,41131343,0,0,54,54,627151
chr1,41131367,0.08,4,47,51,627152
chr1,41131370,0,0,41,41,627153
chr1,41131377,0,0,26,26,627154
chr1,41131398,0.1,4,35,39,627155
chr1,41131404,0,0,12,12,627156
chr1,41131410,0,0,25,25,627157
chr1,41131412,0,0,27,27,627158
chr1,41131422,0,0,14,14,627159
chr1,41131436,0,0,25,25,627160
chr1,41131453,0,0,5,5,627161
chr1,41131470,0.04,1,23,24,627162
chr1,41131487,0,0,19,19,627163
chr1,41131531,0,0,15,15,627164
chr1,41131559,0,0,12,12,627165
chr1,41131589,0.04,1,22,23,627166
chr1,41131676,0,0,53,53,627167
chr1,41131679,0,0,27,27,627168
chr1,41131718,0,0,89,89,627169
chr1,41131740,0.01,1,110,111,627170
chr1,41131751,0,0,108,108,627171
chr1,41131874,0.1,8,72,80,627172
chr1,41131908,0.78,58,16,74,627173
chr1,41131946,0.52,51,47,98,627174
chr1,41131970,0.27,30,83,113,627175
chr1,41132004,0.21,27,103,130,627176
chr1,41132022,0.74,98,34,132,627177
chr1,41132056,0.86,95,16,111,627178
chr1,41132083,0.93,105,8,113,627179
chr1,41132103,0.74,84,30,114,627180
chr1,41132210,0.61,67,42,109,627181
chr1,41132243,0.64,58,32,90,627182
chr1,41132427,0.91,61,6,67,627183
chr1,41132494,0.92,54,5,59,627184
chr1,41132589,0.9,86,10,96,627185
chr1,41132604,0.93,90,7,97,627186
chr1,41132628,0.98,99,2,101,627187
chr1,41132645,0.93,87,7,94,627188
chr1,41132651,0.96,74,3,77,627189
chr1,41132795,0.97,56,2,58,627190
chr1,41132865,0.93,43,3,46,627191
chr1,41133057,0.93,51,4,55,627192
chr1,41133374,0.99,71,1,72,627193
chr1,41133439,0.96,87,4,91,627194
chr1,41133523,0.95,70,4,74,627195
chr1,41133571,1,49,0,49,627196
chr1,41133646,0.93,55,4,59,627197
chr1,41133652,0.98,53,1,54,627198
chr1,41133690,0.94,60,4,64,627199
chr1,41133699,0.93,63,5,68,627200
chr1,41133837,1,49,0,49,627201
chr1,41133854,1,37,0,37,627202
chr1,41133877,0.93,26,2,28,627203
chr1,41134050,0.96,69,3,72,627204
chr1,41134140,1,38,0,38,627205
chr1,41134163,0.97,35,1,36,627206
chr1,41134184,0.25,8,24,32,627207
chr1,41134251,0.52,34,32,66,627208
chr1,41134467,0.08,4,44,48,627209
chr1,41134513,0.71,30,12,42,627210
chr1,41134530,0.21,11,41,52,627211
chr1,41134535,0.13,7,46,53,627212
chr1,41134541,0.14,7,43,50,627213
chr1,41134573,0.02,1,52,53,627214
chr1,41134579,0,0,56,56,627215
chr1,41134605,0.02,1,47,48,627216
chr1,41134608,0,0,32,32,627217
chr1,41134620,0,0,39,39,627218
chr1,41134639,0,0,47,47,627219
chr1,41134649,0,0,51,51,627220
chr1,41134662,0,0,46,46,627221
chr1,41134700,0,0,63,63,627222
chr1,41134705,0,0,66,66,627223
chr1,41134739,0,0,74,74,627224
chr1,41134741,0.01,1,70,71,627225
chr1,41134801,0,0,79,79,627226
chr1,41134917,0.04,4,86,90,627227
chr1,41134956,0.72,66,26,92,627228
chr1,41135188,0.82,77,17,94,627229
chr1,41135229,0.48,45,49,94,627230
chr1,41135263,0.54,53,45,98,627231
chr1,41136321,0.94,46,3,49,627232
chr1,41136346,0.98,61,1,62,627233
chr1,41136417,1,61,0,61,627234
chr1,41136541,0.92,73,6,79,627235
chr1,41137254,0.92,59,5,64,627236
chr1,41137292,0.94,60,4,64,627237
chr1,41137294,1,65,0,65,627238
chr1,41137495,0.96,72,3,75,627239
chr1,41137649,0.96,53,2,55,627240
chr1,41137719,0.95,58,3,61,627241
chr1,41137893,1,13,0,13,627242
chr1,41137901,1,17,0,17,627243
chr1,41137918,0.95,19,1,20,627244
chr1,41137939,0.9,19,2,21,627245
chr1,41137956,0.95,19,1,20,627246
chr1,41137963,0.79,15,4,19,627247
chr1,41138019,1,1,0,1,627248
chr1,41138071,0.67,2,1,3,627249
chr1,41138091,0.94,16,1,17,627250
chr1,41138105,0.94,32,2,34,627251
chr1,41138121,0.95,52,3,55,627252
chr1,41138149,0.99,82,1,83,627253
chr1,41138159,0.98,91,2,93,627254
chr1,41138169,0.97,100,3,103,627255
chr1,41138206,0.92,98,8,106,627256
chr1,41138260,0.69,53,24,77,627257
chr1,41138388,0.97,95,3,98,627258
chr1,41138560,0.9,26,3,29,627259
chr1,41138707,0.97,60,2,62,627260
chr1,41138712,0.95,60,3,63,627261
chr1,41138783,0.99,77,1,78,627262
chr1,41139123,0.93,64,5,69,627263
chr1,41139158,0.87,54,8,62,627264
chr1,41139180,0.98,53,1,54,627265
chr1,41139195,0.33,19,38,57,627266
chr1,41139390,0.58,71,52,123,627267
chr1,41139631,0.91,69,7,76,627268
chr1,41139729,0.95,91,5,96,627269
chr1,41139889,0.91,81,8,89,627270
chr1,41140056,0.91,86,9,95,627271
chr1,41140112,0.93,111,8,119,627272
chr1,41140300,0.15,6,33,39,627273
chr1,41140612,0.95,73,4,77,627274
chr1,41140663,0.98,105,2,107,627275
chr1,41140690,0.94,119,8,127,627276
chr1,41140767,0.98,117,3,120,627277
chr1,41140895,0.25,21,63,84,627278
chr1,41141047,0.94,59,4,63,627279
chr1,41141157,0.95,52,3,55,627280
chr1,41141227,0.99,76,1,77,627281
chr1,41141290,0.95,69,4,73,627282
chr1,41141361,0.94,48,3,51,627283
chr1,41141370,0.98,45,1,46,627284
chr1,41141384,0.78,31,9,40,627285
chr1,41141554,0.74,66,23,89,627286
chr1,41141923,0.09,8,86,94,627287
chr1,41142066,0.03,2,66,68,627288
chr1,41142130,0.36,27,49,76,627289
chr1,41142143,0.16,13,68,81,627290
chr1,41142155,0.04,3,81,84,627291
chr1,41142240,0.05,4,84,88,627292
chr1,41142896,0.98,59,1,60,627293
chr1,41142923,0.97,59,2,61,627294
chr1,41142966,0.9,61,7,68,627295
chr1,41142971,0.99,75,1,76,627296
chr1,41143092,0.98,62,1,63,627297
chr1,41143098,0.98,55,1,56,627298
chr1,41143145,1,25,0,25,627299
chr1,41143152,0.92,24,2,26,627300
chr1,41143166,1,18,0,18,627301
chr1,41143186,0.64,9,5,14,627302
chr1,41143197,0.94,16,1,17,627303
chr1,41143238,1,19,0,19,627304
chr1,41143242,1,21,0,21,627305
chr1,41143246,0.95,20,1,21,627306
chr1,41143286,1,24,0,24,627307
chr1,41143301,0.92,24,2,26,627308
chr1,41143356,0.96,49,2,51,627309
chr1,41143502,0.63,57,34,91,627310
chr1,41143600,1,80,0,80,627311
chr1,41143807,0.92,54,5,59,627312
chr1,41143850,0.98,49,1,50,627313
chr1,41143908,0.95,55,3,58,627314
chr1,41143948,0.99,67,1,68,627315
chr1,41143952,0.93,65,5,70,627316
chr1,41143994,0.96,50,2,52,627317
chr1,41144020,1,24,0,24,627318
chr1,41144165,1,39,0,39,627319
chr1,41144373,0.95,56,3,59,627320
chr1,41144376,1,57,0,57,627321
chr1,41144414,0.95,62,3,65,627322
chr1,41144508,0.92,101,9,110,627323
chr1,41144703,0.97,59,2,61,627324
chr1,41145210,0.96,80,3,83,627325
chr1,41145430,1,66,0,66,627326
chr1,41145772,0.96,68,3,71,627327
chr1,41145885,0.96,74,3,77,627328
chr1,41146042,0.82,41,9,50,627329
chr1,41146089,0.98,82,2,84,627330
chr1,41146164,0.94,83,5,88,627331
chr1,41146250,0.98,55,1,56,627332
chr1,41146255,0.91,49,5,54,627333
chr1,41147005,0.9,43,5,48,627334
chr1,41147137,0.99,70,1,71,627335
chr1,41147182,0.95,95,5,100,627336
chr1,41147201,0.96,95,4,99,627337
chr1,41147549,0.97,60,2,62,627338
chr1,41147623,0.98,62,1,63,627339
chr1,41148116,0.94,51,3,54,627340
chr1,41148186,1,68,0,68,627341
chr1,41148217,0.98,61,1,62,627342
chr1,41148481,0.88,37,5,42,627343
chr1,41148505,0.9,54,6,60,627344
chr1,41148515,0.89,54,7,61,627345
chr1,41148537,0.92,56,5,61,627346
chr1,41148807,0.95,80,4,84,627347
chr1,41148910,0.96,105,4,109,627348
chr1,41148976,0.86,84,14,98,627349
chr1,41149013,0.97,73,2,75,627350
chr1,41149153,0.81,30,7,37,627351
chr1,41149188,0.95,62,3,65,627352
chr1,41149399,0.45,39,48,87,627353
chr1,41150193,0.95,123,6,129,627354
chr1,41150348,0.97,77,2,79,627355
chr1,41150564,0.82,70,15,85,627356
chr1,41150667,0.94,92,6,98,627357
chr1,41150781,1,71,0,71,627358
chr1,41150906,0.96,50,2,52,627359
chr1,41151110,0.71,65,26,91,627360
chr1,41151120,0.97,72,2,74,627361
chr1,41151246,0.95,83,4,87,627362
chr1,41151292,0.91,86,9,95,627363
chr1,41151321,0.98,96,2,98,627364
chr1,41151340,0.99,93,1,94,627365
chr1,41151541,0.98,43,1,44,627366
chr1,41151553,0.98,48,1,49,627367
chr1,41151573,0.92,60,5,65,627368
chr1,41151648,0.95,52,3,55,627369
chr1,41151739,0.97,59,2,61,627370
chr1,41151808,0.95,39,2,41,627371
chr1,41151928,0.96,69,3,72,627372
chr1,41152046,0.96,71,3,74,627373
chr1,41152062,0.96,65,3,68,627374
chr1,41152120,1,57,0,57,627375
chr1,41152140,0.95,59,3,62,627376
chr1,41152153,0.94,62,4,66,627377
chr1,41152185,0.97,74,2,76,627378
chr1,41152195,0.99,74,1,75,627379
chr1,41152201,1,76,0,76,627380
chr1,41152221,0.91,67,7,74,627381
chr1,41152231,0.99,75,1,76,627382
chr1,41152245,0.97,69,2,71,627383
chr1,41152253,1,77,0,77,627384
chr1,41152260,0.99,73,1,74,627385
chr1,41152285,0.99,68,1,69,627386
chr1,41152323,0.94,68,4,72,627387
chr1,41152381,0.95,87,5,92,627388
chr1,41152485,1,103,0,103,627389
chr1,41152873,0.97,92,3,95,627390
chr1,41152879,0.99,95,1,96,627391
chr1,41152886,0.95,89,5,94,627392
chr1,41152940,0.88,65,9,74,627393
chr1,41152995,0.89,31,4,35,627394
chr1,41153001,0.64,16,9,25,627395
chr1,41153011,0.71,17,7,24,627396
chr1,41153102,0.98,53,1,54,627397
chr1,41153130,0.95,56,3,59,627398
chr1,41153144,0.98,50,1,51,627399
chr1,41153146,1,53,0,53,627400
chr1,41153166,0.97,66,2,68,627401
chr1,41153188,0.97,76,2,78,627402
chr1,41153198,0.96,75,3,78,627403
chr1,41153205,0.97,71,2,73,627404
chr1,41153212,0.92,56,5,61,627405
chr1,41153222,0.95,60,3,63,627406
chr1,41153348,0.85,73,13,86,627407
chr1,41153454,0.96,107,5,112,627408
chr1,41153639,0.95,99,5,104,627409
chr1,41153667,0.97,109,3,112,627410
chr1,41153699,0.97,97,3,100,627411
chr1,41153705,0.97,94,3,97,627412
chr1,41153781,0.96,72,3,75,627413
chr1,41153797,0.94,63,4,67,627414
chr1,41153825,0.95,60,3,63,627415
chr1,41153856,0.95,55,3,58,627416
chr1,41153870,0.97,56,2,58,627417
chr1,41153881,0.96,72,3,75,627418
chr1,41153926,0.95,73,4,77,627419
chr1,41153937,0.99,79,1,80,627420
chr1,41154278,0.98,82,2,84,627421
chr1,41154383,0.87,61,9,70,627422
chr1,41154544,0.9,74,8,82,627423
chr1,41154736,0.87,74,11,85,627424
chr1,41154992,0.98,48,1,49,627425
chr1,41155014,0.96,53,2,55,627426
chr1,41155078,0.93,80,6,86,627427
chr1,41155187,0.96,69,3,72,627428
chr1,41155203,0.96,66,3,69,627429
chr1,41155241,0.95,73,4,77,627430
chr1,41155247,0.96,81,3,84,627431
chr1,41155251,0.97,84,3,87,627432
chr1,41155305,0.92,83,7,90,627433
chr1,41155362,0.96,49,2,51,627434
chr1,41155606,0.19,17,73,90,627435
chr1,41156064,0.76,53,17,70,627436
chr1,41156072,0.68,48,23,71,627437
chr1,41156091,0.76,68,21,89,627438
chr1,41156100,0.89,67,8,75,627439
chr1,41156144,0.88,81,11,92,627440
chr1,41156345,0.59,54,38,92,627441
chr1,41156520,0.95,105,5,110,627442
chr1,41156608,0.75,97,33,130,627443
chr1,41156730,0.24,25,80,105,627444
chr1,41156791,0.2,20,79,99,627445
chr1,41156836,0.18,17,78,95,627446
chr1,41156839,0.38,37,61,98,627447
chr1,41156961,0.01,1,69,70,627448
chr1,41156980,0.02,1,62,63,627449
chr1,41156988,0.01,1,72,73,627450
chr1,41157043,0.09,5,51,56,627451
chr1,41157075,0.08,7,80,87,627452
chr1,41157077,0.18,15,70,85,627453
chr1,41157111,0.01,1,66,67,627454
chr1,41157163,0,0,21,21,627455
chr1,41157169,0,0,47,47,627456
chr1,41157178,0.02,1,40,41,627457
chr1,41157188,0,0,27,27,627458
chr1,41157208,0,0,38,38,627459
chr1,41157216,0,0,36,36,627460
chr1,41157226,0,0,23,23,627461
chr1,41157253,0.06,1,15,16,627462
chr1,41157266,0,0,39,39,627463
chr1,41157269,0.04,1,23,24,627464
chr1,41157286,0,0,38,38,627465
chr1,41157288,0.03,1,34,35,627466
chr1,41157314,0,0,26,26,627467
chr1,41157319,0,0,29,29,627468
chr1,41157323,0,0,31,31,627469
chr1,41157341,0,0,13,13,627470
chr1,41157372,0,0,24,24,627471
chr1,41157381,0,0,25,25,627472
chr1,41157384,0,0,19,19,627473
chr1,41157390,0,0,21,21,627474
chr1,41157410,0,0,25,25,627475
chr1,41157415,0,0,26,26,627476
chr1,41157417,0,0,27,27,627477
chr1,41157419,0,0,24,24,627478
chr1,41157421,0,0,19,19,627479
chr1,41157426,0.03,1,28,29,627480
chr1,41157433,0,0,30,30,627481
chr1,41157438,0,0,26,26,627482
chr1,41157459,0,0,15,15,627483
chr1,41157462,0,0,18,18,627484
chr1,41157464,0,0,15,15,627485
chr1,41157485,0,0,25,25,627486
chr1,41157491,0,0,29,29,627487
chr1,41157499,0,0,31,31,627488
chr1,41157501,0,0,34,34,627489
chr1,41157507,0,0,26,26,627490
chr1,41157553,0,0,38,38,627491
chr1,41157567,0,0,30,30,627492
chr1,41157584,0,0,27,27,627493
chr1,41157587,0,0,25,25,627494
chr1,41157590,0,0,17,17,627495
chr1,41157605,0,0,22,22,627496
chr1,41157612,0,0,28,28,627497
chr1,41157618,0,0,34,34,627498
chr1,41157638,0,0,35,35,627499
chr1,41157640,0,0,32,32,627500
chr1,41157642,0,0,35,35,627501
chr1,41157646,0,0,35,35,627502
chr1,41157659,0,0,40,40,627503
chr1,41157664,0.03,1,39,40,627504
chr1,41157673,0,0,37,37,627505
chr1,41157676,0,0,43,43,627506
chr1,41157701,0,0,48,48,627507
chr1,41157710,0,0,41,41,627508
chr1,41157713,0,0,46,46,627509
chr1,41157716,0,0,48,48,627510
chr1,41157719,0,0,55,55,627511
chr1,41157721,0,0,50,50,627512
chr1,41157725,0,0,56,56,627513
chr1,41157734,0,0,55,55,627514
chr1,41157743,0,0,53,53,627515
chr1,41157746,0,0,55,55,627516
chr1,41157751,0,0,54,54,627517
chr1,41157756,0,0,51,51,627518
chr1,41157758,0,0,53,53,627519
chr1,41157776,0,0,41,41,627520
chr1,41157783,0,0,32,32,627521
chr1,41157786,0,0,43,43,627522
chr1,41157789,0,0,35,35,627523
chr1,41157799,0,0,42,42,627524
chr1,41157803,0,0,49,49,627525
chr1,41157813,0,0,50,50,627526
chr1,41157819,0,0,30,30,627527
chr1,41157828,0,0,35,35,627528
chr1,41157830,0,0,35,35,627529
chr1,41157851,0,0,46,46,627530
chr1,41157853,0,0,44,44,627531
chr1,41157862,0,0,55,55,627532
chr1,41157895,0,0,56,56,627533
chr1,41157903,0,0,53,53,627534
chr1,41157905,0.02,1,43,44,627535
chr1,41157907,0,0,51,51,627536
chr1,41157922,0.04,1,25,26,627537
chr1,41157944,0,0,53,53,627538
chr1,41157947,0,0,43,43,627539
chr1,41157953,0,0,42,42,627540
chr1,41157963,0,0,44,44,627541
chr1,41157966,0.03,1,29,30,627542
chr1,41157974,0,0,11,11,627543
chr1,41158149,0,0,94,94,627544
chr1,41158158,0,0,97,97,627545
chr1,41158178,0,0,94,94,627546
chr1,41158230,0,0,95,95,627547
chr1,41158285,0,0,88,88,627548
chr1,41158294,0,0,87,87,627549
chr1,41158370,0,0,103,103,627550
chr1,41158404,0.03,3,103,106,627551
chr1,41158439,0,0,101,101,627552
chr1,41158521,0.05,5,104,109,627553
chr1,41158745,0.01,1,83,84,627554
chr1,41158937,0.14,18,109,127,627555
chr1,41158986,0.63,80,46,126,627556
chr1,41159016,0.52,59,55,114,627557
chr1,41159283,0.86,83,14,97,627558
chr1,41159805,0.92,78,7,85,627559
chr1,41160127,0.61,60,39,99,627560
chr1,41160271,0.69,68,31,99,627561
chr1,41160650,0.98,64,1,65,627562
chr1,41160662,0.97,64,2,66,627563
chr1,41160677,0.92,71,6,77,627564
chr1,41160732,0.96,85,4,89,627565
chr1,41160783,1,84,0,84,627566
chr1,41160803,0.99,81,1,82,627567
chr1,41160835,0.88,61,8,69,627568
chr1,41160897,0.99,68,1,69,627569
chr1,41161003,0.95,79,4,83,627570
chr1,41161185,0.96,76,3,79,627571
chr1,41161195,0.99,72,1,73,627572
chr1,41161217,0.91,61,6,67,627573
chr1,41161281,0.77,68,20,88,627574
chr1,41161344,0.95,98,5,103,627575
chr1,41161372,0.98,89,2,91,627576
chr1,41161382,0.92,84,7,91,627577
chr1,41161609,0.7,70,30,100,627578
chr1,41161681,0.21,15,57,72,627579
chr1,41161725,0.82,37,8,45,627580
chr1,41161756,0.89,51,6,57,627581
chr1,41161758,0.94,58,4,62,627582
chr1,41161798,0.88,56,8,64,627583
chr1,41161840,0.84,42,8,50,627584
chr1,41161844,0.94,48,3,51,627585
chr1,41161885,0.9,57,6,63,627586
chr1,41161930,0.92,58,5,63,627587
chr1,41161937,0.92,54,5,59,627588
chr1,41161946,0.98,60,1,61,627589
chr1,41162111,0.97,85,3,88,627590
chr1,41162131,0.92,84,7,91,627591
chr1,41162277,0.92,109,9,118,627592
chr1,41162330,0.84,87,16,103,627593
chr1,41162795,0.94,68,4,72,627594
chr1,41162844,0.92,90,8,98,627595
chr1,41162934,0.77,95,28,123,627596
chr1,41163203,0.99,75,1,76,627597
chr1,41163208,0.97,75,2,77,627598
chr1,41163255,0.81,77,18,95,627599
chr1,41163353,0.67,63,31,94,627600
chr1,41163392,0.54,54,46,100,627601
chr1,41163721,0.76,87,27,114,627602
chr1,41163772,0.95,92,5,97,627603
chr1,41163800,0.95,93,5,98,627604
chr1,41163863,0.86,74,12,86,627605
chr1,41163949,0.96,80,3,83,627606
chr1,41163953,0.95,83,4,87,627607
chr1,41163965,0.98,80,2,82,627608
chr1,41164020,0.91,49,5,54,627609
chr1,41164055,0.76,31,10,41,627610
chr1,41164137,0.96,76,3,79,627611
chr1,41164167,0.97,88,3,91,627612
chr1,41164201,0.94,93,6,99,627613
chr1,41164246,0.95,86,5,91,627614
chr1,41164319,0.95,60,3,63,627615
chr1,41164363,1,74,0,74,627616
chr1,41164415,0.95,71,4,75,627617
chr1,41164558,0.98,80,2,82,627618
chr1,41164562,1,80,0,80,627619
chr1,41164565,0.99,80,1,81,627620
chr1,41164607,0.98,46,1,47,627621
chr1,41164696,0.95,59,3,62,627622
chr1,41164728,0.86,62,10,72,627623
chr1,41164750,0.85,61,11,72,627624
chr1,41164760,0.69,48,22,70,627625
chr1,41164784,0.32,20,42,62,627626
chr1,41164790,0.34,19,37,56,627627
chr1,41164792,0.49,24,25,49,627628
chr1,41164817,0.07,4,55,59,627629
chr1,41165218,0.05,6,127,133,627630
chr1,41165339,0.1,8,72,80,627631
chr1,41165624,0.97,111,3,114,627632
chr1,41165626,0.95,111,6,117,627633
chr1,41165657,0.95,116,6,122,627634
chr1,41165683,0.54,71,61,132,627635
chr1,41165785,0.94,82,5,87,627636
chr1,41165830,0.99,91,1,92,627637
chr1,41166058,0.99,91,1,92,627638
chr1,41166307,0.99,84,1,85,627639
chr1,41166425,0.95,75,4,79,627640
chr1,41166539,0.89,80,10,90,627641
chr1,41166671,0.88,81,11,92,627642
chr1,41166705,0.97,83,3,86,627643
chr1,41166799,0.98,56,1,57,627644
chr1,41166988,0.88,49,7,56,627645
chr1,41167064,1,63,0,63,627646
chr1,41167068,0.92,55,5,60,627647
chr1,41167251,0.84,87,16,103,627648
chr1,41167532,0.59,53,37,90,627649
chr1,41167554,0.72,61,24,85,627650
chr1,41167700,0.56,35,28,63,627651
chr1,41167771,0.92,86,7,93,627652
chr1,41167960,0.93,90,7,97,627653
chr1,41168032,0.67,28,14,42,627654
chr1,41168075,0.98,46,1,47,627655
chr1,41168100,0.96,67,3,70,627656
chr1,41168117,0.97,76,2,78,627657
chr1,41168139,0.97,77,2,79,627658
chr1,41168249,0.98,88,2,90,627659
chr1,41168265,0.98,87,2,89,627660
chr1,41168303,1,91,0,91,627661
chr1,41168309,0.97,94,3,97,627662
chr1,41168536,1,66,0,66,627663
chr1,41168557,0.96,64,3,67,627664
chr1,41168591,0.95,60,3,63,627665
chr1,41168613,0.82,45,10,55,627666
chr1,41168645,0.8,45,11,56,627667
chr1,41168677,0.79,52,14,66,627668
chr1,41168740,0.69,43,19,62,627669
chr1,41168780,0.61,56,36,92,627670
chr1,41168817,0.29,31,76,107,627671
chr1,41169032,0.88,42,6,48,627672
chr1,41169120,0.55,17,14,31,627673
chr1,41169291,0.43,43,56,99,627674
chr1,41169320,0.78,87,24,111,627675
chr1,41169804,0.95,21,1,22,627676
chr1,41169806,0.75,21,7,28,627677
chr1,41169888,0.95,52,3,55,627678
chr1,41169892,0.97,58,2,60,627679
chr1,41169900,0.57,36,27,63,627680
chr1,41169904,0.85,61,11,72,627681
chr1,41169933,0.92,71,6,77,627682
chr1,41169944,0.39,30,47,77,627683
chr1,41169964,0.98,78,2,80,627684
chr1,41169978,0.92,81,7,88,627685
chr1,41170022,0.93,81,6,87,627686
chr1,41170034,0.98,84,2,86,627687
chr1,41170341,0.98,96,2,98,627688
chr1,41170396,0.83,73,15,88,627689
chr1,41170407,0.83,70,14,84,627690
chr1,41170646,0.85,56,10,66,627691
chr1,41170927,0.9,62,7,69,627692
chr1,41171154,0.95,92,5,97,627693
chr1,41171457,0.96,64,3,67,627694
chr1,41171487,0.94,67,4,71,627695
chr1,41171562,0.97,73,2,75,627696
chr1,41171709,1,67,0,67,627697
chr1,41171866,1,85,0,85,627698
chr1,41172117,0.93,94,7,101,627699
chr1,41172196,0.98,103,2,105,627700
chr1,41172403,0.6,52,35,87,627701
chr1,41172563,0.82,55,12,67,627702
chr1,41172567,0.89,57,7,64,627703
chr1,41172607,0.91,61,6,67,627704
chr1,41172698,0.97,37,1,38,627705
chr1,41172734,0.55,21,17,38,627706
chr1,41172742,1,41,0,41,627707
chr1,41172756,0.95,39,2,41,627708
chr1,41172785,1,43,0,43,627709
chr1,41172796,0.98,42,1,43,627710
chr1,41172801,0.95,41,2,43,627711
chr1,41172931,0.96,44,2,46,627712
chr1,41173108,0.96,45,2,47,627713
chr1,41173111,1,48,0,48,627714
chr1,41173213,0.89,42,5,47,627715
chr1,41173233,1,56,0,56,627716
chr1,41173273,0.98,45,1,46,627717
chr1,41173367,0.93,41,3,44,627718
chr1,41173425,0.93,40,3,43,627719
chr1,41173442,1,42,0,42,627720
chr1,41173459,0.98,39,1,40,627721
chr1,41173465,0.95,37,2,39,627722
chr1,41173497,0.81,26,6,32,627723
chr1,41173554,0.51,25,24,49,627724
chr1,41173643,0.82,72,16,88,627725
chr1,41173712,0.92,99,9,108,627726
chr1,41173817,0.9,94,11,105,627727
chr1,41174259,0.64,51,29,80,627728
chr1,41174527,0.01,1,94,95,627729
chr1,41174571,0.02,2,121,123,627730
chr1,41174668,0,0,127,127,627731
chr1,41174793,0,0,139,139,627732
chr1,41174893,0,0,122,122,627733
chr1,41174907,0.01,1,122,123,627734
chr1,41174927,0.01,1,124,125,627735
chr1,41175048,0.01,1,86,87,627736
chr1,41175097,0.02,1,63,64,627737
chr1,41175132,0.02,1,64,65,627738
chr1,41175199,0.03,2,67,69,627739
chr1,41175244,0.04,3,79,82,627740
chr1,41175287,0.02,2,99,101,627741
chr1,41175477,0.01,1,92,93,627742
chr1,41175616,0.03,3,101,104,627743
chr1,41175728,0.04,4,90,94,627744
chr1,41176012,0.08,7,85,92,627745
chr1,41176298,0.07,5,69,74,627746
chr1,41176328,0.06,5,78,83,627747
chr1,41176363,0.04,3,73,76,627748
chr1,41176372,0.02,1,65,66,627749
chr1,41176439,0.03,3,90,93,627750
chr1,41176498,0.04,6,139,145,627751
chr1,41176629,0.08,5,59,64,627752
chr1,41177236,0,0,79,79,627753
chr1,41177689,0.05,5,96,101,627754
chr1,41177788,0.02,2,90,92,627755
chr1,41177943,0.07,7,89,96,627756
chr1,41178360,0.07,2,27,29,627757
chr1,41178368,0.27,9,24,33,627758
chr1,41178406,0.06,3,46,49,627759
chr1,41178505,0.87,66,10,76,627760
chr1,41178562,0.71,36,15,51,627761
chr1,41179080,0.49,55,57,112,627762
chr1,41180180,0.95,88,5,93,627763
chr1,41180410,0.95,76,4,80,627764
chr1,41180434,0.97,76,2,78,627765
chr1,41180478,1,61,0,61,627766
chr1,41180490,0.98,63,1,64,627767
chr1,41180518,0.97,68,2,70,627768
chr1,41180534,0.94,82,5,87,627769
chr1,41180608,0.97,58,2,60,627770
chr1,41180620,0.94,48,3,51,627771
chr1,41180624,0.94,45,3,48,627772
chr1,41180644,0.96,49,2,51,627773
chr1,41180676,0.97,56,2,58,627774
chr1,41180683,0.97,58,2,60,627775
chr1,41180700,0.94,59,4,63,627776
chr1,41180708,0.98,60,1,61,627777
chr1,41180738,0.96,43,2,45,627778
chr1,41180850,0.97,67,2,69,627779
chr1,41180924,0.98,87,2,89,627780
chr1,41180938,0.99,86,1,87,627781
chr1,41181049,0.88,28,4,32,627782
chr1,41181134,0.91,53,5,58,627783
chr1,41181271,0.88,88,12,100,627784
chr1,41181343,0.98,104,2,106,627785
chr1,41181436,0.8,79,20,99,627786
chr1,41181630,0.68,57,27,84,627787
chr1,41181806,0.94,109,7,116,627788
chr1,41181944,0.85,90,16,106,627789
chr1,41181948,0.97,107,3,110,627790
chr1,41182222,0.74,51,18,69,627791
chr1,41182376,0.96,87,4,91,627792
chr1,41182421,0.93,105,8,113,627793
chr1,41183104,0.44,42,54,96,627794
chr1,41183149,0.98,100,2,102,627795
chr1,41183166,0.76,75,24,99,627796
chr1,41183944,0.73,53,20,73,627797
chr1,41184068,1,71,0,71,627798
chr1,41184186,0.97,105,3,108,627799
chr1,41184252,0.93,98,7,105,627800
chr1,41184503,0.88,79,11,90,627801
chr1,41184567,0.83,65,13,78,627802
chr1,41184583,0.96,64,3,67,627803
chr1,41184606,0.86,42,7,49,627804
chr1,41184646,1,13,0,13,627805
chr1,41184668,0.73,11,4,15,627806
chr1,41184692,0.97,34,1,35,627807
chr1,41184700,0.98,39,1,40,627808
chr1,41184732,0.87,54,8,62,627809
chr1,41184776,0.96,68,3,71,627810
chr1,41184787,0.98,79,2,81,627811
chr1,41184820,0.97,77,2,79,627812
chr1,41184829,0.97,77,2,79,627813
chr1,41184832,1,78,0,78,627814
chr1,41184861,0.91,78,8,86,627815
chr1,41184993,0.97,76,2,78,627816
chr1,41185349,0.8,119,29,148,627817
chr1,41185807,0.28,17,44,61,627818
chr1,41185951,0.87,78,12,90,627819
chr1,41186060,0.84,97,19,116,627820
chr1,41186425,0.99,114,1,115,627821
chr1,41186497,0.99,101,1,102,627822
chr1,41186513,0.95,105,6,111,627823
chr1,41186680,0.95,83,4,87,627824
chr1,41187176,0.84,54,10,64,627825
chr1,41187327,0.99,74,1,75,627826
chr1,41187365,1,77,0,77,627827
chr1,41187380,0.97,75,2,77,627828
chr1,41187423,0.83,45,9,54,627829
chr1,41187472,0.99,78,1,79,627830
chr1,41187524,0.99,104,1,105,627831
chr1,41187564,0.98,92,2,94,627832
chr1,41187568,1,86,0,86,627833
chr1,41187570,0.98,83,2,85,627834
chr1,41187617,0.97,36,1,37,627835
chr1,41187638,0.94,16,1,17,627836
chr1,41187658,1,12,0,12,627837
chr1,41187703,1,36,0,36,627838
chr1,41187767,0.93,51,4,55,627839
chr1,41187774,1,51,0,51,627840
chr1,41187799,1,52,0,52,627841
chr1,41187965,0.67,58,28,86,627842
chr1,41188199,0.95,112,6,118,627843
chr1,41188423,0.95,82,4,86,627844
chr1,41188481,0.57,53,40,93,627845
chr1,41188505,0.92,89,8,97,627846
chr1,41188825,0.13,9,63,72,627847
chr1,41188945,0.13,11,74,85,627848
chr1,41189035,0.55,48,39,87,627849
chr1,41189094,0.54,50,43,93,627850
chr1,41189402,0.96,52,2,54,627851
chr1,41189453,1,59,0,59,627852
chr1,41189464,0.86,54,9,63,627853
chr1,41189568,0.96,66,3,69,627854
chr1,41189595,0.97,71,2,73,627855
chr1,41189779,1,71,0,71,627856
chr1,41189807,0.96,76,3,79,627857
chr1,41189869,0.97,99,3,102,627858
chr1,41189908,0.97,94,3,97,627859
chr1,41189954,1,69,0,69,627860
chr1,41189964,0.89,62,8,70,627861
chr1,41189988,0.92,61,5,66,627862
chr1,41189994,0.95,63,3,66,627863
chr1,41190034,0.64,42,24,66,627864
chr1,41190303,0.65,57,31,88,627865
chr1,41190354,0.72,73,29,102,627866
chr1,41190620,0.86,74,12,86,627867
chr1,41190652,0.2,20,79,99,627868
chr1,41190814,0.25,17,51,68,627869
chr1,41191073,0.24,21,68,89,627870
chr1,41191088,0.13,12,83,95,627871
chr1,41191208,0.86,57,9,66,627872
chr1,41191726,1,102,0,102,627873
chr1,41191819,0.95,57,3,60,627874
chr1,41191850,0.98,64,1,65,627875
chr1,41191892,0.94,62,4,66,627876
chr1,41191936,0.93,53,4,57,627877
chr1,41191978,0.93,26,2,28,627878
chr1,41192009,1,20,0,20,627879
chr1,41192069,0.94,33,2,35,627880
chr1,41192079,0.97,34,1,35,627881
chr1,41192228,0.81,59,14,73,627882
chr1,41192368,0.96,97,4,101,627883
chr1,41192622,0.87,58,9,67,627884
chr1,41192710,0.97,92,3,95,627885
chr1,41193141,0.43,26,34,60,627886
chr1,41193241,0.92,23,2,25,627887
chr1,41193265,0.96,44,2,46,627888
chr1,41193271,1,50,0,50,627889
chr1,41193288,0.99,68,1,69,627890
chr1,41193363,0.95,84,4,88,627891
chr1,41193414,0.99,77,1,78,627892
chr1,41193445,0.91,52,5,57,627893
chr1,41193449,0.96,66,3,69,627894
chr1,41193454,0.92,66,6,72,627895
chr1,41193492,0.97,69,2,71,627896
chr1,41193494,0.97,72,2,74,627897
chr1,41193679,0.98,92,2,94,627898
chr1,41193730,0.96,80,3,83,627899
chr1,41193805,1,73,0,73,627900
chr1,41193881,0.98,99,2,101,627901
chr1,41193986,0.99,73,1,74,627902
chr1,41193994,1,71,0,71,627903
chr1,41193996,0.67,68,34,102,627904
chr1,41194039,0.36,50,87,137,627905
chr1,41194043,0.33,41,85,126,627906
chr1,41194084,0.85,58,10,68,627907
chr1,41194089,0.98,62,1,63,627908
chr1,41194129,0.98,79,2,81,627909
chr1,41194137,0.99,87,1,88,627910
chr1,41194161,0.98,101,2,103,627911
chr1,41194182,0.97,100,3,103,627912
chr1,41194199,0.97,104,3,107,627913
chr1,41194246,0.97,105,3,108,627914
chr1,41194332,0.94,74,5,79,627915
chr1,41194340,0.97,72,2,74,627916
chr1,41194412,1,58,0,58,627917
chr1,41194458,0.99,76,1,77,627918
chr1,41194466,0.95,78,4,82,627919
chr1,41194469,0.98,81,2,83,627920
chr1,41194529,0.97,57,2,59,627921
chr1,41194552,0.98,53,1,54,627922
chr1,41194556,0.98,65,1,66,627923
chr1,41194589,0.96,78,3,81,627924
chr1,41194720,0.91,85,8,93,627925
chr1,41194834,0.81,101,23,124,627926
chr1,41194972,0.96,90,4,94,627927
chr1,41195370,1,40,0,40,627928
chr1,41195386,0.88,49,7,56,627929
chr1,41195410,0.95,76,4,80,627930
chr1,41195433,0.97,88,3,91,627931
chr1,41195492,0.99,85,1,86,627932
chr1,41195594,1,44,0,44,627933
chr1,41195599,0.94,47,3,50,627934
chr1,41195637,0.98,53,1,54,627935
chr1,41195639,0.95,54,3,57,627936
chr1,41195701,0.88,52,7,59,627937
chr1,41195932,0.93,50,4,54,627938
chr1,41195992,0.96,97,4,101,627939
chr1,41196057,0.93,115,8,123,627940
chr1,41196068,0.89,108,13,121,627941
chr1,41196089,0.94,113,7,120,627942
chr1,41196130,0.91,107,10,117,627943
chr1,41196379,0.82,64,14,78,627944
chr1,41196597,0.91,82,8,90,627945
chr1,41196636,0.75,57,19,76,627946
chr1,41196682,0.86,64,10,74,627947
chr1,41196871,0.93,55,4,59,627948
chr1,41196949,1,60,0,60,627949
chr1,41196991,1,35,0,35,627950
chr1,41197134,1,36,0,36,627951
chr1,41197167,0.78,35,10,45,627952
chr1,41197173,0.83,39,8,47,627953
chr1,41197217,0.98,39,1,40,627954
chr1,41197219,1,36,0,36,627955
chr1,41197259,0.94,30,2,32,627956
chr1,41197268,0.94,32,2,34,627957
chr1,41197305,0.79,37,10,47,627958
chr1,41197391,0.57,28,21,49,627959
chr1,41197407,0.82,49,11,60,627960
chr1,41197435,0.98,53,1,54,627961
chr1,41197445,0.96,53,2,55,627962
chr1,41197447,1,55,0,55,627963
chr1,41197457,0.97,59,2,61,627964
chr1,41197657,0.99,101,1,102,627965
chr1,41197675,0.93,97,7,104,627966
chr1,41197749,0.99,68,1,69,627967
chr1,41198679,0.86,18,3,21,627968
chr1,41198944,0.88,91,12,103,627969
chr1,41199003,0.52,59,55,114,627970
chr1,41199143,0.95,62,3,65,627971
chr1,41199384,0.86,75,12,87,627972
chr1,41199446,0.98,81,2,83,627973
chr1,41199454,0.92,80,7,87,627974
chr1,41199501,0.96,104,4,108,627975
chr1,41199576,0.9,75,8,83,627976
chr1,41199811,0.91,90,9,99,627977
chr1,41200006,0.76,71,23,94,627978
chr1,41200103,0.93,54,4,58,627979
chr1,41200157,0.76,57,18,75,627980
chr1,41200252,0.95,40,2,42,627981
chr1,41200279,1,39,0,39,627982
chr1,41200312,0.7,38,16,54,627983
chr1,41200322,0.95,56,3,59,627984
chr1,41200328,0.94,50,3,53,627985
chr1,41200584,0.93,86,6,92,627986
chr1,41200781,0.92,66,6,72,627987
chr1,41200811,0.96,50,2,52,627988
chr1,41200815,1,47,0,47,627989
chr1,41200927,0.98,51,1,52,627990
chr1,41201109,0.97,131,4,135,627991
chr1,41201184,0.97,98,3,101,627992
chr1,41201266,0.97,76,2,78,627993
chr1,41201326,0.96,94,4,98,627994
chr1,41202207,0.2,22,86,108,627995
chr1,41202218,0.11,11,93,104,627996
chr1,41202332,0.96,125,5,130,627997
chr1,41202386,0.93,94,7,101,627998
chr1,41202411,0.98,87,2,89,627999
chr1,41202434,0.82,56,12,68,628000
chr1,41202524,1,19,0,19,628001
chr1,41202526,1,22,0,22,628002
chr1,41202536,0.96,26,1,27,628003
chr1,41202564,0.93,50,4,54,628004
chr1,41202618,0.97,61,2,63,628005
chr1,41202659,0.97,76,2,78,628006
chr1,41202786,0.92,24,2,26,628007
chr1,41203020,0.9,43,5,48,628008
chr1,41203061,0.9,43,5,48,628009
chr1,41203103,0.95,59,3,62,628010
chr1,41203145,0.94,66,4,70,628011
chr1,41203152,0.95,75,4,79,628012
chr1,41203157,0.96,72,3,75,628013
chr1,41203161,0.94,64,4,68,628014
chr1,41203220,0.95,79,4,83,628015
chr1,41203252,0.86,77,13,90,628016
chr1,41203290,0.98,94,2,96,628017
chr1,41203308,0.94,95,6,101,628018
chr1,41203400,0.9,103,11,114,628019
chr1,41203561,1,47,0,47,628020
chr1,41203597,0,0,1,1,628021
chr1,41203635,0,0,1,1,628022
chr1,41203816,1,3,0,3,628023
chr1,41203820,0.89,8,1,9,628024
chr1,41203825,1,13,0,13,628025
chr1,41203853,0.96,25,1,26,628026
chr1,41203863,0.97,32,1,33,628027
chr1,41203865,1,34,0,34,628028
chr1,41203869,0.95,35,2,37,628029
chr1,41203898,0.95,54,3,57,628030
chr1,41204373,0.98,103,2,105,628031
chr1,41204512,0.95,114,6,120,628032
chr1,41204577,0.48,49,53,102,628033
chr1,41204588,0.65,62,34,96,628034
chr1,41204606,0.55,52,43,95,628035
chr1,41204786,0.89,92,11,103,628036
chr1,41204834,0.75,70,23,93,628037
chr1,41204972,0.83,75,15,90,628038
chr1,41205075,0.96,87,4,91,628039
chr1,41205138,0.95,84,4,88,628040
chr1,41205210,0.91,83,8,91,628041
chr1,41205316,0.63,70,41,111,628042
chr1,41205924,0.26,23,66,89,628043
chr1,41206033,0.99,99,1,100,628044
chr1,41206477,0.05,4,74,78,628045
chr1,41206492,0.07,5,70,75,628046
chr1,41206504,0.09,7,69,76,628047
chr1,41206639,0.1,6,52,58,628048
chr1,41206820,0.35,39,71,110,628049
chr1,41206886,0.6,69,46,115,628050
chr1,41206942,0.99,114,1,115,628051
chr1,41207067,0.99,80,1,81,628052
chr1,41207359,0.96,48,2,50,628053
chr1,41207377,1,51,0,51,628054
chr1,41207386,0.98,55,1,56,628055
chr1,41207423,1,64,0,64,628056
chr1,41207569,0.95,58,3,61,628057
chr1,41207949,0.92,77,7,84,628058
chr1,41208516,0.47,23,26,49,628059
chr1,41208542,0.81,50,12,62,628060
chr1,41208731,0.82,119,27,146,628061
chr1,41208858,0.8,94,23,117,628062
chr1,41209023,0.95,102,5,107,628063
chr1,41209064,0.88,82,11,93,628064
chr1,41209170,0.97,62,2,64,628065
chr1,41209457,0.87,100,15,115,628066
chr1,41209508,0.93,95,7,102,628067
chr1,41209590,0.93,64,5,69,628068
chr1,41209708,0.97,89,3,92,628069
chr1,41209863,0.98,90,2,92,628070
chr1,41210288,0.94,99,6,105,628071
chr1,41210502,0.84,67,13,80,628072
chr1,41210786,0.99,95,1,96,628073
chr1,41210924,0.16,14,73,87,628074
chr1,41211437,0.95,75,4,79,628075
chr1,41211618,0.97,69,2,71,628076
chr1,41211791,0.98,132,3,135,628077
chr1,41212754,0.94,82,5,87,628078
chr1,41212757,0.9,77,9,86,628079
chr1,41212885,0.63,35,21,56,628080
chr1,41212915,0.68,27,13,40,628081
chr1,41213091,0.96,55,2,57,628082
chr1,41213098,1,54,0,54,628083
chr1,41213215,0.95,80,4,84,628084
chr1,41213239,0.86,75,12,87,628085
chr1,41213555,1,42,0,42,628086
chr1,41213570,1,46,0,46,628087
chr1,41213632,0.94,59,4,63,628088
chr1,41213652,1,56,0,56,628089
chr1,41213656,1,59,0,59,628090
chr1,41213735,0.93,70,5,75,628091
chr1,41213797,0.42,24,33,57,628092
chr1,41213872,0.93,67,5,72,628093
chr1,41213950,0.95,72,4,76,628094
chr1,41214030,0.9,62,7,69,628095
chr1,41214184,0.98,90,2,92,628096
chr1,41214303,1,65,0,65,628097
chr1,41215038,1,71,0,71,628098
chr1,41215261,0.95,101,5,106,628099
chr1,41215314,0.91,96,9,105,628100
chr1,41215344,0.99,102,1,103,628101
chr1,41215347,0.96,103,4,107,628102
chr1,41215421,0.95,81,4,85,628103
chr1,41215515,0.97,66,2,68,628104
chr1,41215703,0.88,81,11,92,628105
chr1,41215854,0.95,77,4,81,628106
chr1,41216121,0.83,76,16,92,628107
chr1,41216150,0.91,87,9,96,628108
chr1,41216216,0.89,93,12,105,628109
chr1,41217138,1,53,0,53,628110
chr1,41217162,0.97,59,2,61,628111
chr1,41217322,0.97,75,2,77,628112
chr1,41217592,0.97,93,3,96,628113
chr1,41217601,0.72,66,26,92,628114
chr1,41217619,0.99,69,1,70,628115
chr1,41217707,0.86,49,8,57,628116
chr1,41217990,0.89,109,14,123,628117
chr1,41218545,0.95,99,5,104,628118
chr1,41218547,0.91,96,10,106,628119
chr1,41218711,0.56,44,35,79,628120
chr1,41218738,0.61,57,36,93,628121
chr1,41218805,0.95,89,5,94,628122
chr1,41218834,0.95,106,6,112,628123
chr1,41218876,0.92,108,10,118,628124
chr1,41218913,0.94,101,6,107,628125
chr1,41218959,0.99,80,1,81,628126
chr1,41218983,0.98,80,2,82,628127
chr1,41219030,0.75,83,28,111,628128
chr1,41219103,0.93,106,8,114,628129
chr1,41219404,1,81,0,81,628130
chr1,41219560,0.62,66,41,107,628131
chr1,41219572,0.9,96,11,107,628132
chr1,41220011,0.94,65,4,69,628133
chr1,41220017,0.71,52,21,73,628134
chr1,41220093,0.81,50,12,62,628135
chr1,41220106,0.98,56,1,57,628136
chr1,41220119,0.96,51,2,53,628137
chr1,41220123,0.88,46,6,52,628138
chr1,41220135,0.94,48,3,51,628139
chr1,41220140,0.96,52,2,54,628140
chr1,41220481,0.84,89,17,106,628141
chr1,41220605,0.71,67,28,95,628142
chr1,41220623,0.76,70,22,92,628143
chr1,41220629,0.67,56,28,84,628144
chr1,41220771,0.68,47,22,69,628145
chr1,41220832,0.84,92,17,109,628146
chr1,41220919,0.26,31,87,118,628147
chr1,41221134,1,95,0,95,628148
chr1,41221648,0.97,61,2,63,628149
chr1,41222471,0.95,69,4,73,628150
chr1,41222498,0.7,67,29,96,628151
chr1,41222500,0.95,94,5,99,628152
chr1,41222758,0.43,22,29,51,628153
chr1,41222892,0.77,71,21,92,628154
chr1,41222901,0.83,66,14,80,628155
chr1,41222904,0.75,68,23,91,628156
chr1,41223078,0.8,55,14,69,628157
chr1,41223085,0.61,42,27,69,628158
chr1,41223096,0.8,55,14,69,628159
chr1,41223129,0.9,73,8,81,628160
chr1,41223160,0.96,93,4,97,628161
chr1,41223276,0.51,60,57,117,628162
chr1,41223355,0.5,39,39,78,628163
chr1,41223511,0.94,103,7,110,628164
chr1,41223526,0.74,88,31,119,628165
chr1,41223560,0.9,113,12,125,628166
chr1,41223740,0.9,44,5,49,628167
chr1,41223802,0.92,46,4,50,628168
chr1,41223822,0.91,59,6,65,628169
chr1,41223845,0.98,79,2,81,628170
chr1,41223864,0.97,89,3,92,628171
chr1,41223914,0.89,100,12,112,628172
chr1,41223945,0.94,107,7,114,628173
chr1,41224386,0.5,28,28,56,628174
chr1,41224433,0.79,37,10,47,628175
chr1,41224712,0.94,103,7,110,628176
chr1,41224769,0.98,93,2,95,628177
chr1,41224972,0.95,40,2,42,628178
chr1,41224998,0.94,58,4,62,628179
chr1,41225122,0.94,101,7,108,628180
chr1,41225340,0.74,79,28,107,628181
chr1,41225487,0.84,69,13,82,628182
chr1,41225504,0.97,86,3,89,628183
chr1,41225520,0.95,79,4,83,628184
chr1,41225564,0.66,56,29,85,628185
chr1,41225663,0.48,39,43,82,628186
chr1,41225752,0.48,35,38,73,628187
chr1,41225966,0.98,42,1,43,628188
chr1,41226018,0.98,48,1,49,628189
chr1,41226028,0.93,50,4,54,628190
chr1,41226118,1,53,0,53,628191
chr1,41226158,0.88,37,5,42,628192
chr1,41226167,0.93,38,3,41,628193
chr1,41226247,0.98,48,1,49,628194
chr1,41226251,0.98,53,1,54,628195
chr1,41226259,0.96,51,2,53,628196
chr1,41226263,0.96,50,2,52,628197
chr1,41226283,0.96,72,3,75,628198
chr1,41226323,0.97,72,2,74,628199
chr1,41226346,0.97,64,2,66,628200
chr1,41226378,0.96,49,2,51,628201
chr1,41226547,0.81,69,16,85,628202
chr1,41226817,0.22,24,86,110,628203
chr1,41226879,0.53,46,41,87,628204
chr1,41226916,0.09,8,82,90,628205
chr1,41227045,0.54,64,54,118,628206
chr1,41227084,0.85,104,18,122,628207
chr1,41227284,0.06,5,72,77,628208
chr1,41227326,0.05,4,73,77,628209
chr1,41227353,0.11,9,71,80,628210
chr1,41227453,0.88,86,12,98,628211
chr1,41227586,0.96,44,2,46,628212
chr1,41227598,0.95,41,2,43,628213
chr1,41227736,0.54,48,41,89,628214
chr1,41228038,0.75,57,19,76,628215
chr1,41228052,0.7,54,23,77,628216
chr1,41228218,0.6,76,51,127,628217
chr1,41228371,0.3,33,78,111,628218
chr1,41228485,0.55,42,34,76,628219
chr1,41228499,0.85,64,11,75,628220
chr1,41228531,0.96,76,3,79,628221
chr1,41228717,0.91,77,8,85,628222
chr1,41229006,0.61,51,32,83,628223
chr1,41229104,0.99,67,1,68,628224
chr1,41229121,0.86,54,9,63,628225
chr1,41229143,0.55,36,29,65,628226
chr1,41229165,0.53,31,27,58,628227
chr1,41229179,0.29,17,42,59,628228
chr1,41229261,0.9,18,2,20,628229
chr1,41229265,0.97,28,1,29,628230
chr1,41229270,0.86,24,4,28,628231
chr1,41229310,0.98,39,1,40,628232
chr1,41229342,0.87,48,7,55,628233
chr1,41229451,0.77,55,16,71,628234
chr1,41229459,0.53,39,35,74,628235
chr1,41229469,0.77,59,18,77,628236
chr1,41229583,0.51,23,22,45,628237
chr1,41229900,0.7,92,40,132,628238
chr1,41229922,0.68,81,39,120,628239
chr1,41230077,0.71,50,20,70,628240
chr1,41230087,0.95,73,4,77,628241
chr1,41230183,0.96,95,4,99,628242
chr1,41230501,0.94,78,5,83,628243
chr1,41231031,0.72,77,30,107,628244
chr1,41231047,0.69,74,34,108,628245
chr1,41231057,0.43,51,67,118,628246
chr1,41231115,0.95,94,5,99,628247
chr1,41231301,0.94,64,4,68,628248
chr1,41231433,0.95,76,4,80,628249
chr1,41231571,0.96,98,4,102,628250
chr1,41231595,1,90,0,90,628251
chr1,41231601,0.99,85,1,86,628252
chr1,41231822,0.99,97,1,98,628253
chr1,41231883,0.95,107,6,113,628254
chr1,41232282,0.91,83,8,91,628255
chr1,41232301,0.95,93,5,98,628256
chr1,41232444,0.97,62,2,64,628257
chr1,41232620,0.96,82,3,85,628258
chr1,41232678,0.93,76,6,82,628259
chr1,41232686,0.98,79,2,81,628260
chr1,41232694,0.95,79,4,83,628261
chr1,41232833,0.86,51,8,59,628262
chr1,41232998,0.98,84,2,86,628263
chr1,41233002,0.81,74,17,91,628264
chr1,41233019,0.93,90,7,97,628265
chr1,41233117,0.92,70,6,76,628266
chr1,41233197,0.97,76,2,78,628267
chr1,41233212,0.91,79,8,87,628268
chr1,41233214,0.57,50,37,87,628269
chr1,41233223,0.93,84,6,90,628270
chr1,41233306,0.92,82,7,89,628271
chr1,41233385,1,78,0,78,628272
chr1,41233432,0.95,63,3,66,628273
chr1,41233440,0.94,62,4,66,628274
chr1,41233477,0.91,80,8,88,628275
chr1,41233508,0.99,93,1,94,628276
chr1,41233626,0.75,60,20,80,628277
chr1,41233672,0.65,74,40,114,628278
chr1,41234272,0.99,73,1,74,628279
chr1,41234294,0.84,71,14,85,628280
chr1,41234421,0.76,42,13,55,628281
chr1,41234480,0.24,16,50,66,628282
chr1,41234537,0.47,41,46,87,628283
chr1,41234579,0.5,41,41,82,628284
chr1,41234651,0.99,71,1,72,628285
chr1,41234823,0.97,75,2,77,628286
chr1,41234852,0.88,59,8,67,628287
chr1,41235129,0.98,82,2,84,628288
chr1,41235226,0.89,66,8,74,628289
chr1,41235484,0.4,29,44,73,628290
chr1,41235495,0.47,36,41,77,628291
chr1,41235548,0.6,50,33,83,628292
chr1,41235769,0.41,38,54,92,628293
chr1,41235844,0.67,74,37,111,628294
chr1,41236046,0.75,36,12,48,628295
chr1,41236077,0.91,39,4,43,628296
chr1,41236090,0.3,14,32,46,628297
chr1,41236106,0.43,19,25,44,628298
chr1,41236195,0.6,21,14,35,628299
chr1,41236263,0.92,24,2,26,628300
chr1,41236311,0.86,31,5,36,628301
chr1,41236376,0.89,42,5,47,628302
chr1,41236415,0.52,43,39,82,628303
chr1,41236428,0.71,54,22,76,628304
chr1,41236467,0.73,53,20,73,628305
chr1,41236470,0.73,44,16,60,628306
chr1,41236491,0.67,49,24,73,628307
chr1,41236494,0.61,43,28,71,628308
chr1,41236590,0.78,49,14,63,628309
chr1,41236594,0.77,50,15,65,628310
chr1,41236603,1,71,0,71,628311
chr1,41236653,0.77,73,22,95,628312
chr1,41236896,0.81,43,10,53,628313
chr1,41236943,0.63,40,23,63,628314
chr1,41236997,0.33,19,39,58,628315
chr1,41237448,0.68,40,19,59,628316
chr1,41237629,0.76,79,25,104,628317
chr1,41237687,0.89,97,12,109,628318
chr1,41237744,0.81,95,23,118,628319
chr1,41237826,0.67,76,38,114,628320
chr1,41237901,0.85,64,11,75,628321
chr1,41238736,0.83,71,15,86,628322
chr1,41239013,0.94,62,4,66,628323
chr1,41239127,0.56,50,40,90,628324
chr1,41239163,0.87,68,10,78,628325
chr1,41239491,0.76,60,19,79,628326
chr1,41239526,0.23,21,70,91,628327
chr1,41239541,0.24,25,78,103,628328
chr1,41239582,0.57,61,46,107,628329
chr1,41239594,0.44,48,61,109,628330
chr1,41239656,0.98,91,2,93,628331
chr1,41240025,0.21,12,45,57,628332
chr1,41240519,0.08,10,121,131,628333
chr1,41240656,0.08,10,117,127,628334
chr1,41240881,0.96,53,2,55,628335
chr1,41240973,0.94,58,4,62,628336
chr1,41241059,0.88,45,6,51,628337
chr1,41241088,0.83,35,7,42,628338
chr1,41241090,0.79,34,9,43,628339
chr1,41241113,0.88,23,3,26,628340
chr1,41241120,0.83,19,4,23,628341
chr1,41241176,1,2,0,2,628342
chr1,41241184,1,3,0,3,628343
chr1,41241216,0.95,20,1,21,628344
chr1,41241247,0.98,44,1,45,628345
chr1,41241261,0.98,53,1,54,628346
chr1,41241268,0.98,62,1,63,628347
chr1,41241305,1,85,0,85,628348
chr1,41241315,0.93,79,6,85,628349
chr1,41241564,0.96,64,3,67,628350
chr1,41241578,0.98,64,1,65,628351
chr1,41241756,0.93,57,4,61,628352
chr1,41242110,0.58,60,44,104,628353
chr1,41242287,0.97,32,1,33,628354
chr1,41242340,0.98,57,1,58,628355
chr1,41242538,0.95,95,5,100,628356
chr1,41243041,0.93,95,7,102,628357
chr1,41243511,0.99,72,1,73,628358
chr1,41243828,0.96,87,4,91,628359
chr1,41243923,0.98,90,2,92,628360
chr1,41243970,1,81,0,81,628361
chr1,41244120,1,60,0,60,628362
chr1,41244298,0.92,94,8,102,628363
chr1,41244343,0.94,105,7,112,628364
chr1,41244439,0.83,91,18,109,628365
chr1,41244590,0.98,42,1,43,628366
chr1,41244788,0.93,54,4,58,628367
chr1,41244800,0.95,53,3,56,628368
chr1,41244833,1,35,0,35,628369
chr1,41244837,1,32,0,32,628370
chr1,41244858,1,22,0,22,628371
chr1,41244878,1,17,0,17,628372
chr1,41244889,0.92,12,1,13,628373
chr1,41244931,1,31,0,31,628374
chr1,41244935,1,29,0,29,628375
chr1,41244987,0.89,32,4,36,628376
chr1,41245011,0.96,26,1,27,628377
chr1,41245019,1,29,0,29,628378
chr1,41245049,1,14,0,14,628379
chr1,41245118,0.67,10,5,15,628380
chr1,41245354,0.52,59,55,114,628381
chr1,41245375,0.93,107,8,115,628382
chr1,41245386,0.9,100,11,111,628383
chr1,41245390,0.95,105,5,110,628384
chr1,41245733,0.53,40,36,76,628385
chr1,41245759,0.62,39,24,63,628386
chr1,41245918,0.93,95,7,102,628387
chr1,41245933,0.96,90,4,94,628388
chr1,41246053,0.98,45,1,46,628389
chr1,41246229,0.97,62,2,64,628390
chr1,41246234,0.94,63,4,67,628391
chr1,41246246,0.97,59,2,61,628392
chr1,41246300,0.65,35,19,54,628393
chr1,41246508,0.6,76,50,126,628394
chr1,41246537,0.69,81,36,117,628395
chr1,41246578,0.8,82,21,103,628396
chr1,41246758,0.94,51,3,54,628397
chr1,41246925,0.85,51,9,60,628398
chr1,41246957,1,54,0,54,628399
chr1,41247062,0.13,7,49,56,628400
chr1,41247165,0.82,23,5,28,628401
chr1,41247192,0.86,24,4,28,628402
chr1,41247199,1,25,0,25,628403
chr1,41247214,0.94,31,2,33,628404
chr1,41247386,0.91,77,8,85,628405
chr1,41247390,0.94,88,6,94,628406
chr1,41247757,0.85,56,10,66,628407
chr1,41247991,0.63,40,24,64,628408
chr1,41248016,0.77,53,16,69,628409
chr1,41248134,0,0,23,23,628410
chr1,41248180,0,0,21,21,628411
chr1,41248209,0.17,2,10,12,628412
chr1,41248250,0,0,29,29,628413
chr1,41248256,0.17,3,15,18,628414
chr1,41248264,0.2,3,12,15,628415
chr1,41248276,0.18,2,9,11,628416
chr1,41248285,0.08,3,34,37,628417
chr1,41248289,0.08,4,45,49,628418
chr1,41248295,0.08,4,49,53,628419
chr1,41248302,0.03,2,57,59,628420
chr1,41248313,0.05,3,58,61,628421
chr1,41248322,0.03,2,57,59,628422
chr1,41248338,0.09,5,52,57,628423
chr1,41248366,0.06,3,45,48,628424
chr1,41248375,0.04,1,23,24,628425
chr1,41248388,0,0,39,39,628426
chr1,41248398,0,0,46,46,628427
chr1,41248422,0,0,59,59,628428
chr1,41248507,0,0,44,44,628429
chr1,41248707,0.15,7,40,47,628430
chr1,41248750,0,0,34,34,628431
chr1,41248841,0.1,4,35,39,628432
chr1,41248878,0.57,17,13,30,628433
chr1,41248881,0.6,21,14,35,628434
chr1,41248927,0.07,3,38,41,628435
chr1,41248947,0.03,1,37,38,628436
chr1,41248956,0,0,45,45,628437
chr1,41248976,0.09,4,42,46,628438
chr1,41248995,0.12,5,36,41,628439
chr1,41249011,0.03,1,39,40,628440
chr1,41249045,0.02,1,44,45,628441
chr1,41249091,0.02,1,41,42,628442
chr1,41249094,0.02,1,57,58,628443
chr1,41249122,0.01,1,70,71,628444
chr1,41249132,0,0,57,57,628445
chr1,41249147,0,0,21,21,628446
chr1,41249151,0.02,1,48,49,628447
chr1,41249153,0.04,2,48,50,628448
chr1,41249191,0,0,65,65,628449
chr1,41249196,0,0,58,58,628450
chr1,41249206,0,0,45,45,628451
chr1,41249218,0,0,42,42,628452
chr1,41249236,0,0,43,43,628453
chr1,41249241,0,0,36,36,628454
chr1,41249259,0,0,42,42,628455
chr1,41249261,0,0,45,45,628456
chr1,41249265,0,0,49,49,628457
chr1,41249273,0.02,1,40,41,628458
chr1,41249279,0.03,1,37,38,628459
chr1,41249281,0,0,31,31,628460
chr1,41249283,0,0,30,30,628461
chr1,41249292,0,0,33,33,628462
chr1,41249297,0,0,47,47,628463
chr1,41249299,0,0,46,46,628464
chr1,41249304,0,0,43,43,628465
chr1,41249321,0,0,40,40,628466
chr1,41249325,0,0,23,23,628467
chr1,41249329,0,0,43,43,628468
chr1,41249333,0,0,22,22,628469
chr1,41249343,0,0,20,20,628470
chr1,41249346,0.04,1,25,26,628471
chr1,41249355,0.06,2,33,35,628472
chr1,41249357,0.03,1,33,34,628473
chr1,41249359,0.03,1,36,37,628474
chr1,41249372,0,0,7,7,628475
chr1,41249377,0,0,18,18,628476
chr1,41249382,0,0,23,23,628477
chr1,41249390,0,0,21,21,628478
chr1,41249394,0,0,12,12,628479
chr1,41249404,0,0,19,19,628480
chr1,41249417,0,0,12,12,628481
chr1,41249421,0.08,1,12,13,628482
chr1,41249423,0,0,14,14,628483
chr1,41249428,0,0,11,11,628484
chr1,41249432,0.09,1,10,11,628485
chr1,41249443,0,0,9,9,628486
chr1,41249448,0,0,10,10,628487
chr1,41249469,0.05,1,19,20,628488
chr1,41249472,0,0,15,15,628489
chr1,41249474,0,0,18,18,628490
chr1,41249476,0.05,1,19,20,628491
chr1,41249479,0,0,26,26,628492
chr1,41249497,0,0,16,16,628493
chr1,41249501,0,0,24,24,628494
chr1,41249511,0,0,25,25,628495
chr1,41249513,0,0,26,26,628496
chr1,41249533,0,0,34,34,628497
chr1,41249552,0,0,26,26,628498
chr1,41249555,0.04,1,27,28,628499
chr1,41249563,0,0,18,18,628500
chr1,41249576,0,0,18,18,628501
chr1,41249583,0,0,22,22,628502
chr1,41249586,0,0,19,19,628503
chr1,41249600,0,0,15,15,628504
chr1,41249604,0,0,7,7,628505
chr1,41249608,0.08,1,11,12,628506
chr1,41249612,0,0,14,14,628507
chr1,41249614,0,0,14,14,628508
chr1,41249620,0,0,17,17,628509
chr1,41249625,0,0,18,18,628510
chr1,41249639,0,0,14,14,628511
chr1,41249642,0,0,15,15,628512
chr1,41249646,0,0,20,20,628513
chr1,41249648,0,0,15,15,628514
chr1,41249652,0,0,15,15,628515
chr1,41249657,0.04,1,24,25,628516
chr1,41249662,0,0,15,15,628517
chr1,41249676,0,0,24,24,628518
chr1,41249682,0,0,20,20,628519
chr1,41249691,0,0,18,18,628520
chr1,41249701,0,0,12,12,628521
chr1,41249706,0,0,16,16,628522
chr1,41249710,0,0,10,10,628523
chr1,41249712,0,0,9,9,628524
chr1,41249718,0,0,9,9,628525
chr1,41249723,0,0,15,15,628526
chr1,41249728,0,0,14,14,628527
chr1,41249734,0,0,13,13,628528
chr1,41249741,0.1,1,9,10,628529
chr1,41249744,0,0,7,7,628530
chr1,41249755,0,0,15,15,628531
chr1,41249758,0,0,9,9,628532
chr1,41249761,0,0,13,13,628533
chr1,41249771,0,0,21,21,628534
chr1,41249782,0.04,1,22,23,628535
chr1,41249784,0,0,17,17,628536
chr1,41249787,0,0,20,20,628537
chr1,41249792,0,0,29,29,628538
chr1,41249806,0,0,25,25,628539
chr1,41249810,0,0,33,33,628540
chr1,41249816,0.05,1,18,19,628541
chr1,41249823,0,0,30,30,628542
chr1,41249825,0.1,3,27,30,628543
chr1,41249827,0,0,28,28,628544
chr1,41249839,0,0,26,26,628545
chr1,41249845,0.03,1,31,32,628546
chr1,41249849,0,0,30,30,628547
chr1,41249858,0.03,1,28,29,628548
chr1,41249867,0,0,19,19,628549
chr1,41249872,0,0,22,22,628550
chr1,41249876,0,0,14,14,628551
chr1,41249882,0,0,16,16,628552
chr1,41249890,0,0,23,23,628553
chr1,41249892,0.05,1,18,19,628554
chr1,41249895,0,0,21,21,628555
chr1,41249900,0,0,30,30,628556
chr1,41249923,0.03,1,28,29,628557
chr1,41249926,0,0,36,36,628558
chr1,41249930,0,0,18,18,628559
chr1,41249932,0,0,10,10,628560
chr1,41249947,0,0,30,30,628561
chr1,41249954,0,0,39,39,628562
chr1,41249959,0,0,40,40,628563
chr1,41249966,0,0,35,35,628564
chr1,41249972,0,0,35,35,628565
chr1,41249979,0,0,27,27,628566
chr1,41249986,0,0,42,42,628567
chr1,41249990,0,0,41,41,628568
chr1,41249992,0,0,33,33,628569
chr1,41250000,0,0,32,32,628570
chr1,41250006,0,0,26,26,628571
chr1,41250009,0,0,37,37,628572
chr1,41250032,0,0,44,44,628573
chr1,41250042,0,0,32,32,628574
chr1,41250048,0,0,41,41,628575
chr1,41250050,0,0,42,42,628576
chr1,41250062,0,0,39,39,628577
chr1,41250071,0,0,40,40,628578
chr1,41250089,0,0,32,32,628579
chr1,41250095,0.05,1,21,22,628580
chr1,41250097,0.06,1,16,17,628581
chr1,41250105,0.03,1,30,31,628582
chr1,41250107,0,0,35,35,628583
chr1,41250115,0.03,1,30,31,628584
chr1,41250117,0,0,31,31,628585
chr1,41250133,0,0,36,36,628586
chr1,41250140,0,0,35,35,628587
chr1,41250144,0.15,2,11,13,628588
chr1,41250149,0,0,15,15,628589
chr1,41250160,0.2,4,16,20,628590
chr1,41250186,0,0,35,35,628591
chr1,41250219,0.02,1,58,59,628592
chr1,41250235,0.15,8,47,55,628593
chr1,41250244,0.07,4,56,60,628594
chr1,41250288,0.17,10,50,60,628595
chr1,41250303,0.11,7,54,61,628596
chr1,41250308,0.13,11,71,82,628597
chr1,41250333,0.25,17,50,67,628598
chr1,41250366,0.13,10,66,76,628599
chr1,41250370,0.23,14,48,62,628600
chr1,41250392,0.25,16,49,65,628601
chr1,41250399,0.18,12,55,67,628602
chr1,41250424,0.5,11,11,22,628603
chr1,41250494,0.08,5,56,61,628604
chr1,41250562,0.17,9,43,52,628605
chr1,41250638,0.11,5,39,44,628606
chr1,41250653,0.09,4,42,46,628607
chr1,41250671,0.19,7,29,36,628608
chr1,41250711,0.14,6,38,44,628609
chr1,41250714,0.19,7,30,37,628610
chr1,41250718,0.2,5,20,25,628611
chr1,41250745,0.14,6,38,44,628612
chr1,41250760,0.24,8,25,33,628613
chr1,41250848,0.09,3,31,34,628614
chr1,41250961,0.18,12,55,67,628615
chr1,41250993,0.26,17,48,65,628616
chr1,41251023,0.15,9,51,60,628617
chr1,41251031,0.25,13,39,52,628618
chr1,41251121,0.84,41,8,49,628619
chr1,41251225,0.71,53,22,75,628620
chr1,41251263,0.84,70,13,83,628621
chr1,41251315,0.94,61,4,65,628622
chr1,41251410,0.9,80,9,89,628623
chr1,41251422,0.8,66,17,83,628624
chr1,41251497,0.97,60,2,62,628625
chr1,41251539,0.51,43,41,84,628626
chr1,41251552,0.76,67,21,88,628627
chr1,41251646,0.95,80,4,84,628628
chr1,41251660,0.86,75,12,87,628629
chr1,41251732,0.44,35,45,80,628630
chr1,41251869,0.79,33,9,42,628631
chr1,41252054,0.98,42,1,43,628632
chr1,41252133,0.09,7,70,77,628633
chr1,41252142,0.06,5,81,86,628634
chr1,41252167,0.32,30,65,95,628635
chr1,41252324,0.26,19,53,72,628636
chr1,41252377,0.9,71,8,79,628637
chr1,41252398,0.99,67,1,68,628638
chr1,41252474,0.85,55,10,65,628639
chr1,41252724,0.94,60,4,64,628640
chr1,41252781,0.97,70,2,72,628641
chr1,41252786,0.97,63,2,65,628642
chr1,41252840,1,80,0,80,628643
chr1,41252897,0.94,87,6,93,628644
chr1,41253098,0.93,28,2,30,628645
chr1,41253104,0.78,25,7,32,628646
chr1,41253232,0.69,38,17,55,628647
chr1,41253450,0.55,55,45,100,628648
chr1,41253466,0.96,87,4,91,628649
chr1,41253490,0.79,55,15,70,628650
chr1,41253605,0.96,51,2,53,628651
chr1,41253616,0.96,54,2,56,628652
chr1,41253664,0.88,43,6,49,628653
chr1,41253696,0.27,12,33,45,628654
chr1,41253755,0.78,29,8,37,628655
chr1,41253772,0.7,28,12,40,628656
chr1,41253780,0.74,26,9,35,628657
chr1,41253793,0.84,36,7,43,628658
chr1,41253814,0.92,49,4,53,628659
chr1,41253868,0.95,82,4,86,628660
chr1,41253880,0.62,63,39,102,628661
chr1,41253971,0.81,101,24,125,628662
chr1,41254052,0.82,84,18,102,628663
chr1,41254057,0.58,60,43,103,628664
chr1,41254073,0.71,75,30,105,628665
chr1,41254164,0.76,70,22,92,628666
chr1,41254283,0.94,73,5,78,628667
chr1,41254288,1,74,0,74,628668
chr1,41254311,0.98,65,1,66,628669
chr1,41254387,0.76,48,15,63,628670
chr1,41254404,1,58,0,58,628671
chr1,41254485,0.42,24,33,57,628672
chr1,41254503,0.73,41,15,56,628673
chr1,41254514,0.86,50,8,58,628674
chr1,41254556,0.95,56,3,59,628675
chr1,41254668,0.61,67,43,110,628676
chr1,41254674,0.67,76,38,114,628677
chr1,41254769,0.93,84,6,90,628678
chr1,41254827,0.98,78,2,80,628679
chr1,41254842,0.79,73,19,92,628680
chr1,41254852,0.88,79,11,90,628681
chr1,41254858,0.8,66,16,82,628682
chr1,41254882,0.86,71,12,83,628683
chr1,41255127,0.69,46,21,67,628684
chr1,41255235,0.61,30,19,49,628685
chr1,41255281,0.49,38,39,77,628686
chr1,41255286,0.67,55,27,82,628687
chr1,41255300,0.45,35,43,78,628688
chr1,41255328,0.33,38,77,115,628689
chr1,41255349,0.46,54,64,118,628690
chr1,41255351,0.59,73,50,123,628691
chr1,41255387,0.05,7,121,128,628692
chr1,41255544,0.11,3,25,28,628693
chr1,41255635,0.06,3,44,47,628694
chr1,41255750,0.43,34,45,79,628695
chr1,41255772,0.86,80,13,93,628696
chr1,41255788,0.74,62,22,84,628697
chr1,41255812,0.51,44,43,87,628698
chr1,41255841,0.38,33,55,88,628699
chr1,41255957,0.79,63,17,80,628700
chr1,41255990,0.53,39,35,74,628701
chr1,41256038,0.76,34,11,45,628702
chr1,41256135,0.71,27,11,38,628703
chr1,41256220,0.63,45,27,72,628704
chr1,41256227,0.96,65,3,68,628705
chr1,41256489,0.3,16,37,53,628706
chr1,41256501,0.11,7,55,62,628707
chr1,41256601,0.2,11,43,54,628708
chr1,41256626,0.29,17,41,58,628709
chr1,41256630,0.18,10,46,56,628710
chr1,41256675,0.11,5,41,46,628711
chr1,41256871,0.73,49,18,67,628712
chr1,41256938,0.78,68,19,87,628713
chr1,41257124,0.83,48,10,58,628714
chr1,41257197,0.87,47,7,54,628715
chr1,41257261,0.62,31,19,50,628716
chr1,41257270,0.98,44,1,45,628717
chr1,41257301,0.89,31,4,35,628718
chr1,41257324,0.77,27,8,35,628719
chr1,41257424,0.82,68,15,83,628720
chr1,41257589,0.93,38,3,41,628721
chr1,41257609,0.83,34,7,41,628722
chr1,41257655,0.94,33,2,35,628723
chr1,41257701,0.97,31,1,32,628724
chr1,41257713,0.93,25,2,27,628725
chr1,41257736,0.26,8,23,31,628726
chr1,41257816,0.08,2,24,26,628727
chr1,41257937,0.48,21,23,44,628728
chr1,41257943,0.3,15,35,50,628729
chr1,41257953,0.14,7,43,50,628730
chr1,41258033,0.89,47,6,53,628731
chr1,41258125,0.97,64,2,66,628732
chr1,41258141,0.75,47,16,63,628733
chr1,41258210,0.72,43,17,60,628734
chr1,41258275,0.72,39,15,54,628735
chr1,41258349,0.86,37,6,43,628736
chr1,41258356,0.84,31,6,37,628737
chr1,41258480,0.93,42,3,45,628738
chr1,41258723,0.84,48,9,57,628739
chr1,41258819,0.97,104,3,107,628740
chr1,41258912,0.95,70,4,74,628741
chr1,41258923,0.8,59,15,74,628742
chr1,41258932,0.79,53,14,67,628743
chr1,41259136,0.85,60,11,71,628744
chr1,41259170,0.99,74,1,75,628745
chr1,41259191,0.97,73,2,75,628746
chr1,41259298,0.96,75,3,78,628747
chr1,41259387,0.98,81,2,83,628748
chr1,41259592,0.72,83,32,115,628749
chr1,41259811,0.93,41,3,44,628750
chr1,41259966,0.55,38,31,69,628751
chr1,41260038,0.39,25,39,64,628752
chr1,41260066,0.75,45,15,60,628753
chr1,41260168,0.32,34,72,106,628754
chr1,41260191,0.47,57,65,122,628755
chr1,41260209,0.77,88,27,115,628756
chr1,41260233,0.89,101,12,113,628757
chr1,41260291,0.69,57,26,83,628758
chr1,41260299,0.91,67,7,74,628759
chr1,41260466,0.26,22,62,84,628760
chr1,41260474,0.47,35,40,75,628761
chr1,41260495,0.89,55,7,62,628762
chr1,41260503,0.95,53,3,56,628763
chr1,41260590,0.74,29,10,39,628764
chr1,41260642,0.89,25,3,28,628765
chr1,41260711,0.84,31,6,37,628766
chr1,41260851,0.89,59,7,66,628767
chr1,41261036,0.98,93,2,95,628768
chr1,41261072,0.41,36,51,87,628769
chr1,41261082,0.74,66,23,89,628770
chr1,41261087,0.89,83,10,93,628771
chr1,41261090,0.93,81,6,87,628772
chr1,41261153,0.85,53,9,62,628773
chr1,41261209,0.79,48,13,61,628774
chr1,41261358,0.96,67,3,70,628775
chr1,41261492,0.12,10,76,86,628776
chr1,41261732,0.12,14,99,113,628777
chr1,41261779,0.24,23,73,96,628778
chr1,41261790,0.19,17,74,91,628779
chr1,41261817,0.6,42,28,70,628780
chr1,41261843,0.76,26,8,34,628781
chr1,41261874,0.81,35,8,43,628782
chr1,41261885,0.43,18,24,42,628783
chr1,41261901,0.38,16,26,42,628784
chr1,41262018,0.06,4,65,69,628785
chr1,41262050,0.87,62,9,71,628786
chr1,41262146,0.96,65,3,68,628787
chr1,41262236,0.74,51,18,69,628788
chr1,41262310,0.93,62,5,67,628789
chr1,41262314,0.97,66,2,68,628790
chr1,41262326,0.94,66,4,70,628791
chr1,41262386,0.97,57,2,59,628792
chr1,41262417,0.8,55,14,69,628793
chr1,41262460,0.95,78,4,82,628794
chr1,41262504,0.97,71,2,73,628795
chr1,41262514,0.9,61,7,68,628796
chr1,41262538,0.92,47,4,51,628797
chr1,41262544,0.77,37,11,48,628798
chr1,41262649,0.02,1,42,43,628799
chr1,41262684,0.06,2,34,36,628800
chr1,41262746,0.02,2,90,92,628801
chr1,41262875,0.05,5,86,91,628802
chr1,41263111,0.99,89,1,90,628803
chr1,41263173,0.31,28,62,90,628804
chr1,41263188,0.35,27,51,78,628805
chr1,41263259,0.06,2,31,33,628806
chr1,41263289,0.96,25,1,26,628807
chr1,41263449,0.88,87,12,99,628808
chr1,41263585,0.99,66,1,67,628809
chr1,41263588,0.97,62,2,64,628810
chr1,41263717,0.88,43,6,49,628811
chr1,41264012,0.33,33,67,100,628812
chr1,41264026,0.88,87,12,99,628813
chr1,41264038,0.93,91,7,98,628814
chr1,41264102,0.96,92,4,96,628815
chr1,41264342,0.99,89,1,90,628816
chr1,41264351,0.99,87,1,88,628817
chr1,41264373,0.74,62,22,84,628818
chr1,41264383,0.9,73,8,81,628819
chr1,41264498,0.5,30,30,60,628820
chr1,41264743,0,0,26,26,628821
chr1,41264957,1,71,0,71,628822
chr1,41265173,0.24,11,35,46,628823
chr1,41265265,0.32,27,57,84,628824
chr1,41265292,0.73,62,23,85,628825
chr1,41265379,0.01,1,84,85,628826
chr1,41265403,0.01,1,97,98,628827
chr1,41265471,0.1,9,85,94,628828
chr1,41265626,0.32,19,41,60,628829
chr1,41265829,0.89,68,8,76,628830
chr1,41265859,0.77,63,19,82,628831
chr1,41265948,0.73,60,22,82,628832
chr1,41266297,0.88,80,11,91,628833
chr1,41266439,0.95,78,4,82,628834
chr1,41266519,0.31,33,75,108,628835
chr1,41266551,0.96,77,3,80,628836
chr1,41266645,0.9,91,10,101,628837
chr1,41266652,0.95,100,5,105,628838
chr1,41266685,0.82,89,20,109,628839
chr1,41267098,0.95,74,4,78,628840
chr1,41267143,0.76,70,22,92,628841
chr1,41267274,0.92,65,6,71,628842
chr1,41267302,0.73,43,16,59,628843
chr1,41267494,0.78,77,22,99,628844
chr1,41267564,0.61,46,30,76,628845
chr1,41267616,0.85,35,6,41,628846
chr1,41267772,0.82,62,14,76,628847
chr1,41267789,0.48,38,41,79,628848
chr1,41267814,0.49,33,35,68,628849
chr1,41267835,0.5,34,34,68,628850
chr1,41267866,0.16,10,53,63,628851
chr1,41267920,0.54,21,18,39,628852
chr1,41267926,0.16,7,38,45,628853
chr1,41267931,0.32,11,23,34,628854
chr1,41267934,0.27,9,24,33,628855
chr1,41267940,0.21,7,26,33,628856
chr1,41267943,0.1,3,26,29,628857
chr1,41267945,0.14,4,25,29,628858
chr1,41267958,0.15,3,17,20,628859
chr1,41267970,0,0,32,32,628860
chr1,41267976,0.05,1,21,22,628861
chr1,41267978,0.14,3,19,22,628862
chr1,41267981,0.05,1,21,22,628863
chr1,41267999,0.13,4,26,30,628864
chr1,41268008,0.03,1,32,33,628865
chr1,41268015,0.16,5,26,31,628866
chr1,41268027,0.11,4,31,35,628867
chr1,41268030,0.05,2,38,40,628868
chr1,41268032,0.05,2,41,43,628869
chr1,41268056,0.02,1,48,49,628870
chr1,41268069,0.06,3,44,47,628871
chr1,41268073,0.04,2,48,50,628872
chr1,41268077,0.23,7,24,31,628873
chr1,41268087,0.16,6,32,38,628874
chr1,41268089,0.08,3,35,38,628875
chr1,41268101,0.08,3,35,38,628876
chr1,41268107,0.09,3,31,34,628877
chr1,41268115,0.13,3,20,23,628878
chr1,41268120,0.18,5,23,28,628879
chr1,41268130,0.24,7,22,29,628880
chr1,41268136,0.06,2,34,36,628881
chr1,41268160,0.11,2,16,18,628882
chr1,41268175,0.1,3,26,29,628883
chr1,41268186,0,0,20,20,628884
chr1,41268200,0.04,1,24,25,628885
chr1,41268206,0.05,2,37,39,628886
chr1,41268216,0.03,1,29,30,628887
chr1,41268226,0.03,1,37,38,628888
chr1,41268235,0.18,5,23,28,628889
chr1,41268241,0,0,35,35,628890
chr1,41268244,0.05,2,38,40,628891
chr1,41268249,0.09,3,29,32,628892
chr1,41268273,0.16,5,26,31,628893
chr1,41268283,0.68,13,6,19,628894
chr1,41268307,0.27,6,16,22,628895
chr1,41268311,0.64,9,5,14,628896
chr1,41268325,0.3,3,7,10,628897
chr1,41268366,0.64,16,9,25,628898
chr1,41268376,0.42,13,18,31,628899
chr1,41268387,0.3,12,28,40,628900
chr1,41268395,0.4,16,24,40,628901
chr1,41268397,0.46,18,21,39,628902
chr1,41268425,0.73,47,17,64,628903
chr1,41268493,0.7,69,29,98,628904
chr1,41268525,0.81,92,22,114,628905
chr1,41268710,0.19,12,50,62,628906
chr1,41268885,0.31,17,38,55,628907
chr1,41268891,0.25,13,39,52,628908
chr1,41269045,1,63,0,63,628909
chr1,41269068,0.44,27,34,61,628910
chr1,41269093,0.93,56,4,60,628911
chr1,41269211,0.93,53,4,57,628912
chr1,41269316,1,85,0,85,628913
chr1,41269328,0.96,88,4,92,628914
chr1,41269627,0.7,57,25,82,628915
chr1,41269640,0.77,59,18,77,628916
chr1,41270180,0.94,60,4,64,628917
chr1,41270285,0.81,70,16,86,628918
chr1,41270290,0.71,58,24,82,628919
chr1,41270296,0.93,75,6,81,628920
chr1,41270346,0.59,55,39,94,628921
chr1,41270399,0.97,88,3,91,628922
chr1,41270438,0.77,50,15,65,628923
chr1,41270716,0.7,47,20,67,628924
chr1,41270735,0.86,56,9,65,628925
chr1,41270905,0.16,10,51,61,628926
chr1,41270936,0.16,11,57,68,628927
chr1,41270943,0.34,25,49,74,628928
chr1,41271064,0.87,40,6,46,628929
chr1,41271320,0.83,44,9,53,628930
chr1,41271322,0.4,4,6,10,628931
chr1,41271382,0.3,22,52,74,628932
chr1,41271552,0.85,47,8,55,628933
chr1,41271574,0.98,53,1,54,628934
chr1,41271582,0.61,34,22,56,628935
chr1,41271599,0.98,60,1,61,628936
chr1,41271614,0.81,58,14,72,628937
chr1,41271658,1,59,0,59,628938
chr1,41271670,0.97,58,2,60,628939
chr1,41271714,0.96,25,1,26,628940
chr1,41271734,1,15,0,15,628941
chr1,41271755,0.96,25,1,26,628942
chr1,41271792,0.97,35,1,36,628943
chr1,41271802,1,39,0,39,628944
chr1,41271804,0.98,40,1,41,628945
chr1,41271808,1,41,0,41,628946
chr1,41271829,0.98,55,1,56,628947
chr1,41271860,0.91,53,5,58,628948
chr1,41271870,0.87,58,9,67,628949
chr1,41271889,0.84,65,12,77,628950
chr1,41272139,0.94,74,5,79,628951
chr1,41272166,0.85,62,11,73,628952
chr1,41272253,0.51,47,46,93,628953
chr1,41272448,0.42,30,42,72,628954
chr1,41272521,0.34,23,44,67,628955
chr1,41272533,0.12,9,67,76,628956
chr1,41272602,0.2,19,75,94,628957
chr1,41272629,0.11,11,88,99,628958
chr1,41272647,0.09,7,75,82,628959
chr1,41272663,0.18,10,46,56,628960
chr1,41272677,0.04,3,69,72,628961
chr1,41272764,0.04,2,54,56,628962
chr1,41272803,0.06,4,60,64,628963
chr1,41272873,0.09,4,42,46,628964
chr1,41272962,0.06,3,50,53,628965
chr1,41273063,0.05,3,62,65,628966
chr1,41273092,0.06,3,51,54,628967
chr1,41273101,0.02,1,51,52,628968
chr1,41273104,0.02,1,45,46,628969
chr1,41273130,0.04,2,55,57,628970
chr1,41273162,0.02,1,51,52,628971
chr1,41273218,0.09,4,40,44,628972
chr1,41273362,0.06,6,93,99,628973
chr1,41273374,0.05,5,92,97,628974
chr1,41273543,0.1,7,63,70,628975
chr1,41273545,0.6,41,27,68,628976
chr1,41273663,0.09,6,59,65,628977
chr1,41273854,0.03,2,56,58,628978
chr1,41273865,0.02,1,57,58,628979
chr1,41273955,0.18,6,27,33,628980
chr1,41274090,0.76,26,8,34,628981
chr1,41274138,0.62,24,15,39,628982
chr1,41274276,0.41,20,29,49,628983
chr1,41274440,0.68,49,23,72,628984
chr1,41274547,0.78,69,19,88,628985
chr1,41274744,0.52,57,53,110,628986
chr1,41274795,0.7,69,30,99,628987
chr1,41274816,0.3,30,71,101,628988
chr1,41274883,0.85,68,12,80,628989
chr1,41274910,0.83,68,14,82,628990
chr1,41274924,0.68,60,28,88,628991
chr1,41275030,0.88,64,9,73,628992
chr1,41275137,0.95,73,4,77,628993
chr1,41275219,0.82,69,15,84,628994
chr1,41275236,0.94,83,5,88,628995
chr1,41275252,0.97,98,3,101,628996
chr1,41275321,0.87,96,14,110,628997
chr1,41275464,0.94,66,4,70,628998
chr1,41275474,0.38,30,48,78,628999
chr1,41275502,0.89,33,4,37,629000
chr1,41275565,0.95,20,1,21,629001
chr1,41275593,0.98,41,1,42,629002
chr1,41275597,0.98,42,1,43,629003
chr1,41275629,0.39,22,35,57,629004
chr1,41275644,0.92,57,5,62,629005
chr1,41275668,1,46,0,46,629006
chr1,41275710,0.96,26,1,27,629007
chr1,41275726,1,20,0,20,629008
chr1,41275883,0.92,85,7,92,629009
chr1,41275898,0.92,79,7,86,629010
chr1,41275901,0.94,80,5,85,629011
chr1,41275952,0.96,70,3,73,629012
chr1,41276012,0.97,96,3,99,629013
chr1,41276036,0.94,99,6,105,629014
chr1,41276064,0.92,96,8,104,629015
chr1,41276073,0.97,99,3,102,629016
chr1,41276311,0.81,52,12,64,629017
chr1,41276324,0.79,48,13,61,629018
chr1,41276341,0.87,59,9,68,629019
chr1,41276418,0.66,41,21,62,629020
chr1,41276487,0.93,54,4,58,629021
chr1,41276543,0.48,27,29,56,629022
chr1,41276576,0.94,61,4,65,629023
chr1,41276730,0.2,61,246,307,629024
chr1,41276741,0.23,72,235,307,629025
chr1,41276771,0.19,52,228,280,629026
chr1,41276893,0.99,68,1,69,629027
chr1,41276943,0.91,40,4,44,629028
chr1,41276986,0.96,49,2,51,629029
chr1,41277225,0.98,88,2,90,629030
chr1,41277297,0.77,49,15,64,629031
chr1,41277399,0.95,59,3,62,629032
chr1,41277497,0.94,73,5,78,629033
chr1,41277989,0.97,58,2,60,629034
chr1,41278031,1,74,0,74,629035
chr1,41278053,0.84,68,13,81,629036
chr1,41278223,0.54,49,42,91,629037
chr1,41278225,0.98,89,2,91,629038
chr1,41278230,0.95,87,5,92,629039
chr1,41278357,0.96,93,4,97,629040
chr1,41278361,0.97,99,3,102,629041
chr1,41278390,0.98,80,2,82,629042
chr1,41278578,0.9,83,9,92,629043
chr1,41278822,0.97,69,2,71,629044
chr1,41278865,0.97,63,2,65,629045
chr1,41278894,0.98,61,1,62,629046
chr1,41278905,0.96,71,3,74,629047
chr1,41278908,0.97,70,2,72,629048
chr1,41278926,1,71,0,71,629049
chr1,41278969,0.91,90,9,99,629050
chr1,41279036,0.6,39,26,65,629051
chr1,41279055,0.94,72,5,77,629052
chr1,41279169,0.93,71,5,76,629053
chr1,41279177,0.94,72,5,77,629054
chr1,41279306,0.96,69,3,72,629055
chr1,41279362,0.98,55,1,56,629056
chr1,41279442,0.65,30,16,46,629057
chr1,41279458,0.44,20,25,45,629058
chr1,41279480,0.68,32,15,47,629059
chr1,41279544,0.39,33,51,84,629060
chr1,41279568,0.92,86,7,93,629061
chr1,41279620,0.9,65,7,72,629062
chr1,41279640,0.97,58,2,60,629063
chr1,41279670,0.91,32,3,35,629064
chr1,41279698,1,12,0,12,629065
chr1,41279710,1,8,0,8,629066
chr1,41279714,0.88,7,1,8,629067
chr1,41279811,1,51,0,51,629068
chr1,41279870,0.94,59,4,63,629069
chr1,41279882,0.93,57,4,61,629070
chr1,41279914,1,46,0,46,629071
chr1,41279924,0.72,33,13,46,629072
chr1,41279977,0.96,54,2,56,629073
chr1,41280015,0.97,59,2,61,629074
chr1,41280059,0.89,68,8,76,629075
chr1,41280110,0.96,64,3,67,629076
chr1,41280146,1,61,0,61,629077
chr1,41280232,0.94,84,5,89,629078
chr1,41280324,0.93,52,4,56,629079
chr1,41280488,0.75,92,30,122,629080
chr1,41280533,0.91,124,12,136,629081
chr1,41280651,0.47,37,41,78,629082
chr1,41280679,0.96,69,3,72,629083
chr1,41280695,0.87,66,10,76,629084
chr1,41280740,0.73,61,23,84,629085
chr1,41280774,0.74,70,25,95,629086
chr1,41280804,0.69,68,30,98,629087
chr1,41280826,0.91,74,7,81,629088
chr1,41280836,0.85,64,11,75,629089
chr1,41280843,0.98,65,1,66,629090
chr1,41280860,0.84,53,10,63,629091
chr1,41281018,0.43,37,50,87,629092
chr1,41281044,0.64,44,25,69,629093
chr1,41281084,0.91,61,6,67,629094
chr1,41281156,0.94,72,5,77,629095
chr1,41281175,0.89,63,8,71,629096
chr1,41281238,0.67,32,16,48,629097
chr1,41281245,0.34,16,31,47,629098
chr1,41281282,0.88,57,8,65,629099
chr1,41281300,0.67,48,24,72,629100
chr1,41281327,0.85,74,13,87,629101
chr1,41281439,0.98,79,2,81,629102
chr1,41281484,0.95,79,4,83,629103
chr1,41281569,0.9,113,12,125,629104
chr1,41281594,0.55,64,52,116,629105
chr1,41281659,0.88,83,11,94,629106
chr1,41281696,0.96,72,3,75,629107
chr1,41281712,0.84,67,13,80,629108
chr1,41281745,0.89,48,6,54,629109
chr1,41281751,0.77,49,15,64,629110
chr1,41281766,0.95,57,3,60,629111
chr1,41281792,0.96,64,3,67,629112
chr1,41281804,0.96,68,3,71,629113
chr1,41281815,0.89,62,8,70,629114
chr1,41281857,0.93,40,3,43,629115
chr1,41281902,0.79,26,7,33,629116
chr1,41281979,0.98,43,1,44,629117
chr1,41282016,0.98,58,1,59,629118
chr1,41282041,0.97,65,2,67,629119
chr1,41282145,0.92,84,7,91,629120
chr1,41282173,0.75,58,19,77,629121
chr1,41282187,0.45,33,40,73,629122
chr1,41282311,0.79,42,11,53,629123
chr1,41282419,0.86,78,13,91,629124
chr1,41282434,0.77,71,21,92,629125
chr1,41282523,0.93,77,6,83,629126
chr1,41283009,0.71,74,30,104,629127
chr1,41283044,0.89,77,10,87,629128
chr1,41283091,0.97,60,2,62,629129
chr1,41283138,0.91,52,5,57,629130
chr1,41283185,0.93,52,4,56,629131
chr1,41283201,0.83,24,5,29,629132
chr1,41283440,0.4,31,46,77,629133
chr1,41283604,0.86,65,11,76,629134
chr1,41283622,0.94,67,4,71,629135
chr1,41283667,0.99,69,1,70,629136
chr1,41283688,0.86,64,10,74,629137
chr1,41283694,0.74,58,20,78,629138
chr1,41283726,0.91,60,6,66,629139
chr1,41283771,0.91,61,6,67,629140
chr1,41283773,0.76,52,16,68,629141
chr1,41283841,0.93,87,7,94,629142
chr1,41283850,0.97,91,3,94,629143
chr1,41283859,0.97,86,3,89,629144
chr1,41283874,0.94,76,5,81,629145
chr1,41283878,0.9,77,9,86,629146
chr1,41283889,0.98,81,2,83,629147
chr1,41283892,0.94,73,5,78,629148
chr1,41283905,0.97,67,2,69,629149
chr1,41283911,0.78,53,15,68,629150
chr1,41283926,0.94,51,3,54,629151
chr1,41283932,0.96,52,2,54,629152
chr1,41283961,0.74,32,11,43,629153
chr1,41283972,0.9,38,4,42,629154
chr1,41283974,0.84,32,6,38,629155
chr1,41283979,0.93,38,3,41,629156
chr1,41283983,0.38,18,29,47,629157
chr1,41284016,0.93,39,3,42,629158
chr1,41284034,0.71,34,14,48,629159
chr1,41284054,0.6,25,17,42,629160
chr1,41284067,0.78,29,8,37,629161
chr1,41284117,0.9,37,4,41,629162
chr1,41284123,0.68,34,16,50,629163
chr1,41284129,0.71,35,14,49,629164
chr1,41284133,0.83,44,9,53,629165
chr1,41284135,0.8,45,11,56,629166
chr1,41284157,0.89,47,6,53,629167
chr1,41284160,0.63,30,18,48,629168
chr1,41284166,0.88,58,8,66,629169
chr1,41284184,0.23,18,62,80,629170
chr1,41284190,0.57,47,36,83,629171
chr1,41284198,0.4,38,56,94,629172
chr1,41284205,0.68,63,29,92,629173
chr1,41284211,0.59,47,33,80,629174
chr1,41284214,0.22,30,106,136,629175
chr1,41284216,0.12,17,121,138,629176
chr1,41284238,0.83,117,24,141,629177
chr1,41284243,0.51,76,72,148,629178
chr1,41284247,0.39,77,121,198,629179
chr1,41284249,0.9,89,10,99,629180
chr1,41284254,0.88,98,13,111,629181
chr1,41284263,0.67,97,47,144,629182
chr1,41284281,0.78,101,28,129,629183
chr1,41284290,0.8,95,24,119,629184
chr1,41284299,0.85,94,16,110,629185
chr1,41284302,0.54,57,48,105,629186
chr1,41284304,0.3,32,75,107,629187
chr1,41284307,0.88,82,11,93,629188
chr1,41284340,0.91,80,8,88,629189
chr1,41284342,0.83,68,14,82,629190
chr1,41284368,0.59,56,39,95,629191
chr1,41284370,0.73,69,26,95,629192
chr1,41284372,0.48,47,50,97,629193
chr1,41284374,0.86,83,13,96,629194
chr1,41284382,0.23,24,79,103,629195
chr1,41284388,0.87,69,10,79,629196
chr1,41284401,0.53,49,44,93,629197
chr1,41284410,0.9,74,8,82,629198
chr1,41284419,1,68,0,68,629199
chr1,41284428,0.98,58,1,59,629200
chr1,41284449,0.48,31,33,64,629201
chr1,41284473,0.34,14,27,41,629202
chr1,41284498,1,28,0,28,629203
chr1,41284509,0.53,16,14,30,629204
chr1,41284518,0.85,23,4,27,629205
chr1,41284545,0.94,17,1,18,629206
chr1,41284559,0.05,1,21,22,629207
chr1,41284564,0.08,2,23,25,629208
chr1,41284576,0.5,6,6,12,629209
chr1,41284582,0.12,3,22,25,629210
chr1,41284590,0.35,6,11,17,629211
chr1,41284639,0.79,31,8,39,629212
chr1,41284688,0.97,30,1,31,629213
chr1,41284738,0.9,27,3,30,629214
chr1,41284753,0.9,27,3,30,629215
chr1,41284798,1,15,0,15,629216
chr1,41284828,0.36,4,7,11,629217
chr1,41284848,0.85,17,3,20,629218
chr1,41284854,0.67,14,7,21,629219
chr1,41284856,0.52,12,11,23,629220
chr1,41284863,0.86,18,3,21,629221
chr1,41284874,0.7,14,6,20,629222
chr1,41284877,0.9,19,2,21,629223
chr1,41284905,0.84,16,3,19,629224
chr1,41284919,0.88,22,3,25,629225
chr1,41284948,0.85,17,3,20,629226
chr1,41284985,1,33,0,33,629227
chr1,41284995,0.9,38,4,42,629228
chr1,41284997,1,42,0,42,629229
chr1,41285005,0.98,46,1,47,629230
chr1,41285014,0.95,53,3,56,629231
chr1,41285030,0.98,60,1,61,629232
chr1,41285042,0.65,41,22,63,629233
chr1,41285063,0.97,67,2,69,629234
chr1,41285096,0.98,61,1,62,629235
chr1,41285105,0.97,63,2,65,629236
chr1,41285120,0.94,60,4,64,629237
chr1,41285123,0.86,50,8,58,629238
chr1,41285128,0.97,66,2,68,629239
chr1,41285143,0.97,58,2,60,629240
chr1,41285148,0.98,61,1,62,629241
chr1,41285203,0.86,51,8,59,629242
chr1,41285217,0.97,57,2,59,629243
chr1,41285241,0.98,49,1,50,629244
chr1,41285348,0.97,35,1,36,629245
chr1,41285432,0.94,51,3,54,629246
chr1,41285496,0.96,72,3,75,629247
chr1,41285509,0.95,79,4,83,629248
chr1,41285564,0.94,110,7,117,629249
chr1,41285584,0.53,59,53,112,629250
chr1,41285621,0.96,82,3,85,629251
chr1,41285851,0.89,48,6,54,629252
chr1,41285882,0.84,62,12,74,629253
chr1,41285896,0.79,61,16,77,629254
chr1,41285903,0.84,70,13,83,629255
chr1,41285913,0.76,62,20,82,629256
chr1,41285945,0.43,36,48,84,629257
chr1,41285970,0.14,11,65,76,629258
chr1,41286215,0.63,35,21,56,629259
chr1,41286502,0.2,9,37,46,629260
chr1,41286743,0.04,2,52,54,629261
chr1,41286784,0.06,4,59,63,629262
chr1,41286852,0.12,8,61,69,629263
chr1,41287053,0.24,4,13,17,629264
chr1,41287151,0.13,4,28,32,629265
chr1,41287216,0.11,5,42,47,629266
chr1,41287407,0.16,12,63,75,629267
chr1,41287629,0.61,36,23,59,629268
chr1,41287797,0.26,24,67,91,629269
chr1,41287806,0.18,15,69,84,629270
chr1,41287968,0.78,21,6,27,629271
chr1,41287995,1,40,0,40,629272
chr1,41288009,0.75,30,10,40,629273
chr1,41288019,0.8,33,8,41,629274
chr1,41288322,0.71,52,21,73,629275
chr1,41288394,0.54,47,40,87,629276
chr1,41288592,0.78,72,20,92,629277
chr1,41288658,0.66,49,25,74,629278
chr1,41288717,0.94,59,4,63,629279
chr1,41288725,0.83,53,11,64,629280
chr1,41288733,0.98,56,1,57,629281
chr1,41288774,0.96,45,2,47,629282
chr1,41288782,1,48,0,48,629283
chr1,41288826,0.98,47,1,48,629284
chr1,41288828,0.98,45,1,46,629285
chr1,41288838,0.87,40,6,46,629286
chr1,41288867,0.87,34,5,39,629287
chr1,41288918,1,42,0,42,629288
chr1,41288968,0.77,47,14,61,629289
chr1,41289046,0.83,55,11,66,629290
chr1,41289301,0.78,32,9,41,629291
chr1,41289307,0.67,24,12,36,629292
chr1,41289385,1,29,0,29,629293
chr1,41289476,0.47,28,32,60,629294
chr1,41289481,0.25,15,44,59,629295
chr1,41289525,0.31,22,48,70,629296
chr1,41289641,0.45,26,32,58,629297
chr1,41289793,0.48,16,17,33,629298
chr1,41289800,0.88,28,4,32,629299
chr1,41289806,0.9,28,3,31,629300
chr1,41289821,0.65,15,8,23,629301
chr1,41289836,0.88,22,3,25,629302
chr1,41289839,1,23,0,23,629303
chr1,41289843,0.94,17,1,18,629304
chr1,41289846,0.85,17,3,20,629305
chr1,41289853,0.67,14,7,21,629306
chr1,41289856,0.9,18,2,20,629307
chr1,41289869,0.91,21,2,23,629308
chr1,41289876,0.95,21,1,22,629309
chr1,41289880,1,27,0,27,629310
chr1,41289896,0.92,23,2,25,629311
chr1,41289900,1,25,0,25,629312
chr1,41289941,0.7,30,13,43,629313
chr1,41290026,0.43,18,24,42,629314
chr1,41290062,0.96,51,2,53,629315
chr1,41290195,0.58,23,17,40,629316
chr1,41290232,0.58,11,8,19,629317
chr1,41290272,0.34,12,23,35,629318
chr1,41290316,0.18,13,60,73,629319
chr1,41290329,0.03,2,77,79,629320
chr1,41290373,0.13,9,61,70,629321
chr1,41290409,0.13,6,39,45,629322
chr1,41290422,0.06,4,61,65,629323
chr1,41290474,0.05,4,72,76,629324
chr1,41290590,0.3,12,28,40,629325
chr1,41290691,0,0,73,73,629326
chr1,41290737,0.05,3,60,63,629327
chr1,41290824,0.03,2,57,59,629328
chr1,41290955,0.79,60,16,76,629329
chr1,41290960,0.72,65,25,90,629330
chr1,41290983,0.71,55,23,78,629331
chr1,41290996,0.57,50,38,88,629332
chr1,41291009,0.08,9,99,108,629333
chr1,41291064,0.88,88,12,100,629334
chr1,41291072,0.22,23,82,105,629335
chr1,41291274,0.13,2,13,15,629336
chr1,41291337,0.11,4,34,38,629337
chr1,41291386,0.3,17,40,57,629338
chr1,41291539,0.41,26,37,63,629339
chr1,41291619,0.16,11,57,68,629340
chr1,41291648,0.78,42,12,54,629341
chr1,41291762,0.14,7,43,50,629342
chr1,41291769,0.14,7,42,49,629343
chr1,41291784,0.6,29,19,48,629344
chr1,41291836,0.07,4,50,54,629345
chr1,41292158,0.67,32,16,48,629346
chr1,41292218,1,29,0,29,629347
chr1,41292225,1,16,0,16,629348
chr1,41292272,0.83,44,9,53,629349
chr1,41292286,0.68,39,18,57,629350
chr1,41292329,0.43,26,35,61,629351
chr1,41292341,0.85,50,9,59,629352
chr1,41292349,0.95,55,3,58,629353
chr1,41292363,0.76,38,12,50,629354
chr1,41292376,0.81,30,7,37,629355
chr1,41292471,0.96,48,2,50,629356
chr1,41292478,0.97,56,2,58,629357
chr1,41292507,0.98,62,1,63,629358
chr1,41292567,0.85,66,12,78,629359
chr1,41292659,0.92,60,5,65,629360
chr1,41292835,0.94,116,8,124,629361
chr1,41292900,0.65,86,46,132,629362
chr1,41292918,0.73,90,33,123,629363
chr1,41292924,0.77,92,28,120,629364
chr1,41293000,0.68,67,31,98,629365
chr1,41293077,0.82,72,16,88,629366
chr1,41293165,0.95,72,4,76,629367
chr1,41293304,0.89,50,6,56,629368
chr1,41293379,0.8,37,9,46,629369
chr1,41293418,0.51,31,30,61,629370
chr1,41293633,0.86,80,13,93,629371
chr1,41293663,0.9,75,8,83,629372
chr1,41293736,1,59,0,59,629373
chr1,41293787,0.95,62,3,65,629374
chr1,41293911,1,26,0,26,629375
chr1,41294034,0.82,53,12,65,629376
chr1,41294289,0.33,24,49,73,629377
chr1,41294318,0.94,50,3,53,629378
chr1,41294381,0.2,12,48,60,629379
chr1,41294683,0.8,65,16,81,629380
chr1,41294774,0.74,50,18,68,629381
chr1,41294799,0.9,55,6,61,629382
chr1,41294906,0.45,19,23,42,629383
chr1,41294911,0.59,26,18,44,629384
chr1,41295022,0.94,31,2,33,629385
chr1,41295203,1,52,0,52,629386
chr1,41295288,0.99,67,1,68,629387
chr1,41295349,0.45,79,96,175,629388
chr1,41295453,0.92,84,7,91,629389
chr1,41295468,0.94,94,6,100,629390
chr1,41295505,0.98,80,2,82,629391
chr1,41295511,0.64,56,31,87,629392
chr1,41295669,0.65,72,38,110,629393
chr1,41295680,0.5,52,52,104,629394
chr1,41295699,0.96,90,4,94,629395
chr1,41295729,0.98,99,2,101,629396
chr1,41295735,0.94,93,6,99,629397
chr1,41295741,0.96,99,4,103,629398
chr1,41295779,0.94,90,6,96,629399
chr1,41295818,0.85,72,13,85,629400
chr1,41295982,0.96,88,4,92,629401
chr1,41296004,0.98,93,2,95,629402
chr1,41296011,0.99,88,1,89,629403
chr1,41296087,0.93,57,4,61,629404
chr1,41296126,0.96,43,2,45,629405
chr1,41296175,0.98,39,1,40,629406
chr1,41296217,0.95,41,2,43,629407
chr1,41296252,1,50,0,50,629408
chr1,41296254,0.98,48,1,49,629409
chr1,41296272,0.87,47,7,54,629410
chr1,41296323,0.94,47,3,50,629411
chr1,41296347,0.88,42,6,48,629412
chr1,41296381,0.97,34,1,35,629413
chr1,41296411,0.97,56,2,58,629414
chr1,41296513,0.88,42,6,48,629415
chr1,41296559,0.84,26,5,31,629416
chr1,41296569,0.91,32,3,35,629417
chr1,41296635,0.86,31,5,36,629418
chr1,41296642,0.86,32,5,37,629419
chr1,41296760,0.35,26,48,74,629420
chr1,41296778,0.41,28,40,68,629421
chr1,41296784,0.42,27,38,65,629422
chr1,41296802,0.41,26,37,63,629423
chr1,41296805,0.43,27,36,63,629424
chr1,41296809,0.29,18,44,62,629425
chr1,41296864,0.95,75,4,79,629426
chr1,41296925,0.94,85,5,90,629427
chr1,41296931,0.98,83,2,85,629428
chr1,41296937,0.94,80,5,85,629429
chr1,41296961,0.91,77,8,85,629430
chr1,41296986,0.92,71,6,77,629431
chr1,41297000,0.96,81,3,84,629432
chr1,41297004,0.79,67,18,85,629433
chr1,41297011,0.89,71,9,80,629434
chr1,41297029,0.99,79,1,80,629435
chr1,41297066,0.96,70,3,73,629436
chr1,41297068,0.97,72,2,74,629437
chr1,41297093,0.87,68,10,78,629438
chr1,41297182,0.86,63,10,73,629439
chr1,41297228,0.96,53,2,55,629440
chr1,41297273,0.97,71,2,73,629441
chr1,41297453,0.97,61,2,63,629442
chr1,41297570,0.75,57,19,76,629443
chr1,41298110,0.98,78,2,80,629444
chr1,41298159,0.97,75,2,77,629445
chr1,41298482,0.8,71,18,89,629446
chr1,41298572,0,0,32,32,629447
chr1,41298625,0.74,37,13,50,629448
chr1,41298737,0.99,68,1,69,629449
chr1,41298744,0.96,67,3,70,629450
chr1,41298775,0.97,72,2,74,629451
chr1,41298805,0.98,65,1,66,629452
chr1,41298819,0.93,69,5,74,629453
chr1,41298851,0.99,77,1,78,629454
chr1,41298909,0.84,36,7,43,629455
chr1,41298942,0.91,42,4,46,629456
chr1,41299197,0.98,60,1,61,629457
chr1,41299238,0.97,62,2,64,629458
chr1,41299394,0.94,92,6,98,629459
chr1,41299466,0.91,101,10,111,629460
chr1,41299629,0.92,73,6,79,629461
chr1,41299861,0.85,61,11,72,629462
chr1,41300067,0.87,79,12,91,629463
chr1,41300138,0.93,88,7,95,629464
chr1,41300187,0.91,74,7,81,629465
chr1,41300196,0.96,69,3,72,629466
chr1,41300214,0.96,64,3,67,629467
chr1,41300375,0.79,60,16,76,629468
chr1,41300431,0.86,66,11,77,629469
chr1,41300501,0.96,53,2,55,629470
chr1,41300685,0.9,63,7,70,629471
chr1,41300689,0.85,61,11,72,629472
chr1,41300693,0.64,46,26,72,629473
chr1,41300696,0.73,53,20,73,629474
chr1,41300705,0.83,59,12,71,629475
chr1,41300748,0.91,77,8,85,629476
chr1,41300769,0.69,57,26,83,629477
chr1,41300781,0.8,66,17,83,629478
chr1,41300814,0.92,58,5,63,629479
chr1,41300850,0.91,60,6,66,629480
chr1,41300942,0.77,48,14,62,629481
chr1,41301276,0.88,103,14,117,629482
chr1,41301333,0.95,141,7,148,629483
chr1,41301421,0.83,115,23,138,629484
chr1,41301617,0.72,68,26,94,629485
chr1,41301659,0.6,66,44,110,629486
chr1,41301710,0.79,93,24,117,629487
chr1,41301777,0.95,101,5,106,629488
chr1,41301829,0.91,99,10,109,629489
chr1,41301839,0.95,102,5,107,629490
chr1,41302002,0.61,76,48,124,629491
chr1,41302050,0.82,103,23,126,629492
chr1,41302073,0.88,105,15,120,629493
chr1,41302182,0.85,97,17,114,629494
chr1,41302697,0.8,32,8,40,629495
chr1,41302798,0.75,38,13,51,629496
chr1,41302831,0.97,77,2,79,629497
chr1,41302844,0.96,93,4,97,629498
chr1,41302853,0.95,99,5,104,629499
chr1,41302983,1,53,0,53,629500
chr1,41303048,1,58,0,58,629501
chr1,41303056,0.98,58,1,59,629502
chr1,41303100,0.74,53,19,72,629503
chr1,41303122,0.81,58,14,72,629504
chr1,41303243,0.93,57,4,61,629505
chr1,41303296,0.9,60,7,67,629506
chr1,41303299,0.96,65,3,68,629507
chr1,41303307,0.79,62,16,78,629508
chr1,41303356,0.8,63,16,79,629509
chr1,41303364,0.72,57,22,79,629510
chr1,41303380,0.71,55,22,77,629511
chr1,41303391,0.99,67,1,68,629512
chr1,41303406,0.97,67,2,69,629513
chr1,41303409,0.91,60,6,66,629514
chr1,41303411,0.94,61,4,65,629515
chr1,41303443,0.98,51,1,52,629516
chr1,41303445,0.77,37,11,48,629517
chr1,41303487,1,35,0,35,629518
chr1,41303519,0.95,18,1,19,629519
chr1,41303521,0.62,13,8,21,629520
chr1,41303540,0.95,21,1,22,629521
chr1,41303570,0.57,12,9,21,629522
chr1,41303595,0.83,20,4,24,629523
chr1,41303599,0.7,21,9,30,629524
chr1,41303608,1,28,0,28,629525
chr1,41303614,0.88,23,3,26,629526
chr1,41303617,0.86,24,4,28,629527
chr1,41303638,0.5,11,11,22,629528
chr1,41303658,0.47,7,8,15,629529
chr1,41303679,0.67,20,10,30,629530
chr1,41303732,0.95,62,3,65,629531
chr1,41303746,0.74,48,17,65,629532
chr1,41303756,0.73,46,17,63,629533
chr1,41303758,0.97,68,2,70,629534
chr1,41303772,0.67,51,25,76,629535
chr1,41303793,0.82,62,14,76,629536
chr1,41303818,0.94,67,4,71,629537
chr1,41303825,0.97,75,2,77,629538
chr1,41303853,0.44,34,43,77,629539
chr1,41303880,0.69,36,16,52,629540
chr1,41303892,0.22,16,56,72,629541
chr1,41303908,0.29,20,50,70,629542
chr1,41303922,0.65,24,13,37,629543
chr1,41303928,0.51,28,27,55,629544
chr1,41303932,0.46,26,30,56,629545
chr1,41303934,0.49,28,29,57,629546
chr1,41303943,0.37,25,43,68,629547
chr1,41303969,0.99,79,1,80,629548
chr1,41303974,0.68,52,25,77,629549
chr1,41303994,0.61,56,36,92,629550
chr1,41304029,0.96,89,4,93,629551
chr1,41304031,0.93,85,6,91,629552
chr1,41304040,0.99,86,1,87,629553
chr1,41304053,0.73,65,24,89,629554
chr1,41304066,1,87,0,87,629555
chr1,41304069,0.72,65,25,90,629556
chr1,41304080,0.94,82,5,87,629557
chr1,41304087,0.49,34,36,70,629558
chr1,41304093,0.79,73,19,92,629559
chr1,41304105,0.84,77,15,92,629560
chr1,41304129,0.3,32,74,106,629561
chr1,41304141,0.86,87,14,101,629562
chr1,41304147,0.98,105,2,107,629563
chr1,41304155,0.97,94,3,97,629564
chr1,41304169,0.99,97,1,98,629565
chr1,41304173,0.93,92,7,99,629566
chr1,41304223,0.79,55,15,70,629567
chr1,41304233,0.68,43,20,63,629568
chr1,41304235,0.83,57,12,69,629569
chr1,41304243,1,62,0,62,629570
chr1,41304248,0.94,63,4,67,629571
chr1,41304268,0.92,60,5,65,629572
chr1,41304279,0.86,50,8,58,629573
chr1,41304301,0.9,54,6,60,629574
chr1,41304318,0.71,46,19,65,629575
chr1,41304343,0.99,74,1,75,629576
chr1,41304367,0.92,58,5,63,629577
chr1,41304389,0.97,69,2,71,629578
chr1,41304404,0.94,66,4,70,629579
chr1,41304424,0.92,55,5,60,629580
chr1,41304428,0.88,51,7,58,629581
chr1,41304433,0.81,48,11,59,629582
chr1,41304435,0.87,47,7,54,629583
chr1,41304509,0.9,43,5,48,629584
chr1,41304521,0.98,45,1,46,629585
chr1,41304525,0.95,40,2,42,629586
chr1,41304589,0.83,38,8,46,629587
chr1,41304612,0.98,48,1,49,629588
chr1,41304623,0.98,53,1,54,629589
chr1,41305049,0.7,77,33,110,629590
chr1,41305055,0.7,77,33,110,629591
chr1,41305059,0.77,79,24,103,629592
chr1,41305126,0.82,87,19,106,629593
chr1,41305165,0.93,81,6,87,629594
chr1,41305215,0.83,35,7,42,629595
chr1,41305276,0.89,48,6,54,629596
chr1,41305310,1,49,0,49,629597
chr1,41305389,1,48,0,48,629598
chr1,41305395,0.82,46,10,56,629599
chr1,41305415,0.74,51,18,69,629600
chr1,41305532,0.95,69,4,73,629601
chr1,41305534,0.99,74,1,75,629602
chr1,41305540,0.96,70,3,73,629603
chr1,41305601,1,70,0,70,629604
chr1,41305614,0.89,65,8,73,629605
chr1,41305745,0.91,43,4,47,629606
chr1,41305753,0.96,50,2,52,629607
chr1,41305767,0.8,45,11,56,629608
chr1,41305786,0.98,50,1,51,629609
chr1,41305866,0.93,62,5,67,629610
chr1,41306028,0.95,57,3,60,629611
chr1,41306032,0.88,56,8,64,629612
chr1,41306040,0.97,69,2,71,629613
chr1,41306051,0.87,62,9,71,629614
chr1,41306058,0.9,61,7,68,629615
chr1,41306206,0.82,45,10,55,629616
chr1,41306347,0.04,3,80,83,629617
chr1,41306673,0.94,82,5,87,629618
chr1,41306686,0.87,79,12,91,629619
chr1,41306791,0.93,53,4,57,629620
chr1,41306916,0.93,65,5,70,629621
chr1,41307009,0.92,72,6,78,629622
chr1,41307066,0.96,89,4,93,629623
chr1,41307076,0.94,99,6,105,629624
chr1,41307165,0.61,70,44,114,629625
chr1,41307172,0.59,66,46,112,629626
chr1,41307399,0.98,41,1,42,629627
chr1,41307407,0.95,37,2,39,629628
chr1,41307413,0.83,34,7,41,629629
chr1,41307561,0.86,31,5,36,629630
chr1,41307587,0.88,49,7,56,629631
chr1,41307592,0.92,49,4,53,629632
chr1,41307632,0.9,54,6,60,629633
chr1,41307763,0.89,42,5,47,629634
chr1,41307807,0.93,56,4,60,629635
chr1,41307817,0.95,62,3,65,629636
chr1,41307888,0.91,69,7,76,629637
chr1,41308031,0.99,86,1,87,629638
chr1,41308035,0.93,81,6,87,629639
chr1,41308376,0.94,108,7,115,629640
chr1,41308725,0.95,69,4,73,629641
chr1,41308728,1,72,0,72,629642
chr1,41308857,0.92,101,9,110,629643
chr1,41308978,0.95,62,3,65,629644
chr1,41308985,0.98,61,1,62,629645
chr1,41309062,1,60,0,60,629646
chr1,41309122,0.92,72,6,78,629647
chr1,41309518,0.74,73,25,98,629648
chr1,41309540,0.78,80,23,103,629649
chr1,41309785,0.91,51,5,56,629650
chr1,41309807,0.95,58,3,61,629651
chr1,41309859,0.98,48,1,49,629652
chr1,41309908,0.77,54,16,70,629653
chr1,41310064,0.87,79,12,91,629654
chr1,41310196,1,63,0,63,629655
chr1,41310299,0.98,59,1,60,629656
chr1,41310303,0.93,54,4,58,629657
chr1,41310354,0.58,33,24,57,629658
chr1,41310644,0.63,54,32,86,629659
chr1,41310683,0.75,57,19,76,629660
chr1,41310843,0.24,20,64,84,629661
chr1,41310848,0.82,69,15,84,629662
chr1,41310977,0.31,26,57,83,629663
chr1,41311012,0.19,17,73,90,629664
chr1,41311078,0.4,40,60,100,629665
chr1,41311095,0.61,64,41,105,629666
chr1,41311506,0.98,59,1,60,629667
chr1,41311793,0.97,75,2,77,629668
chr1,41312061,0.9,63,7,70,629669
chr1,41312138,0.55,48,39,87,629670
chr1,41312288,0.99,76,1,77,629671
chr1,41312493,0.99,86,1,87,629672
chr1,41312533,0.87,88,13,101,629673
chr1,41312813,0.75,56,19,75,629674
chr1,41312927,0.74,78,28,106,629675
chr1,41313037,0.99,76,1,77,629676
chr1,41313092,0.81,55,13,68,629677
chr1,41313358,0.95,96,5,101,629678
chr1,41313396,0.97,114,3,117,629679
chr1,41313432,0.83,107,22,129,629680
chr1,41313441,0.9,113,12,125,629681
chr1,41313449,0.79,106,28,134,629682
chr1,41313471,0.9,121,13,134,629683
chr1,41313640,0.87,60,9,69,629684
chr1,41313928,0.84,36,7,43,629685
chr1,41313943,0.41,19,27,46,629686
chr1,41313971,1,40,0,40,629687
chr1,41314081,0.36,30,53,83,629688
chr1,41314174,0.99,76,1,77,629689
chr1,41314176,0.95,73,4,77,629690
chr1,41314291,0.17,12,59,71,629691
chr1,41314383,0.01,1,100,101,629692
chr1,41314394,0,0,90,90,629693
chr1,41314752,0.09,8,83,91,629694
chr1,41314778,0.24,18,57,75,629695
chr1,41314826,0.48,22,24,46,629696
chr1,41314987,0.58,29,21,50,629697
chr1,41314996,0.34,16,31,47,629698
chr1,41315101,0.51,28,27,55,629699
chr1,41315148,0.73,43,16,59,629700
chr1,41315180,0.13,8,52,60,629701
chr1,41315352,0.64,35,20,55,629702
chr1,41315434,0.62,32,20,52,629703
chr1,41315472,0.92,57,5,62,629704
chr1,41315513,0.15,15,84,99,629705
chr1,41315522,0.24,19,61,80,629706
chr1,41315582,0,0,72,72,629707
chr1,41315745,0,0,70,70,629708
chr1,41315810,0,0,76,76,629709
chr1,41315819,0.01,1,78,79,629710
chr1,41315863,0,0,79,79,629711
chr1,41315900,0.11,6,51,57,629712
chr1,41315903,0.02,1,64,65,629713
chr1,41315912,0.06,4,60,64,629714
chr1,41315961,0.3,20,47,67,629715
chr1,41316309,0.9,82,9,91,629716
chr1,41316644,0.91,83,8,91,629717
chr1,41316783,0.74,40,14,54,629718
chr1,41316832,0.95,39,2,41,629719
chr1,41316988,0.85,89,16,105,629720
chr1,41317008,0.99,96,1,97,629721
chr1,41317078,0.97,92,3,95,629722
chr1,41317172,0.84,80,15,95,629723
chr1,41317182,0.86,78,13,91,629724
chr1,41317270,0.94,88,6,94,629725
chr1,41317288,1,99,0,99,629726
chr1,41317320,0.86,94,15,109,629727
chr1,41317366,0.9,108,12,120,629728
chr1,41317412,0.79,79,21,100,629729
chr1,41317662,0.93,52,4,56,629730
chr1,41317694,1,80,0,80,629731
chr1,41317700,0.93,74,6,80,629732
chr1,41317724,0.95,89,5,94,629733
chr1,41317741,0.92,95,8,103,629734
chr1,41317756,0.97,96,3,99,629735
chr1,41317772,0.99,91,1,92,629736
chr1,41317785,0.99,88,1,89,629737
chr1,41317844,0.96,69,3,72,629738
chr1,41317876,0.94,62,4,66,629739
chr1,41317904,0.95,69,4,73,629740
chr1,41318124,0.98,79,2,81,629741
chr1,41318138,0.92,84,7,91,629742
chr1,41318306,0.97,65,2,67,629743
chr1,41318373,0.67,70,34,104,629744
chr1,41318431,0.87,81,12,93,629745
chr1,41318498,0.96,93,4,97,629746
chr1,41318574,1,102,0,102,629747
chr1,41318633,0.93,84,6,90,629748
chr1,41318638,0.96,78,3,81,629749
chr1,41318642,0.97,86,3,89,629750
chr1,41318829,0.97,85,3,88,629751
chr1,41318904,0.93,99,7,106,629752
chr1,41318956,0.98,122,2,124,629753
chr1,41318974,0.96,123,5,128,629754
chr1,41319072,0.84,53,10,63,629755
chr1,41319093,0.59,39,27,66,629756
chr1,41319232,0.07,5,71,76,629757
chr1,41319245,0.05,4,80,84,629758
chr1,41319333,0.04,2,44,46,629759
chr1,41319361,0.13,6,41,47,629760
chr1,41319378,0.12,6,44,50,629761
chr1,41319395,0.09,6,58,64,629762
chr1,41319533,0.11,14,109,123,629763
chr1,41319559,0.08,9,109,118,629764
chr1,41319747,0.16,13,67,80,629765
chr1,41319773,0.07,6,82,88,629766
chr1,41319823,0.06,5,80,85,629767
chr1,41319839,0.32,31,66,97,629768
chr1,41319857,0.22,24,83,107,629769
chr1,41319883,0.88,84,12,96,629770
chr1,41319928,0.7,65,28,93,629771
chr1,41319955,0.42,33,46,79,629772
chr1,41319983,0.79,45,12,57,629773
chr1,41319991,0.91,59,6,65,629774
chr1,41319997,0.93,57,4,61,629775
chr1,41320024,0.92,58,5,63,629776
chr1,41320067,0.91,39,4,43,629777
chr1,41320101,0.93,28,2,30,629778
chr1,41320132,0.98,43,1,44,629779
chr1,41320138,0.96,45,2,47,629780
chr1,41320140,0.9,46,5,51,629781
chr1,41320174,0.92,61,5,66,629782
chr1,41320196,0.91,49,5,54,629783
chr1,41320216,0.98,51,1,52,629784
chr1,41320220,0.94,51,3,54,629785
chr1,41320260,0.96,44,2,46,629786
chr1,41320273,0.96,52,2,54,629787
chr1,41320291,0.95,52,3,55,629788
chr1,41320361,0.98,79,2,81,629789
chr1,41320398,0.98,88,2,90,629790
chr1,41320415,0.93,80,6,86,629791
chr1,41320438,1,75,0,75,629792
chr1,41320507,0.99,80,1,81,629793
chr1,41320568,0.47,41,47,88,629794
chr1,41320620,0.77,80,24,104,629795
chr1,41320665,0.96,108,5,113,629796
chr1,41320752,0.92,107,9,116,629797
chr1,41320774,0.9,103,11,114,629798
chr1,41320881,0.27,22,60,82,629799
chr1,41320993,0.37,67,116,183,629800
chr1,41321052,0.25,45,135,180,629801
chr1,41321070,0.49,53,55,108,629802
chr1,41321102,0.45,48,58,106,629803
chr1,41321142,0.98,52,1,53,629804
chr1,41321287,0.87,71,11,82,629805
chr1,41321372,0.89,76,9,85,629806
chr1,41321413,0.73,73,27,100,629807
chr1,41321515,0.98,46,1,47,629808
chr1,41321520,0.98,44,1,45,629809
chr1,41321530,0.9,38,4,42,629810
chr1,41321611,0.97,35,1,36,629811
chr1,41321659,0.93,38,3,41,629812
chr1,41321708,0.98,57,1,58,629813
chr1,41321727,0.99,66,1,67,629814
chr1,41321883,0.79,84,23,107,629815
chr1,41321891,0.48,51,56,107,629816
chr1,41321941,0.77,90,27,117,629817
chr1,41322438,1,51,0,51,629818
chr1,41322487,0.95,57,3,60,629819
chr1,41322510,0.92,56,5,61,629820
chr1,41322607,0.78,88,25,113,629821
chr1,41322704,0.98,115,2,117,629822
chr1,41322746,0.95,121,6,127,629823
chr1,41322764,0.97,114,3,117,629824
chr1,41322791,0.97,110,3,113,629825
chr1,41322830,0.99,105,1,106,629826
chr1,41323069,0.97,77,2,79,629827
chr1,41323113,0.89,75,9,84,629828
chr1,41323139,0.93,76,6,82,629829
chr1,41323247,0.91,73,7,80,629830
chr1,41323309,0.98,78,2,80,629831
chr1,41323339,0.98,53,1,54,629832
chr1,41323341,1,52,0,52,629833
chr1,41323363,0.97,28,1,29,629834
chr1,41323474,0.94,46,3,49,629835
chr1,41323651,0.93,40,3,43,629836
chr1,41324338,0.99,77,1,78,629837
chr1,41324357,0.92,69,6,75,629838
chr1,41324365,0.85,58,10,68,629839
chr1,41324394,0.98,52,1,53,629840
chr1,41324470,0.89,33,4,37,629841
chr1,41324504,0.96,27,1,28,629842
chr1,41324697,1,39,0,39,629843
chr1,41324740,0.8,33,8,41,629844
chr1,41325000,0.94,32,2,34,629845
chr1,41325005,0.97,30,1,31,629846
chr1,41325346,0.21,14,53,67,629847
chr1,41325351,0.21,15,56,71,629848
chr1,41325362,0.18,13,60,73,629849
chr1,41325466,0.15,12,70,82,629850
chr1,41325557,0.11,9,72,81,629851
chr1,41325566,0.16,13,66,79,629852
chr1,41325578,0.12,9,68,77,629853
chr1,41325628,0.1,9,81,90,629854
chr1,41325705,0.09,8,82,90,629855
chr1,41325718,0.14,12,73,85,629856
chr1,41325792,0.15,11,61,72,629857
chr1,41325800,0.06,5,80,85,629858
chr1,41325862,0.18,8,36,44,629859
chr1,41325899,0.1,5,45,50,629860
chr1,41325933,0.35,15,28,43,629861
chr1,41325955,0.16,5,27,32,629862
chr1,41325975,0.96,24,1,25,629863
chr1,41325977,0.84,21,4,25,629864
chr1,41326019,0.94,44,3,47,629865
chr1,41326050,0.93,56,4,60,629866
chr1,41326064,0.94,62,4,66,629867
chr1,41326075,0.94,67,4,71,629868
chr1,41326080,0.89,63,8,71,629869
chr1,41326268,0.55,77,63,140,629870
chr1,41326317,0.95,106,5,111,629871
chr1,41326335,0.84,74,14,88,629872
chr1,41326360,0.97,58,2,60,629873
chr1,41326377,0.58,29,21,50,629874
chr1,41326434,0.14,6,37,43,629875
chr1,41326573,0.09,9,92,101,629876
chr1,41326597,0.02,2,102,104,629877
chr1,41326695,0.01,1,91,92,629878
chr1,41326717,0.02,2,81,83,629879
chr1,41326781,0,0,78,78,629880
chr1,41326787,0,0,72,72,629881
chr1,41326848,0.06,2,32,34,629882
chr1,41326886,0.02,1,44,45,629883
chr1,41326892,0,0,49,49,629884
chr1,41326950,0.24,4,13,17,629885
chr1,41326953,0.09,2,21,23,629886
chr1,41326969,0.02,1,45,46,629887
chr1,41326988,0.02,1,48,49,629888
chr1,41327006,0,0,48,48,629889
chr1,41327023,0.02,1,49,50,629890
chr1,41327027,0.02,1,48,49,629891
chr1,41327066,0,0,46,46,629892
chr1,41327090,0,0,44,44,629893
chr1,41327106,0,0,52,52,629894
chr1,41327112,0,0,48,48,629895
chr1,41327121,0,0,39,39,629896
chr1,41327131,0,0,27,27,629897
chr1,41327134,0,0,20,20,629898
chr1,41327146,0,0,45,45,629899
chr1,41327148,0,0,45,45,629900
chr1,41327155,0,0,31,31,629901
chr1,41327157,0,0,30,30,629902
chr1,41327159,0,0,39,39,629903
chr1,41327161,0,0,40,40,629904
chr1,41327172,0,0,44,44,629905
chr1,41327188,0.02,1,42,43,629906
chr1,41327191,0,0,40,40,629907
chr1,41327199,0.03,1,39,40,629908
chr1,41327217,0,0,36,36,629909
chr1,41327222,0,0,23,23,629910
chr1,41327225,0,0,37,37,629911
chr1,41327229,0,0,34,34,629912
chr1,41327233,0,0,23,23,629913
chr1,41327236,0,0,31,31,629914
chr1,41327240,0.06,1,15,16,629915
chr1,41327256,0,0,47,47,629916
chr1,41327262,0.04,2,44,46,629917
chr1,41327265,0,0,44,44,629918
chr1,41327269,0.03,1,34,35,629919
chr1,41327272,0,0,36,36,629920
chr1,41327274,0,0,40,40,629921
chr1,41327287,0,0,53,53,629922
chr1,41327298,0,0,58,58,629923
chr1,41327304,0,0,52,52,629924
chr1,41327325,0,0,61,61,629925
chr1,41327334,0,0,59,59,629926
chr1,41327336,0,0,57,57,629927
chr1,41327340,0,0,63,63,629928
chr1,41327342,0.02,1,58,59,629929
chr1,41327352,0,0,63,63,629930
chr1,41327368,0,0,60,60,629931
chr1,41327371,0.02,1,56,57,629932
chr1,41327377,0,0,43,43,629933
chr1,41327385,0,0,54,54,629934
chr1,41327388,0,0,49,49,629935
chr1,41327397,0,0,45,45,629936
chr1,41327400,0,0,40,40,629937
chr1,41327409,0,0,39,39,629938
chr1,41327418,0.03,1,30,31,629939
chr1,41327422,0,0,37,37,629940
chr1,41327424,0,0,38,38,629941
chr1,41327428,0.1,3,28,31,629942
chr1,41327431,0,0,32,32,629943
chr1,41327434,0,0,29,29,629944
chr1,41327442,0,0,38,38,629945
chr1,41327445,0,0,30,30,629946
chr1,41327452,0,0,22,22,629947
chr1,41327455,0,0,38,38,629948
chr1,41327461,0,0,33,33,629949
chr1,41327467,0.09,3,29,32,629950
chr1,41327479,0,0,35,35,629951
chr1,41327484,0,0,23,23,629952
chr1,41327494,0,0,12,12,629953
chr1,41327496,0,0,18,18,629954
chr1,41327500,0,0,26,26,629955
chr1,41327502,0,0,21,21,629956
chr1,41327504,0.04,1,22,23,629957
chr1,41327508,0.04,1,24,25,629958
chr1,41327515,0,0,24,24,629959
chr1,41327518,0.06,1,16,17,629960
chr1,41327521,0,0,18,18,629961
chr1,41327539,0.04,1,22,23,629962
chr1,41327541,0,0,23,23,629963
chr1,41327548,0.04,1,23,24,629964
chr1,41327550,0,0,22,22,629965
chr1,41327554,0,0,28,28,629966
chr1,41327557,0,0,22,22,629967
chr1,41327565,0,0,29,29,629968
chr1,41327569,0,0,30,30,629969
chr1,41327590,0,0,29,29,629970
chr1,41327593,0,0,18,18,629971
chr1,41327598,0,0,35,35,629972
chr1,41327607,0,0,37,37,629973
chr1,41327611,0,0,29,29,629974
chr1,41327622,0,0,37,37,629975
chr1,41327630,0,0,30,30,629976
chr1,41327635,0,0,20,20,629977
chr1,41327638,0,0,26,26,629978
chr1,41327641,0,0,21,21,629979
chr1,41327650,0,0,34,34,629980
chr1,41327660,0,0,40,40,629981
chr1,41327662,0,0,38,38,629982
chr1,41327686,0,0,52,52,629983
chr1,41327692,0.02,1,49,50,629984
chr1,41327694,0,0,51,51,629985
chr1,41327698,0,0,53,53,629986
chr1,41327701,0,0,40,40,629987
chr1,41327711,0,0,57,57,629988
chr1,41327716,0,0,41,41,629989
chr1,41327733,0.03,1,39,40,629990
chr1,41327737,0,0,55,55,629991
chr1,41327739,0,0,54,54,629992
chr1,41327742,0,0,48,48,629993
chr1,41327746,0,0,50,50,629994
chr1,41327749,0,0,30,30,629995
chr1,41327765,0,0,43,43,629996
chr1,41327775,0.02,1,53,54,629997
chr1,41327778,0,0,44,44,629998
chr1,41327793,0,0,50,50,629999
chr1,41327802,0,0,43,43,630000
